//MAP CONVERTED BY dmm2tgm.py THIS HEADER COMMENT PREVENTS RECONVERSION, DO NOT REMOVE
"a" = (
/turf/simulated/floor/outdoors/grass/sif/cave,
/area/submap/alientomb)
"d" = (
/obj/machinery/power/emitter,
/obj/structure/cable/blue,
/turf/simulated/floor/plating/sif/planetuse,
/area/submap/alientomb)
"f" = (
/turf/simulated/mineral,
/area/template_noop)
"g" = (
/mob/living/simple_mob/humanoid/merc/ranged/laser,
/turf/simulated/floor/plating/sif/planetuse,
/area/submap/alientomb)
"j" = (
/turf/template_noop,
/area/template_noop)
"k" = (
/obj/structure/reflector,
/turf/simulated/floor/plating/sif/planetuse,
/area/submap/alientomb)
"m" = (
/mob/living/simple_mob/humanoid/merc/ranged/grenadier,
/turf/simulated/floor/plating/sif/planetuse,
/area/submap/alientomb)
"n" = (
/mob/living/simple_mob/humanoid/merc/ranged/smg/sol,
/turf/simulated/floor/plating/sif/planetuse,
/area/submap/alientomb)
"q" = (
/obj/machinery/door/blast/puzzle,
/turf/simulated/floor/flock,
/area/submap/alientomb)
"r" = (
/obj/structure/prop/lock/projectile{
	pixel_y = 6
	},
/turf/simulated/floor/flock,
/area/submap/alientomb)
"t" = (
/turf/simulated/floor/plating/sif/planetuse,
/area/submap/alientomb)
"u" = (
/obj/structure/table/alien/blue,
/obj/item/perfect_tele/alien,
/turf/simulated/floor/flock,
/area/submap/alientomb)
"x" = (
/turf/simulated/mineral,
/area/submap/alientomb)
"A" = (
/obj/structure/cable/blue{
	d1 = 1;
	d2 = 2;
	icon_state = "1-2"
	},
/turf/simulated/floor/plating/sif/planetuse,
/area/submap/alientomb)
"I" = (
/obj/structure/table/alien/blue,
/obj/item/multitool/alien,
/turf/simulated/floor/flock,
/area/submap/alientomb)
"K" = (
/turf/simulated/floor/flock,
/area/submap/alientomb)
"L" = (
/obj/structure/table/alien/blue,
/obj/item/storage/pill_bottle/healing_nanites,
/turf/simulated/floor/flock,
/area/submap/alientomb)
"T" = (
/mob/living/simple_mob/humanoid/merc/melee/sword/space,
/turf/simulated/floor/plating/sif/planetuse,
/area/submap/alientomb)
"W" = (
/turf/simulated/shuttle/wall/flock,
/area/submap/alientomb)
"X" = (
/obj/machinery/power/port_gen/pacman,
/obj/structure/cable/blue{
	d2 = 2;
	icon_state = "0-2"
	},
/turf/simulated/floor/plating/sif/planetuse,
/area/submap/alientomb)

(1,1,1) = {"
j
j
j
j
j
j
j
j
j
j
j
f
f
f
f
f
f
f
f
f
f
f
f
"}
(2,1,1) = {"
j
j
j
j
j
j
j
j
j
j
j
f
f
f
f
f
f
f
f
f
f
f
f
"}
(3,1,1) = {"
j
j
a
a
a
a
a
a
a
a
a
x
x
x
x
x
x
x
x
x
x
f
f
"}
(4,1,1) = {"
j
j
a
a
a
a
a
a
a
a
a
x
x
x
x
x
x
x
x
x
x
f
f
"}
(5,1,1) = {"
j
j
a
a
a
a
a
a
a
a
a
x
x
x
x
x
x
x
x
x
x
f
f
"}
(6,1,1) = {"
j
j
a
a
a
a
a
a
a
a
a
x
x
x
x
x
x
x
x
x
x
f
f
"}
(7,1,1) = {"
j
j
a
a
a
a
a
a
a
a
a
x
x
x
x
W
W
W
W
W
x
f
f
"}
(8,1,1) = {"
j
j
a
a
a
t
t
a
a
a
a
x
x
x
x
K
K
K
K
W
x
f
f
"}
(9,1,1) = {"
j
j
a
a
t
t
t
t
a
a
a
x
x
W
W
W
W
W
K
W
x
f
f
"}
(10,1,1) = {"
j
j
a
k
t
t
t
t
t
a
a
W
W
W
I
W
W
W
K
W
x
f
f
"}
(11,1,1) = {"
j
j
a
t
g
t
t
T
t
a
a
W
K
K
K
K
W
W
K
W
x
f
f
"}
(12,1,1) = {"
j
j
a
X
A
d
t
t
t
a
a
q
K
K
K
K
u
W
r
W
x
f
f
"}
(13,1,1) = {"
j
j
a
t
m
t
t
n
t
a
a
W
K
K
K
K
W
W
K
W
x
f
f
"}
(14,1,1) = {"
j
j
a
k
t
t
t
t
t
a
a
W
W
W
L
W
W
W
K
W
x
f
f
"}
(15,1,1) = {"
j
j
a
a
t
t
t
t
a
a
a
x
x
W
W
W
W
W
K
W
x
f
f
"}
(16,1,1) = {"
j
j
a
a
a
t
t
a
a
a
a
x
x
x
x
K
K
K
K
W
x
f
f
"}
(17,1,1) = {"
j
j
a
a
a
a
a
a
a
a
a
x
x
x
x
W
W
W
W
W
x
f
f
"}
(18,1,1) = {"
j
j
a
a
a
a
a
a
a
a
a
x
x
x
x
x
x
x
x
x
x
f
f
"}
(19,1,1) = {"
j
j
a
a
a
a
a
a
a
a
a
x
x
x
x
x
x
x
x
x
x
f
f
"}
(20,1,1) = {"
j
j
a
a
a
a
a
a
a
a
a
x
x
x
x
x
x
x
x
x
x
f
f
"}
(21,1,1) = {"
j
j
a
a
a
a
a
a
a
a
a
x
x
x
x
x
x
x
x
x
x
f
f
"}
(22,1,1) = {"
j
j
j
j
j
j
j
j
j
j
j
f
f
f
f
f
f
f
f
f
f
f
f
"}
(23,1,1) = {"
j
j
j
j
j
j
j
j
j
j
j
f
f
f
f
f
f
f
f
f
f
f
f
"}
