//MAP CONVERTED BY dmm2tgm.py THIS HEADER COMMENT PREVENTS RECONVERSION, DO NOT REMOVE
"aa" = (
/obj/effect/floor_decal/corner/yellow/border{
	dir = 9
	},
/obj/structure/blob/normal,
/turf/simulated/floor/tiled/white,
/area/submap/blobden)
"ak" = (
/turf/simulated/wall/titanium,
/area/submap/blobden)
"aH" = (
/obj/effect/floor_decal/corner/blue/border{
	dir = 6
	},
/obj/structure/blob/normal,
/turf/simulated/floor/tiled/white,
/area/submap/blobden)
"aQ" = (
/obj/structure/blob/core/random_hard{
	difficulty_floor = 2
	},
/turf/simulated/floor/tiled/white,
/area/submap/blobden)
"bC" = (
/obj/effect/floor_decal/corner/red/border{
	dir = 9
	},
/obj/structure/blob/normal,
/turf/simulated/floor/tiled/white,
/area/submap/blobden)
"cq" = (
/obj/effect/floor_decal/corner/orange/border{
	dir = 8
	},
/turf/simulated/floor/tiled/white,
/area/submap/blobden)
"dt" = (
/obj/effect/floor_decal/corner/blue/border,
/obj/structure/blob/normal,
/turf/simulated/floor/tiled/white,
/area/submap/blobden)
"dS" = (
/obj/effect/floor_decal/corner/green/border{
	dir = 8
	},
/obj/structure/blob/normal,
/turf/simulated/floor/tiled/white,
/area/submap/blobden)
"eL" = (
/obj/effect/floor_decal/corner/red/border,
/obj/structure/blob/normal,
/turf/simulated/floor/tiled/white,
/area/submap/blobden)
"eY" = (
/obj/structure/table/borosilicate,
/obj/item/rig_module/rad_shield/advanced,
/obj/structure/blob/factory,
/turf/simulated/floor/tiled/white,
/area/submap/blobden)
"fb" = (
/obj/effect/floor_decal/corner/orange/border,
/turf/simulated/floor/tiled/white,
/area/submap/blobden)
"gk" = (
/obj/effect/floor_decal/corner/green/border{
	dir = 4
	},
/obj/structure/blob/normal,
/turf/simulated/floor/tiled/white,
/area/submap/blobden)
"ig" = (
/obj/structure/table/borosilicate,
/obj/item/rig_module/mounted/egun,
/obj/structure/blob/factory,
/turf/simulated/floor/tiled/white,
/area/submap/blobden)
"iN" = (
/obj/structure/table/borosilicate,
/obj/item/storage/firstaid/bonemed,
/obj/random/medical,
/obj/structure/blob/normal,
/turf/simulated/floor/tiled/white,
/area/submap/blobden)
"jD" = (
/turf/simulated/mineral,
/area/template_noop)
"kY" = (
/obj/effect/floor_decal/corner/purple/border,
/obj/structure/blob/normal,
/turf/simulated/floor/tiled/white,
/area/submap/blobden)
"ls" = (
/obj/effect/floor_decal/corner/blue/border{
	dir = 4
	},
/obj/structure/blob/normal,
/turf/simulated/floor/tiled/white,
/area/submap/blobden)
"lt" = (
/turf/simulated/mineral/light,
/area/template_noop)
"lO" = (
/obj/effect/floor_decal/corner/yellow/border{
	dir = 4
	},
/obj/structure/blob/normal,
/turf/simulated/floor/tiled/white,
/area/submap/blobden)
"nB" = (
/obj/effect/floor_decal/corner/green/bordercorner{
	dir = 1
	},
/obj/effect/floor_decal/corner/orange/bordercorner,
/turf/simulated/floor/tiled/white,
/area/submap/blobden)
"pr" = (
/obj/effect/floor_decal/corner/green/bordercorner,
/obj/effect/floor_decal/corner/orange/bordercorner{
	dir = 1
	},
/turf/simulated/floor/tiled/white,
/area/submap/blobden)
"pU" = (
/obj/structure/blob/normal,
/turf/simulated/floor/tiled/white,
/area/submap/blobden)
"qc" = (
/obj/machinery/door/airlock/centcom{
	name = "Special Operations";
	req_access = list(103)
	},
/obj/structure/blob/normal,
/turf/simulated/floor/tiled/white,
/area/submap/blobden)
"qz" = (
/obj/effect/floor_decal/corner/green/border,
/obj/structure/blob/normal,
/turf/simulated/floor/tiled/white,
/area/submap/blobden)
"qW" = (
/obj/effect/floor_decal/corner/purple/border{
	dir = 8
	},
/obj/structure/blob/normal,
/turf/simulated/floor/tiled/white,
/area/submap/blobden)
"ry" = (
/obj/effect/floor_decal/corner/red/border{
	dir = 1
	},
/obj/structure/blob/normal,
/turf/simulated/floor/tiled/white,
/area/submap/blobden)
"sJ" = (
/obj/effect/floor_decal/corner/green/border{
	dir = 10
	},
/obj/structure/blob/normal,
/turf/simulated/floor/tiled/white,
/area/submap/blobden)
"sP" = (
/obj/structure/blob/factory,
/turf/simulated/floor/tiled/white,
/area/submap/blobden)
"uj" = (
/obj/effect/floor_decal/corner/purple/border{
	dir = 4
	},
/obj/structure/blob/normal,
/turf/simulated/floor/tiled/white,
/area/submap/blobden)
"uA" = (
/obj/effect/floor_decal/corner/purple/border{
	dir = 5
	},
/obj/structure/blob/normal,
/turf/simulated/floor/tiled/white,
/area/submap/blobden)
"wD" = (
/obj/effect/floor_decal/corner/red/border{
	dir = 5
	},
/obj/structure/blob/normal,
/turf/simulated/floor/tiled/white,
/area/submap/blobden)
"wX" = (
/obj/effect/floor_decal/corner/purple/border{
	dir = 6
	},
/obj/structure/blob/normal,
/turf/simulated/floor/tiled/white,
/area/submap/blobden)
"xW" = (
/obj/effect/floor_decal/corner/orange/border{
	dir = 1
	},
/turf/simulated/floor/tiled/white,
/area/submap/blobden)
"yW" = (
/obj/effect/floor_decal/corner/purple/border{
	dir = 1
	},
/obj/structure/blob/normal,
/turf/simulated/floor/tiled/white,
/area/submap/blobden)
"zE" = (
/obj/effect/floor_decal/corner/green/border{
	dir = 1
	},
/obj/structure/blob/normal,
/turf/simulated/floor/tiled/white,
/area/submap/blobden)
"Ac" = (
/obj/effect/floor_decal/corner/blue/border{
	dir = 8
	},
/obj/structure/blob/normal,
/turf/simulated/floor/tiled/white,
/area/submap/blobden)
"AJ" = (
/obj/structure/table/borosilicate,
/obj/item/cell/device/weapon/recharge,
/obj/item/cell/device/weapon/recharge,
/obj/item/cell/device/weapon/recharge,
/obj/item/cell/device/weapon/recharge,
/obj/structure/blob/normal,
/turf/simulated/floor/tiled/white,
/area/submap/blobden)
"Bc" = (
/obj/effect/floor_decal/corner/purple/border{
	dir = 10
	},
/obj/structure/blob/normal,
/turf/simulated/floor/tiled/white,
/area/submap/blobden)
"Bw" = (
/obj/effect/floor_decal/corner/yellow/border{
	dir = 1
	},
/obj/structure/blob/normal,
/turf/simulated/floor/tiled/white,
/area/submap/blobden)
"Db" = (
/obj/structure/table/borosilicate,
/obj/random/maintenance/security,
/obj/random/maintenance/security,
/obj/random/maintenance/security,
/obj/structure/blob/normal,
/turf/simulated/floor/tiled/white,
/area/submap/blobden)
"DR" = (
/obj/effect/floor_decal/corner/green/border{
	dir = 6
	},
/obj/structure/blob/normal,
/turf/simulated/floor/tiled/white,
/area/submap/blobden)
"Fe" = (
/obj/structure/table/borosilicate,
/obj/item/rig_module/chem_dispenser/combat,
/obj/random/medical,
/obj/structure/blob/factory,
/turf/simulated/floor/tiled/white,
/area/submap/blobden)
"FA" = (
/obj/effect/floor_decal/corner/blue/border{
	dir = 9
	},
/obj/structure/blob/normal,
/turf/simulated/floor/tiled/white,
/area/submap/blobden)
"FC" = (
/obj/effect/floor_decal/corner/green/bordercorner{
	dir = 4
	},
/obj/effect/floor_decal/corner/orange/bordercorner{
	dir = 8
	},
/turf/simulated/floor/tiled/white,
/area/submap/blobden)
"FL" = (
/obj/effect/floor_decal/corner/yellow/border{
	dir = 5
	},
/obj/structure/blob/normal,
/turf/simulated/floor/tiled/white,
/area/submap/blobden)
"Gy" = (
/obj/effect/floor_decal/corner/blue/border{
	dir = 10
	},
/obj/structure/blob/normal,
/turf/simulated/floor/tiled/white,
/area/submap/blobden)
"Ha" = (
/obj/structure/table/borosilicate,
/obj/random/maintenance/research,
/obj/random/maintenance/research,
/obj/random/maintenance/research,
/obj/structure/blob/normal,
/turf/simulated/floor/tiled/white,
/area/submap/blobden)
"Hs" = (
/obj/structure/table/borosilicate,
/obj/random/maintenance/engineering,
/obj/random/maintenance/engineering,
/obj/random/maintenance/engineering,
/obj/structure/blob/normal,
/turf/simulated/floor/tiled/white,
/area/submap/blobden)
"HQ" = (
/obj/structure/table/borosilicate,
/obj/random/energy/sec,
/obj/item/rig_module/stealth_field,
/obj/structure/blob/normal,
/turf/simulated/floor/tiled/white,
/area/submap/blobden)
"Iv" = (
/obj/effect/floor_decal/corner/green/border{
	dir = 5
	},
/obj/structure/blob/normal,
/turf/simulated/floor/tiled/white,
/area/submap/blobden)
"IC" = (
/obj/effect/floor_decal/corner/blue/border{
	dir = 1
	},
/obj/structure/blob/normal,
/turf/simulated/floor/tiled/white,
/area/submap/blobden)
"Kc" = (
/obj/effect/floor_decal/corner/red/border{
	dir = 6
	},
/obj/structure/blob/normal,
/turf/simulated/floor/tiled/white,
/area/submap/blobden)
"La" = (
/obj/effect/floor_decal/corner/yellow/border,
/obj/structure/blob/normal,
/turf/simulated/floor/tiled/white,
/area/submap/blobden)
"NS" = (
/obj/structure/table/borosilicate,
/obj/random/maintenance/medical,
/obj/random/maintenance/medical,
/obj/random/maintenance/medical,
/obj/structure/blob/normal,
/turf/simulated/floor/tiled/white,
/area/submap/blobden)
"OA" = (
/obj/structure/table/borosilicate,
/obj/random/energy/highend,
/obj/item/rig_module/voice,
/obj/structure/blob/normal,
/turf/simulated/floor/tiled/white,
/area/submap/blobden)
"PM" = (
/obj/effect/floor_decal/corner/green/border{
	dir = 9
	},
/obj/structure/blob/normal,
/turf/simulated/floor/tiled/white,
/area/submap/blobden)
"Qg" = (
/obj/structure/table/borosilicate,
/obj/item/rig_module/grenade_launcher/metalfoam,
/obj/structure/blob/factory,
/turf/simulated/floor/tiled/white,
/area/submap/blobden)
"Qp" = (
/obj/effect/floor_decal/corner/red/border{
	dir = 4
	},
/obj/structure/blob/normal,
/turf/simulated/floor/tiled/white,
/area/submap/blobden)
"RM" = (
/obj/effect/floor_decal/corner/orange/border{
	dir = 4
	},
/turf/simulated/floor/tiled/white,
/area/submap/blobden)
"SR" = (
/obj/effect/floor_decal/corner/purple/border{
	dir = 9
	},
/obj/structure/blob/normal,
/turf/simulated/floor/tiled/white,
/area/submap/blobden)
"Tq" = (
/obj/effect/floor_decal/corner/blue/border{
	dir = 5
	},
/obj/structure/blob/normal,
/turf/simulated/floor/tiled/white,
/area/submap/blobden)
"TK" = (
/obj/effect/floor_decal/corner/red/border{
	dir = 8
	},
/obj/structure/blob/normal,
/turf/simulated/floor/tiled/white,
/area/submap/blobden)
"Uv" = (
/obj/effect/floor_decal/corner/green/bordercorner{
	dir = 8
	},
/obj/effect/floor_decal/corner/orange/bordercorner{
	dir = 4
	},
/turf/simulated/floor/tiled/white,
/area/submap/blobden)
"Vm" = (
/obj/effect/floor_decal/corner/yellow/border{
	dir = 6
	},
/obj/structure/blob/normal,
/turf/simulated/floor/tiled/white,
/area/submap/blobden)
"WE" = (
/obj/effect/floor_decal/corner/yellow/border{
	dir = 8
	},
/obj/structure/blob/normal,
/turf/simulated/floor/tiled/white,
/area/submap/blobden)
"WG" = (
/obj/effect/floor_decal/corner/red/border{
	dir = 10
	},
/obj/structure/blob/normal,
/turf/simulated/floor/tiled/white,
/area/submap/blobden)
"Yd" = (
/obj/effect/floor_decal/corner/yellow/border{
	dir = 10
	},
/obj/structure/blob/normal,
/turf/simulated/floor/tiled/white,
/area/submap/blobden)

(1,1,1) = {"
jD
jD
jD
jD
jD
jD
jD
jD
jD
jD
jD
jD
jD
jD
jD
jD
jD
jD
jD
jD
jD
jD
jD
"}
(2,1,1) = {"
jD
jD
jD
jD
jD
jD
jD
jD
jD
jD
jD
jD
jD
jD
jD
jD
jD
jD
jD
jD
jD
jD
jD
"}
(3,1,1) = {"
jD
jD
lt
lt
lt
lt
lt
lt
lt
lt
lt
lt
lt
lt
lt
lt
lt
lt
lt
lt
lt
jD
jD
"}
(4,1,1) = {"
jD
jD
lt
lt
lt
lt
lt
lt
lt
lt
lt
lt
lt
lt
lt
lt
lt
lt
lt
lt
lt
jD
jD
"}
(5,1,1) = {"
jD
jD
lt
lt
ak
ak
ak
ak
ak
ak
ak
ak
ak
ak
ak
ak
ak
ak
ak
lt
lt
jD
jD
"}
(6,1,1) = {"
jD
jD
lt
lt
ak
FA
Ac
Ac
Gy
ak
PM
dS
sJ
ak
SR
qW
qW
Bc
ak
lt
lt
jD
jD
"}
(7,1,1) = {"
jD
jD
lt
lt
ak
IC
iN
NS
dt
ak
zE
sP
qz
ak
yW
Ha
OA
kY
ak
lt
lt
jD
jD
"}
(8,1,1) = {"
jD
jD
lt
lt
ak
IC
NS
Fe
dt
ak
zE
pU
qz
ak
yW
Qg
Ha
kY
ak
lt
lt
jD
jD
"}
(9,1,1) = {"
jD
jD
lt
lt
ak
Tq
ls
ls
aH
qc
zE
pU
qz
qc
uA
uj
uj
wX
ak
lt
lt
jD
jD
"}
(10,1,1) = {"
jD
jD
lt
lt
ak
ak
ak
ak
qc
ak
zE
pU
qz
ak
qc
ak
ak
ak
ak
lt
lt
jD
jD
"}
(11,1,1) = {"
jD
jD
lt
lt
ak
PM
dS
dS
dS
dS
nB
RM
Uv
dS
dS
dS
dS
sJ
ak
lt
lt
jD
jD
"}
(12,1,1) = {"
jD
jD
lt
lt
ak
zE
sP
pU
pU
pU
fb
aQ
xW
pU
pU
pU
sP
qz
ak
lt
lt
jD
jD
"}
(13,1,1) = {"
jD
jD
lt
lt
ak
Iv
gk
gk
gk
gk
FC
cq
pr
gk
gk
gk
gk
DR
ak
lt
lt
jD
jD
"}
(14,1,1) = {"
jD
jD
lt
lt
ak
ak
ak
ak
qc
ak
zE
pU
qz
ak
qc
ak
ak
ak
ak
lt
lt
jD
jD
"}
(15,1,1) = {"
jD
jD
lt
lt
ak
aa
WE
WE
Yd
qc
zE
pU
qz
qc
bC
TK
TK
WG
ak
lt
lt
jD
jD
"}
(16,1,1) = {"
jD
jD
lt
lt
ak
Bw
Hs
eY
La
ak
zE
pU
qz
ak
ry
ig
Db
eL
ak
lt
lt
jD
jD
"}
(17,1,1) = {"
jD
jD
lt
lt
ak
Bw
AJ
Hs
La
ak
zE
sP
qz
ak
ry
Db
HQ
eL
ak
lt
lt
jD
jD
"}
(18,1,1) = {"
jD
jD
lt
lt
ak
FL
lO
lO
Vm
ak
Iv
gk
DR
ak
wD
Qp
Qp
Kc
ak
lt
lt
jD
jD
"}
(19,1,1) = {"
jD
jD
lt
lt
ak
ak
ak
ak
ak
ak
ak
ak
ak
ak
ak
ak
ak
ak
ak
lt
lt
jD
jD
"}
(20,1,1) = {"
jD
jD
lt
lt
lt
lt
lt
lt
lt
lt
lt
lt
lt
lt
lt
lt
lt
lt
lt
lt
lt
jD
jD
"}
(21,1,1) = {"
jD
jD
lt
lt
lt
lt
lt
lt
lt
lt
lt
lt
lt
lt
lt
lt
lt
lt
lt
lt
lt
jD
jD
"}
(22,1,1) = {"
jD
jD
jD
jD
jD
jD
jD
jD
jD
jD
jD
jD
jD
jD
jD
jD
jD
jD
jD
jD
jD
jD
jD
"}
(23,1,1) = {"
jD
jD
jD
jD
jD
jD
jD
jD
jD
jD
jD
jD
jD
jD
jD
jD
jD
jD
jD
jD
jD
jD
jD
"}
