//MAP CONVERTED BY dmm2tgm.py THIS HEADER COMMENT PREVENTS RECONVERSION, DO NOT REMOVE
"aq" = (
/obj/structure/table/sifwoodentable,
/obj/item/flame/candle/candelabra/everburn,
/turf/simulated/floor/wood/sif,
/area/submap/bloodchurch)
"ce" = (
/mob/living/simple_mob/vore/demonAI/wendigo{
	faction = "cult"
	},
/turf/simulated/floor/wood/sif,
/area/submap/bloodchurch)
"cq" = (
/mob/living/simple_mob/construct/shade,
/obj/effect/decal/cleanable/dirt,
/turf/simulated/floor/wood/sif,
/area/submap/bloodchurch)
"cH" = (
/obj/structure/closet,
/obj/random/energy/highend,
/obj/item/clothing/gloves/regen,
/obj/effect/decal/cleanable/dirt,
/turf/simulated/floor/wood/sif,
/area/submap/bloodchurch)
"dF" = (
/mob/living/simple_mob/humanoid/cultist/hunter,
/turf/simulated/floor/wood/sif,
/area/submap/bloodchurch)
"ev" = (
/mob/living/simple_mob/vore/demonAI/wendigo{
	faction = "cult"
	},
/obj/effect/decal/cleanable/dirt,
/turf/simulated/floor/wood/sif,
/area/submap/bloodchurch)
"eT" = (
/obj/structure/cliff/automatic{
	dir = 2
	},
/turf/simulated/floor/outdoors/dirt,
/area/submap/bloodchurch)
"fb" = (
/obj/structure/table/sifwoodentable,
/obj/random/meat,
/obj/random/meat,
/obj/random/meat,
/obj/random/meat,
/turf/simulated/floor/wood/sif,
/area/submap/bloodchurch)
"fn" = (
/obj/effect/decal/cleanable/blood/gibs,
/obj/structure/closet/crate/secure/loot,
/obj/item/rig_module/mounted/energy_blade,
/turf/simulated/floor/wood/sif,
/area/submap/bloodchurch)
"fQ" = (
/obj/structure/table/sifwoodentable,
/obj/random/medical/pillbottle,
/obj/effect/decal/cleanable/dirt,
/turf/simulated/floor/wood/sif,
/area/submap/bloodchurch)
"gy" = (
/turf/simulated/wall/cult,
/area/submap/bloodchurch)
"gM" = (
/obj/structure/bookcase,
/turf/simulated/floor/wood/sif,
/area/submap/bloodchurch)
"hQ" = (
/obj/structure/bed/double/padded,
/mob/living/simple_mob/humanoid/cultist/castertesh,
/obj/item/bedsheet/hosdouble,
/turf/simulated/floor/wood/sif,
/area/submap/bloodchurch)
"il" = (
/obj/structure/closet,
/obj/random/energy/highend,
/obj/item/storage/belt/holding,
/obj/effect/decal/cleanable/dirt,
/turf/simulated/floor/wood/sif,
/area/submap/bloodchurch)
"iT" = (
/obj/structure/kitchenspike,
/turf/simulated/floor/wood/sif,
/area/submap/bloodchurch)
"jP" = (
/mob/living/simple_mob/construct/artificer/caster,
/turf/simulated/floor/outdoors/dirt,
/area/submap/bloodchurch)
"ke" = (
/obj/item/flame/candle/candelabra/everburn,
/obj/structure/table/sifwoodentable,
/obj/effect/decal/cleanable/dirt,
/turf/simulated/floor/wood/sif,
/area/submap/bloodchurch)
"kn" = (
/obj/structure/loot_pile/surface/bones,
/turf/simulated/floor/wood/sif,
/area/submap/bloodchurch)
"lt" = (
/obj/effect/decal/cleanable/blood/gibs,
/turf/simulated/floor/wood/sif,
/area/submap/bloodchurch)
"mn" = (
/obj/item/clothing/suit/wizrobe/psypurple,
/obj/effect/decal/cleanable/dirt,
/obj/item/holosign_creator/forcewand,
/turf/simulated/floor/wood/sif,
/area/submap/bloodchurch)
"mG" = (
/obj/effect/decal/cleanable/dirt,
/obj/effect/decal/cleanable/dirt,
/turf/simulated/floor/wood/sif,
/area/submap/bloodchurch)
"or" = (
/obj/structure/loot_pile/surface/bones,
/obj/effect/decal/cleanable/dirt,
/turf/simulated/floor/wood/sif,
/area/submap/bloodchurch)
"oI" = (
/obj/structure/table/bench/sifwooden/padded,
/mob/living/simple_mob/humanoid/cultist/human/bloodjaunt,
/obj/effect/decal/cleanable/dirt,
/turf/simulated/floor/wood/sif,
/area/submap/bloodchurch)
"pJ" = (
/obj/structure/table/bench/sifwooden/padded,
/obj/effect/decal/cleanable/dirt,
/obj/effect/decal/cleanable/dirt,
/obj/effect/decal/cleanable/dirt,
/turf/simulated/floor/wood/sif,
/area/submap/bloodchurch)
"pL" = (
/mob/living/simple_mob/humanoid/cultist/noodle,
/obj/effect/decal/cleanable/dirt,
/turf/simulated/floor/wood/sif,
/area/submap/bloodchurch)
"qb" = (
/obj/structure/bed/double/padded,
/mob/living/simple_mob/humanoid/cultist/human/bloodjaunt,
/obj/item/bedsheet/hosdouble,
/obj/effect/decal/cleanable/dirt,
/turf/simulated/floor/wood/sif,
/area/submap/bloodchurch)
"rQ" = (
/turf/simulated/floor/wood/sif,
/area/submap/bloodchurch)
"sy" = (
/obj/structure/table/rack,
/obj/item/clothing/suit/storage/hooded/wintercoat/narsie,
/obj/item/clothing/suit/storage/hooded/wintercoat/narsie,
/turf/simulated/floor/wood/sif,
/area/submap/bloodchurch)
"sA" = (
/obj/structure/table/bench/sifwooden/padded,
/mob/living/simple_mob/humanoid/cultist/tesh,
/obj/effect/decal/cleanable/dirt,
/obj/effect/decal/cleanable/dirt,
/turf/simulated/floor/wood/sif,
/area/submap/bloodchurch)
"tW" = (
/obj/structure/table/bench/sifwooden/padded,
/mob/living/simple_mob/humanoid/cultist/castertesh,
/obj/effect/decal/cleanable/dirt,
/obj/effect/decal/cleanable/dirt,
/obj/effect/decal/cleanable/dirt,
/turf/simulated/floor/wood/sif,
/area/submap/bloodchurch)
"wh" = (
/mob/living/simple_mob/humanoid/cultist/elite,
/obj/effect/decal/cleanable/dirt,
/turf/simulated/floor/wood/sif,
/area/submap/bloodchurch)
"wA" = (
/obj/item/clothing/head/wizard/amp,
/mob/living/simple_mob/construct/shade,
/turf/simulated/floor/wood/sif,
/area/submap/bloodchurch)
"xJ" = (
/obj/structure/closet/crate,
/obj/item/stolenpackage,
/obj/item/stolenpackage,
/obj/item/stolenpackage,
/obj/item/rig_module/vision/thermal,
/turf/simulated/floor/wood/sif,
/area/submap/bloodchurch)
"xN" = (
/obj/structure/table/sifwoodentable,
/obj/random/mouseray,
/turf/simulated/floor/wood/sif,
/area/submap/bloodchurch)
"yn" = (
/obj/structure/cliff/automatic{
	dir = 8
	},
/turf/simulated/floor/outdoors/dirt,
/area/submap/bloodchurch)
"yo" = (
/obj/structure/table/bench/sifwooden/padded,
/mob/living/simple_mob/humanoid/cultist/lizard,
/obj/effect/decal/cleanable/dirt,
/obj/effect/decal/cleanable/dirt,
/turf/simulated/floor/wood/sif,
/area/submap/bloodchurch)
"yC" = (
/turf/simulated/floor/outdoors/dirt,
/area/submap/bloodchurch)
"yD" = (
/obj/structure/table/sifwoodentable,
/obj/item/holosign_creator/forcewand,
/obj/effect/decal/cleanable/dirt,
/turf/simulated/floor/wood/sif,
/area/submap/bloodchurch)
"zB" = (
/obj/structure/cliff/automatic/corner{
	dir = 9
	},
/turf/simulated/floor/outdoors/dirt,
/area/submap/bloodchurch)
"zO" = (
/obj/item/clothing/suit/wizrobe,
/mob/living/simple_mob/construct/shade,
/obj/effect/decal/cleanable/dirt,
/turf/simulated/floor/wood/sif,
/area/submap/bloodchurch)
"Ac" = (
/obj/structure/table/sifwoodentable,
/obj/item/flame/candle/everburn,
/obj/effect/decal/cleanable/dirt,
/turf/simulated/floor/wood/sif,
/area/submap/bloodchurch)
"Ae" = (
/obj/effect/decal/cleanable/blood/gibs,
/obj/effect/decal/cleanable/dirt,
/obj/effect/decal/cleanable/dirt,
/turf/simulated/floor/wood/sif,
/area/submap/bloodchurch)
"AL" = (
/turf/template_noop,
/area/template_noop)
"AZ" = (
/obj/item/clothing/suit/wizrobe,
/turf/simulated/floor/wood/sif,
/area/submap/bloodchurch)
"Cf" = (
/obj/structure/table/sifwoodentable,
/obj/item/flame/candle/candelabra/everburn,
/obj/effect/decal/cleanable/dirt,
/turf/simulated/floor/wood/sif,
/area/submap/bloodchurch)
"Ch" = (
/obj/structure/table/sifwoodentable,
/obj/item/flame/candle/everburn,
/obj/effect/decal/cleanable/dirt,
/obj/effect/decal/cleanable/dirt,
/turf/simulated/floor/wood/sif,
/area/submap/bloodchurch)
"DJ" = (
/obj/structure/table/sifwoodentable,
/obj/item/clothing/head/psy_crown/wrath,
/obj/effect/decal/cleanable/dirt,
/turf/simulated/floor/wood/sif,
/area/submap/bloodchurch)
"EZ" = (
/obj/structure/loot_pile/surface/bones,
/obj/item/storage/backpack/dufflebag/syndie,
/turf/simulated/floor/wood/sif,
/area/submap/bloodchurch)
"FG" = (
/obj/structure/table/sifwoodentable,
/obj/random/meat,
/obj/random/meat,
/obj/random/meat,
/obj/random/meat,
/obj/random/meat,
/turf/simulated/floor/wood/sif,
/area/submap/bloodchurch)
"Gk" = (
/obj/effect/decal/cleanable/blood/gibs,
/obj/effect/decal/cleanable/dirt,
/turf/simulated/floor/wood/sif,
/area/submap/bloodchurch)
"GX" = (
/obj/effect/decal/cleanable/dirt,
/obj/effect/decal/cleanable/dirt,
/obj/effect/decal/cleanable/dirt,
/turf/simulated/floor/wood/sif,
/area/submap/bloodchurch)
"Hn" = (
/obj/random/explorer_shield,
/obj/random/contraband/nofail,
/obj/random/contraband/nofail,
/obj/structure/closet/crate/secure/loot,
/obj/item/rig_module/mounted/energy_blade,
/obj/item/rig_module/sprinter,
/obj/item/rig_module/rescue_pharm,
/turf/simulated/floor/wood/sif,
/area/submap/bloodchurch)
"Ku" = (
/mob/living/simple_mob/humanoid/cultist/human/bloodjaunt/fireball,
/turf/simulated/floor/outdoors/dirt,
/area/submap/bloodchurch)
"KD" = (
/obj/structure/cliff/automatic,
/turf/simulated/floor/outdoors/dirt,
/area/submap/bloodchurch)
"MC" = (
/obj/item/flame/candle/candelabra/everburn,
/obj/structure/table/sifwoodentable,
/turf/simulated/floor/wood/sif,
/area/submap/bloodchurch)
"MH" = (
/obj/structure/table/bench/sifwooden/padded,
/obj/effect/decal/cleanable/dirt,
/obj/effect/decal/cleanable/dirt,
/turf/simulated/floor/wood/sif,
/area/submap/bloodchurch)
"MK" = (
/obj/structure/loot_pile/surface/bones,
/obj/item/storage/backpack/holding/duffle,
/turf/simulated/floor/wood/sif,
/area/submap/bloodchurch)
"MQ" = (
/turf/simulated/wall/log_sif,
/area/submap/bloodchurch)
"MX" = (
/obj/structure/table/sifwoodentable,
/obj/random/meat,
/obj/random/meat,
/obj/random/meat,
/obj/random/meat,
/obj/random/meat,
/obj/effect/decal/cleanable/dirt,
/turf/simulated/floor/wood/sif,
/area/submap/bloodchurch)
"Nn" = (
/obj/effect/decal/cleanable/dirt,
/turf/simulated/floor/wood/sif,
/area/submap/bloodchurch)
"OC" = (
/obj/structure/simple_door/sifwood,
/turf/simulated/floor/wood/sif,
/area/submap/bloodchurch)
"OZ" = (
/obj/structure/cliff/automatic/corner{
	dir = 10
	},
/turf/simulated/floor/outdoors/dirt,
/area/submap/bloodchurch)
"Pn" = (
/obj/effect/landmark/loot_spawn,
/turf/simulated/floor/wood/sif,
/area/submap/bloodchurch)
"Qz" = (
/obj/structure/table/sifwoodentable,
/obj/random/toolbox,
/obj/effect/decal/cleanable/dirt,
/turf/simulated/floor/wood/sif,
/area/submap/bloodchurch)
"RN" = (
/obj/structure/table/sifwoodentable,
/obj/random/contraband/nofail,
/obj/random/contraband/nofail,
/obj/random/gun/random,
/turf/simulated/floor/wood/sif,
/area/submap/bloodchurch)
"Uz" = (
/obj/structure/cliff/automatic/corner{
	dir = 6
	},
/turf/simulated/floor/outdoors/dirt,
/area/submap/bloodchurch)
"Vy" = (
/mob/living/simple_mob/humanoid/cultist/hunter,
/obj/effect/decal/cleanable/dirt,
/turf/simulated/floor/wood/sif,
/area/submap/bloodchurch)
"WM" = (
/obj/structure/table/bench/sifwooden/padded,
/mob/living/simple_mob/humanoid/cultist/caster,
/obj/effect/decal/cleanable/dirt,
/turf/simulated/floor/wood/sif,
/area/submap/bloodchurch)
"Yz" = (
/mob/living/simple_mob/construct/shade,
/turf/simulated/floor/wood/sif,
/area/submap/bloodchurch)
"YL" = (
/obj/structure/cliff/automatic{
	dir = 4
	},
/turf/simulated/floor/outdoors/dirt,
/area/submap/bloodchurch)
"YS" = (
/obj/structure/cliff/automatic/corner,
/turf/simulated/floor/outdoors/dirt,
/area/submap/bloodchurch)

(1,1,1) = {"
AL
AL
AL
AL
AL
AL
AL
AL
AL
AL
AL
AL
AL
AL
AL
AL
AL
AL
AL
AL
AL
AL
AL
AL
AL
AL
AL
AL
AL
AL
AL
AL
AL
AL
AL
"}
(2,1,1) = {"
AL
AL
AL
AL
AL
AL
AL
AL
AL
AL
AL
AL
AL
AL
AL
AL
AL
AL
AL
AL
AL
AL
AL
AL
AL
AL
AL
AL
AL
AL
AL
AL
AL
AL
AL
"}
(3,1,1) = {"
AL
Uz
YL
YL
YL
YL
YL
YL
YL
YL
YL
YL
YL
YL
YL
YL
YL
YL
YL
YL
YL
YL
YL
YL
YL
YL
YL
YL
YL
YL
YL
YL
YL
YS
AL
"}
(4,1,1) = {"
AL
eT
yC
yC
yC
yC
yC
yC
yC
yC
yC
yC
yC
yC
yC
yC
yC
yC
yC
yC
yC
yC
yC
yC
yC
yC
yC
yC
yC
yC
yC
yC
yC
KD
AL
"}
(5,1,1) = {"
AL
eT
yC
yC
yC
yC
yC
yC
yC
yC
yC
yC
yC
yC
yC
yC
yC
Ku
yC
yC
yC
yC
yC
yC
yC
yC
yC
yC
yC
yC
yC
yC
yC
KD
AL
"}
(6,1,1) = {"
AL
eT
yC
yC
yC
yC
yC
yC
yC
yC
yC
yC
yC
yC
yC
yC
yC
yC
yC
yC
yC
yC
yC
yC
yC
yC
yC
yC
yC
yC
yC
yC
yC
KD
AL
"}
(7,1,1) = {"
AL
eT
yC
yC
yC
yC
yC
yC
yC
yC
yC
yC
yC
yC
yC
yC
yC
yC
yC
yC
yC
yC
yC
yC
yC
yC
yC
yC
yC
yC
yC
yC
yC
KD
AL
"}
(8,1,1) = {"
AL
eT
yC
yC
yC
Uz
YL
YL
YL
YL
YL
YL
YL
YL
YL
YL
YL
YL
YL
YL
YL
YL
YL
YL
YL
YL
YL
YL
YL
YS
yC
yC
yC
KD
AL
"}
(9,1,1) = {"
AL
eT
yC
yC
yC
eT
MQ
MQ
MQ
MQ
MQ
MQ
MQ
MQ
MQ
MQ
gy
gy
gy
gy
gy
yC
yC
yC
yC
yC
yC
yC
yC
KD
yC
yC
yC
KD
AL
"}
(10,1,1) = {"
AL
eT
yC
yC
yC
eT
MQ
kn
xJ
Yz
lt
Pn
lt
Yz
rQ
EZ
gy
qb
rQ
xN
gy
yC
yC
yC
yC
yC
yC
yC
yC
KD
yC
yC
yC
KD
AL
"}
(11,1,1) = {"
AL
eT
yC
yC
yC
eT
MQ
lt
zO
Nn
Nn
or
cq
Gk
AZ
Pn
gy
ev
Nn
Cf
gy
yC
yC
yC
yC
yC
yC
yC
yC
KD
yC
yC
yC
KD
AL
"}
(12,1,1) = {"
AL
eT
yC
yC
yC
eT
MQ
Pn
Gk
Nn
cq
mn
MK
wA
kn
fn
gy
il
Nn
Nn
gy
yC
yC
yC
yC
yC
yC
yC
yC
KD
yC
yC
yC
KD
AL
"}
(13,1,1) = {"
AL
eT
yC
yC
yC
eT
MQ
MQ
MQ
OC
MQ
MQ
MQ
MQ
MQ
MQ
gy
gy
gy
OC
gy
yC
yC
jP
yC
yC
yC
yC
yC
KD
yC
yC
yC
KD
AL
"}
(14,1,1) = {"
AL
eT
yC
yC
yC
eT
MQ
gM
rQ
rQ
Nn
Nn
rQ
Nn
Nn
rQ
OC
Nn
Nn
Nn
MQ
yC
yC
yC
yC
yC
yC
yC
yC
KD
yC
yC
yC
KD
AL
"}
(15,1,1) = {"
AL
eT
yC
yC
yC
eT
MQ
gM
rQ
mG
Ac
Nn
Ac
Nn
Ac
rQ
MQ
MQ
MQ
MQ
MQ
MQ
yC
yC
yC
yC
yC
yC
yC
KD
yC
yC
yC
KD
AL
"}
(16,1,1) = {"
AL
eT
yC
yC
yC
eT
MQ
rQ
Nn
Nn
WM
mG
yo
mG
oI
mG
MQ
MQ
sy
sy
MQ
MQ
yC
yC
yC
yC
yC
yC
yC
KD
yC
yC
yC
KD
AL
"}
(17,1,1) = {"
AL
eT
yC
yC
yC
eT
MQ
Nn
DJ
Nn
MH
mG
pJ
GX
pJ
Nn
MQ
MC
mG
Nn
MC
MQ
yC
yC
yC
yC
yC
yC
yC
KD
yC
yC
yC
KD
AL
"}
(18,1,1) = {"
AL
eT
yC
Ku
yC
eT
MQ
wh
fQ
mG
GX
mG
GX
mG
GX
Nn
OC
pL
GX
GX
mG
OC
yC
yC
jP
yC
yC
yC
yC
KD
yC
yC
yC
KD
AL
"}
(19,1,1) = {"
AL
eT
yC
yC
yC
eT
MQ
rQ
yD
Nn
MH
GX
pJ
mG
MH
mG
MQ
ke
mG
mG
MC
MQ
yC
yC
yC
yC
yC
yC
yC
KD
yC
Ku
yC
KD
AL
"}
(20,1,1) = {"
AL
eT
yC
yC
yC
eT
MQ
rQ
rQ
mG
sA
mG
yo
mG
tW
Nn
MQ
MQ
sy
sy
MQ
MQ
yC
yC
yC
yC
yC
yC
yC
KD
yC
yC
yC
KD
AL
"}
(21,1,1) = {"
AL
eT
yC
yC
yC
eT
MQ
gM
rQ
Nn
Ch
Nn
Ac
Nn
Ac
rQ
MQ
MQ
MQ
MQ
MQ
MQ
yC
yC
yC
yC
yC
yC
yC
KD
yC
yC
yC
KD
AL
"}
(22,1,1) = {"
AL
eT
yC
yC
yC
eT
MQ
gM
rQ
Nn
Nn
Nn
Nn
Nn
Nn
rQ
OC
rQ
rQ
rQ
MQ
yC
yC
yC
yC
yC
yC
yC
yC
KD
yC
yC
yC
KD
AL
"}
(23,1,1) = {"
AL
eT
yC
yC
yC
eT
MQ
MQ
MQ
OC
MQ
MQ
MQ
MQ
MQ
MQ
gy
gy
gy
OC
gy
yC
yC
jP
yC
KD
yC
yC
yC
KD
yC
yC
yC
KD
AL
"}
(24,1,1) = {"
AL
eT
yC
yC
yC
eT
MQ
Hn
lt
Nn
mG
Nn
Nn
Gk
Nn
RN
gy
cH
Nn
Nn
gy
yC
yC
yC
yC
KD
yC
yC
yC
KD
yC
yC
yC
KD
AL
"}
(25,1,1) = {"
AL
eT
yC
yC
yC
eT
MQ
rQ
dF
Nn
mG
Ae
mG
mG
Vy
lt
gy
ce
Nn
aq
gy
yC
yC
yC
yC
KD
yC
yC
yC
KD
yC
yC
yC
KD
AL
"}
(26,1,1) = {"
AL
eT
yC
yC
yC
eT
MQ
FG
FG
FG
iT
iT
iT
MX
MX
fb
gy
hQ
Nn
Qz
gy
yC
yC
yC
yC
KD
yC
yC
yC
KD
yC
yC
yC
KD
AL
"}
(27,1,1) = {"
AL
eT
yC
yC
yC
eT
MQ
MQ
MQ
MQ
MQ
MQ
MQ
MQ
MQ
MQ
gy
gy
gy
gy
gy
yC
yC
yC
yC
KD
yC
yC
yC
KD
yC
yC
yC
KD
AL
"}
(28,1,1) = {"
AL
eT
yC
yC
yC
OZ
yn
yn
yn
yn
yn
yn
yn
yn
yn
yn
yn
yn
yn
yn
yn
yn
yn
yn
yn
zB
yC
yC
yC
KD
yC
yC
yC
KD
AL
"}
(29,1,1) = {"
AL
eT
yC
yC
yC
yC
yC
yC
yC
yC
yC
yC
yC
yC
yC
yC
yC
yC
yC
yC
yC
yC
yC
yC
yC
yC
yC
yC
yC
KD
yC
yC
yC
KD
AL
"}
(30,1,1) = {"
AL
eT
yC
yC
yC
yC
yC
yC
yC
yC
yC
yC
yC
yC
yC
yC
yC
yC
yC
yC
yC
yC
yC
yC
yC
yC
yC
yC
yC
KD
yC
yC
yC
KD
AL
"}
(31,1,1) = {"
AL
eT
yC
yC
yC
yC
yC
yC
yC
yC
yC
yC
yC
Ku
yC
yC
yC
yC
yC
yC
yC
yC
yC
yC
yC
yC
yC
yC
yC
KD
yC
yC
yC
KD
AL
"}
(32,1,1) = {"
AL
eT
yC
yC
yC
yC
yC
yC
yC
yC
yC
yC
yC
yC
yC
yC
yC
yC
yC
yC
yC
yC
yC
yC
yC
yC
yC
yC
yC
KD
yC
yC
yC
KD
AL
"}
(33,1,1) = {"
AL
OZ
yn
yn
yn
yn
yn
yn
yn
yn
yn
yn
yn
yn
yn
yn
yn
yn
yn
yn
yn
yn
yn
yn
yn
yn
yn
yn
yn
zB
yC
yC
yC
KD
AL
"}
(34,1,1) = {"
AL
AL
AL
AL
AL
AL
AL
AL
AL
AL
AL
AL
AL
AL
AL
AL
AL
AL
AL
AL
AL
AL
AL
AL
AL
AL
AL
AL
AL
AL
yC
yC
yC
zB
AL
"}
(35,1,1) = {"
AL
AL
AL
AL
AL
AL
AL
AL
AL
AL
AL
AL
AL
AL
AL
AL
AL
AL
AL
AL
AL
AL
AL
AL
AL
AL
AL
AL
AL
AL
AL
AL
AL
AL
AL
"}
