//MAP CONVERTED BY dmm2tgm.py THIS HEADER COMMENT PREVENTS RECONVERSION, DO NOT REMOVE
"ax" = (
/obj/structure/closet/crate,
/obj/random/contraband/nofail,
/obj/random/contraband/nofail,
/obj/random/ammo,
/obj/random/ammo,
/obj/random/energy/highend,
/obj/random/energy/highend,
/obj/random/firstaid,
/obj/random/firstaid,
/obj/random/maintenance/morestuff,
/obj/random/maintenance/morestuff,
/obj/random/maintenance/misc,
/obj/random/maintenance/misc,
/obj/random/maintenance/research,
/obj/random/maintenance/research,
/obj/random/material/precious,
/obj/random/material/precious,
/obj/random/material/refined,
/obj/random/material/refined,
/turf/simulated/floor/wood/sif{
	temperature = 243.15;
	oxygen = 20.7263;
	nitrogen = 93.7835
	},
/area/submap/demonranch)
"aM" = (
/obj/fire,
/turf/simulated/floor/outdoors/dirt,
/area/submap/demonranch)
"aT" = (
/obj/structure/table/sifwoodentable,
/obj/random/mainttoyloot/nofail,
/obj/random/maintenance/foodstuff,
/obj/random/maintenance/foodstuff,
/obj/random/medical/pillbottle,
/turf/simulated/floor/wood/sif{
	temperature = 243.15;
	oxygen = 20.7263;
	nitrogen = 93.7835
	},
/area/submap/demonranch)
"bm" = (
/obj/structure/cliff/automatic{
	dir = 8
	},
/turf/simulated/floor/outdoors/dirt,
/area/submap/demonranch)
"bA" = (
/obj/structure/table/sifwoodentable,
/obj/random/explorer_shield,
/obj/random/maintenance/foodstuff,
/obj/random/maintenance/foodstuff,
/turf/simulated/floor/wood/sif{
	temperature = 243.15;
	oxygen = 20.7263;
	nitrogen = 93.7835
	},
/area/submap/demonranch)
"cb" = (
/obj/structure/cliff/automatic/ramp,
/turf/simulated/floor/outdoors/dirt,
/area/submap/demonranch)
"cc" = (
/obj/structure/simple_door/sifwood,
/turf/simulated/floor/wood/sif{
	temperature = 243.15;
	oxygen = 20.7263;
	nitrogen = 93.7835
	},
/area/submap/demonranch)
"dg" = (
/mob/living/simple_mob/humanoid/cultist/hunter,
/turf/simulated/floor/outdoors/dirt,
/area/submap/demonranch)
"eM" = (
/obj/structure/cliff/automatic,
/turf/simulated/floor/outdoors/dirt,
/area/submap/demonranch)
"gE" = (
/obj/item/flame/candle/everburn,
/obj/structure/table/sifwoodentable,
/turf/simulated/floor/wood/sif{
	temperature = 243.15;
	oxygen = 20.7263;
	nitrogen = 93.7835
	},
/area/submap/demonranch)
"hq" = (
/turf/simulated/floor/water,
/area/submap/demonranch)
"hz" = (
/obj/effect/landmark/loot_spawn/low,
/obj/fire,
/turf/simulated/floor/outdoors/dirt,
/area/submap/demonranch)
"hY" = (
/obj/structure/table/bench/sifwooden,
/turf/simulated/floor/outdoors/dirt,
/area/submap/demonranch)
"ie" = (
/mob/living/simple_mob/humanoid/cultist/castertesh,
/turf/simulated/floor/wood/sif{
	temperature = 243.15;
	oxygen = 20.7263;
	nitrogen = 93.7835
	},
/area/submap/demonranch)
"iw" = (
/obj/effect/landmark/loot_spawn/low,
/turf/simulated/floor/outdoors/dirt,
/area/submap/demonranch)
"kd" = (
/mob/living/simple_mob/vore/demonAI{
	faction = "cult"
	},
/turf/simulated/floor/outdoors/dirt,
/area/submap/demonranch)
"kz" = (
/obj/structure/railing,
/turf/simulated/floor/wood/sif{
	temperature = 243.15;
	oxygen = 20.7263;
	nitrogen = 93.7835
	},
/area/submap/demonranch)
"lo" = (
/obj/structure/cliff/automatic{
	dir = 2
	},
/turf/simulated/floor/outdoors/dirt,
/area/submap/demonranch)
"ml" = (
/obj/structure/closet/crate/secure/loot,
/obj/item/personal_shield_generator/belt/security,
/obj/random/contraband/nofail,
/obj/random/contraband/nofail,
/obj/random/contraband/nofail,
/obj/random/contraband/nofail,
/obj/item/storage/backpack/dufflebag/syndie/med,
/obj/item/holosign_creator/forcewand,
/turf/simulated/floor/wood/sif{
	temperature = 243.15;
	oxygen = 20.7263;
	nitrogen = 93.7835
	},
/area/submap/demonranch)
"mC" = (
/obj/random/projectile/random,
/turf/simulated/floor/outdoors/dirt,
/area/submap/demonranch)
"mG" = (
/turf/simulated/floor/wood/sif{
	temperature = 243.15;
	oxygen = 20.7263;
	nitrogen = 93.7835
	},
/area/submap/demonranch)
"nh" = (
/obj/structure/cliff/automatic{
	dir = 4
	},
/turf/simulated/floor/outdoors/dirt,
/area/submap/demonranch)
"nX" = (
/obj/structure/table/sifwoodentable,
/obj/item/reagent_containers/food/snacks/meat,
/obj/item/reagent_containers/food/snacks/meat,
/obj/item/reagent_containers/food/snacks/meat,
/obj/item/reagent_containers/food/snacks/meat,
/obj/item/reagent_containers/food/snacks/meat,
/obj/random/medical/pillbottle,
/obj/random/maintenance/foodstuff,
/obj/random/maintenance/foodstuff,
/turf/simulated/floor/wood/sif{
	temperature = 243.15;
	oxygen = 20.7263;
	nitrogen = 93.7835
	},
/area/submap/demonranch)
"nY" = (
/obj/structure/girder/reinforced,
/turf/simulated/floor/outdoors/dirt,
/area/submap/demonranch)
"ot" = (
/obj/structure/loot_pile/surface/bones,
/turf/simulated/floor/outdoors/dirt,
/area/submap/demonranch)
"pr" = (
/turf/template_noop,
/area/submap/demonranch)
"pV" = (
/turf/simulated/wall/log_sif{
	can_open = 1
	},
/area/submap/demonranch)
"qA" = (
/obj/structure/table/sifwoodentable,
/turf/simulated/floor/wood/sif{
	temperature = 243.15;
	oxygen = 20.7263;
	nitrogen = 93.7835
	},
/area/submap/demonranch)
"qC" = (
/obj/item/clothing/shoes/cult,
/turf/simulated/floor/outdoors/dirt,
/area/submap/demonranch)
"rg" = (
/obj/structure/simple_door/sifwood,
/turf/simulated/floor/outdoors/dirt,
/area/submap/demonranch)
"rV" = (
/obj/structure/railing{
	dir = 8
	},
/turf/simulated/floor/wood/sif{
	temperature = 243.15;
	oxygen = 20.7263;
	nitrogen = 93.7835
	},
/area/submap/demonranch)
"su" = (
/turf/simulated/floor/outdoors/dirt,
/area/submap/demonranch)
"sA" = (
/obj/fire,
/obj/fire,
/turf/simulated/floor/outdoors/dirt,
/area/submap/demonranch)
"ug" = (
/obj/structure/cliff/automatic/corner{
	dir = 6
	},
/turf/simulated/floor/outdoors/dirt,
/area/submap/demonranch)
"uu" = (
/obj/structure/girder/reinforced,
/turf/simulated/floor/wood/sif{
	temperature = 243.15;
	oxygen = 20.7263;
	nitrogen = 93.7835
	},
/area/submap/demonranch)
"uM" = (
/obj/structure/cliff/automatic{
	dir = 9
	},
/turf/simulated/floor/outdoors/dirt,
/area/submap/demonranch)
"vk" = (
/obj/structure/cliff/automatic/corner,
/turf/simulated/floor/outdoors/dirt,
/area/submap/demonranch)
"wt" = (
/obj/structure/cliff/automatic/corner{
	dir = 9
	},
/turf/simulated/floor/outdoors/dirt,
/area/submap/demonranch)
"yj" = (
/mob/living/simple_mob/humanoid/cultist/noodle,
/turf/simulated/floor/wood/sif{
	temperature = 243.15;
	oxygen = 20.7263;
	nitrogen = 93.7835
	},
/area/submap/demonranch)
"yT" = (
/mob/living/simple_mob/humanoid/cultist/hunter,
/turf/simulated/floor/wood/sif{
	temperature = 243.15;
	oxygen = 20.7263;
	nitrogen = 93.7835
	},
/area/submap/demonranch)
"zl" = (
/obj/structure/railing{
	dir = 1
	},
/turf/simulated/floor/wood/sif{
	temperature = 243.15;
	oxygen = 20.7263;
	nitrogen = 93.7835
	},
/area/submap/demonranch)
"Ak" = (
/obj/structure/table/sifwoodentable,
/obj/item/reagent_containers/food/snacks/meat,
/obj/item/reagent_containers/food/snacks/meat,
/obj/item/reagent_containers/food/snacks/meat,
/obj/item/reagent_containers/food/snacks/meat,
/obj/item/reagent_containers/food/snacks/meat,
/obj/item/reagent_containers/food/snacks/meat,
/obj/random/medical/pillbottle,
/obj/random/maintenance/foodstuff,
/obj/random/maintenance/foodstuff,
/turf/simulated/floor/wood/sif{
	temperature = 243.15;
	oxygen = 20.7263;
	nitrogen = 93.7835
	},
/area/submap/demonranch)
"AI" = (
/mob/living/simple_mob/humanoid/cultist/tesh,
/turf/simulated/floor/wood/sif{
	temperature = 243.15;
	oxygen = 20.7263;
	nitrogen = 93.7835
	},
/area/submap/demonranch)
"Bh" = (
/obj/item/clothing/head/culthood/alt,
/turf/simulated/floor/wood/sif{
	temperature = 243.15;
	oxygen = 20.7263;
	nitrogen = 93.7835
	},
/area/submap/demonranch)
"Dw" = (
/obj/effect/landmark/loot_spawn,
/obj/fire,
/turf/simulated/floor/outdoors/dirt,
/area/submap/demonranch)
"Fw" = (
/obj/structure/table/bench/sifwooden,
/mob/living/simple_mob/humanoid/pirate/mate/ranged/rifle{
	faction = "cult"
	},
/turf/simulated/floor/wood/sif{
	temperature = 243.15;
	oxygen = 20.7263;
	nitrogen = 93.7835
	},
/area/submap/demonranch)
"Gb" = (
/obj/structure/railing{
	dir = 4
	},
/turf/simulated/floor/wood/sif{
	temperature = 243.15;
	oxygen = 20.7263;
	nitrogen = 93.7835
	},
/area/submap/demonranch)
"Hj" = (
/obj/item/clothing/suit/cultrobes,
/turf/simulated/floor/wood/sif{
	temperature = 243.15;
	oxygen = 20.7263;
	nitrogen = 93.7835
	},
/area/submap/demonranch)
"In" = (
/obj/item/clothing/shoes/cult,
/turf/simulated/floor/wood/sif{
	temperature = 243.15;
	oxygen = 20.7263;
	nitrogen = 93.7835
	},
/area/submap/demonranch)
"IW" = (
/obj/structure/table/sifwoodentable,
/obj/item/reagent_containers/food/snacks/meat,
/obj/item/reagent_containers/food/snacks/meat,
/obj/item/reagent_containers/food/snacks/meat,
/obj/item/reagent_containers/food/snacks/meat,
/obj/item/reagent_containers/food/snacks/meat,
/obj/item/reagent_containers/food/snacks/meat,
/obj/random/contraband/nofail,
/obj/random/medical/pillbottle,
/obj/random/maintenance/foodstuff,
/obj/random/maintenance/foodstuff,
/turf/simulated/floor/wood/sif{
	temperature = 243.15;
	oxygen = 20.7263;
	nitrogen = 93.7835
	},
/area/submap/demonranch)
"JL" = (
/obj/structure/kitchenspike,
/turf/simulated/floor/wood/sif{
	temperature = 243.15;
	oxygen = 20.7263;
	nitrogen = 93.7835
	},
/area/submap/demonranch)
"JR" = (
/obj/random/projectile/scrapped_shotgun,
/turf/simulated/floor/outdoors/dirt,
/area/submap/demonranch)
"JY" = (
/obj/item/clothing/suit/cultrobes/magusred,
/turf/simulated/floor/wood/sif{
	temperature = 243.15;
	oxygen = 20.7263;
	nitrogen = 93.7835
	},
/area/submap/demonranch)
"Kt" = (
/turf/simulated/wall/log_sif,
/area/submap/demonranch)
"KO" = (
/obj/structure/cliff/automatic{
	dir = 5
	},
/turf/simulated/floor/outdoors/dirt,
/area/submap/demonranch)
"KS" = (
/obj/structure/loot_pile/surface/bones,
/obj/fire,
/turf/simulated/floor/outdoors/dirt,
/area/submap/demonranch)
"Mk" = (
/obj/structure/table/bench/sifwooden,
/mob/living/simple_mob/humanoid/pirate/mate/ranged/shotgun{
	faction = "cult"
	},
/turf/simulated/floor/outdoors/dirt,
/area/submap/demonranch)
"Mq" = (
/obj/structure/cliff/automatic{
	dir = 6
	},
/turf/simulated/floor/outdoors/dirt,
/area/submap/demonranch)
"Nt" = (
/obj/structure/cliff/automatic{
	dir = 10
	},
/turf/simulated/floor/outdoors/dirt,
/area/submap/demonranch)
"Oz" = (
/mob/living/simple_mob/humanoid/cultist/lizard,
/turf/simulated/floor/wood/sif{
	temperature = 243.15;
	oxygen = 20.7263;
	nitrogen = 93.7835
	},
/area/submap/demonranch)
"QH" = (
/obj/structure/table/sifwoodentable,
/obj/random/firstaid,
/obj/random/maintenance/foodstuff,
/obj/random/maintenance/foodstuff,
/turf/simulated/floor/wood/sif{
	temperature = 243.15;
	oxygen = 20.7263;
	nitrogen = 93.7835
	},
/area/submap/demonranch)
"QO" = (
/obj/structure/cliff/automatic/ramp{
	dir = 9
	},
/turf/simulated/floor/outdoors/dirt,
/area/submap/demonranch)
"Rp" = (
/obj/structure/table/sifwoodentable,
/obj/item/flame/candle/everburn,
/turf/simulated/floor/wood/sif{
	temperature = 243.15;
	oxygen = 20.7263;
	nitrogen = 93.7835
	},
/area/submap/demonranch)
"Si" = (
/obj/effect/landmark/loot_spawn,
/turf/simulated/floor/outdoors/dirt,
/area/submap/demonranch)
"SG" = (
/obj/structure/table/bench/sifwooden,
/mob/living/simple_mob/humanoid/pirate/las/armored{
	faction = "cult"
	},
/turf/simulated/floor/wood/sif{
	temperature = 243.15;
	oxygen = 20.7263;
	nitrogen = 93.7835
	},
/area/submap/demonranch)
"Tn" = (
/obj/item/clothing/suit/cultrobes/alt,
/turf/simulated/floor/wood/sif{
	temperature = 243.15;
	oxygen = 20.7263;
	nitrogen = 93.7835
	},
/area/submap/demonranch)
"TI" = (
/obj/item/clothing/head/culthood,
/turf/simulated/floor/wood/sif{
	temperature = 243.15;
	oxygen = 20.7263;
	nitrogen = 93.7835
	},
/area/submap/demonranch)
"TL" = (
/mob/living/simple_mob/vore/demonAI{
	faction = "cult"
	},
/obj/fire,
/turf/simulated/floor/outdoors/dirt,
/area/submap/demonranch)
"Up" = (
/obj/structure/cliff/automatic/corner{
	dir = 10
	},
/turf/simulated/floor/outdoors/dirt,
/area/submap/demonranch)
"UD" = (
/mob/living/simple_mob/humanoid/cultist/castertesh,
/turf/simulated/floor/outdoors/dirt,
/area/submap/demonranch)
"UM" = (
/obj/item/holosign_creator/smokewand,
/turf/simulated/floor/water,
/area/submap/demonranch)
"VJ" = (
/obj/structure/table/bench/sifwooden,
/turf/simulated/floor/wood/sif{
	temperature = 243.15;
	oxygen = 20.7263;
	nitrogen = 93.7835
	},
/area/submap/demonranch)
"WY" = (
/obj/structure/bookcase,
/turf/simulated/floor/wood/sif{
	temperature = 243.15;
	oxygen = 20.7263;
	nitrogen = 93.7835
	},
/area/submap/demonranch)
"Ye" = (
/obj/item/clothing/head/culthood/magus,
/turf/simulated/floor/wood/sif{
	temperature = 243.15;
	oxygen = 20.7263;
	nitrogen = 93.7835
	},
/area/submap/demonranch)
"Zy" = (
/turf/template_noop,
/area/template_noop)
"ZA" = (
/obj/item/clothing/suit/cultrobes/alt,
/turf/simulated/floor/outdoors/dirt,
/area/submap/demonranch)

(1,1,1) = {"
Zy
Zy
Zy
Zy
Zy
Zy
Zy
Zy
Zy
Zy
Zy
Zy
Zy
Zy
Zy
Zy
Zy
Zy
Zy
Zy
Zy
Zy
Zy
Zy
Zy
Zy
Zy
Zy
Zy
Zy
Zy
Zy
Zy
Zy
Zy
"}
(2,1,1) = {"
Zy
pr
pr
pr
pr
pr
pr
pr
pr
pr
pr
pr
pr
pr
pr
pr
pr
pr
pr
pr
pr
pr
pr
pr
pr
pr
pr
pr
pr
pr
pr
pr
pr
pr
Zy
"}
(3,1,1) = {"
Zy
pr
Kt
Kt
Kt
Kt
Kt
Kt
Kt
Kt
Kt
Kt
Kt
Kt
Kt
Kt
Kt
Kt
Kt
Kt
Kt
Kt
Kt
Kt
Kt
Kt
Kt
Kt
Kt
Kt
Kt
Kt
Kt
pr
Zy
"}
(4,1,1) = {"
Zy
pr
Kt
WY
mG
mG
Ye
Rp
Kt
Rp
mG
mG
mG
mG
Rp
Kt
Rp
ml
Rp
Kt
Rp
mG
mG
mG
mG
Rp
Kt
Rp
mG
mG
mG
WY
Kt
pr
Zy
"}
(5,1,1) = {"
Zy
pr
Kt
WY
ie
mG
mG
mG
Kt
mG
mG
mG
AI
mG
mG
pV
mG
mG
mG
pV
mG
mG
AI
mG
mG
mG
Kt
mG
mG
mG
ie
WY
Kt
pr
Zy
"}
(6,1,1) = {"
Zy
pr
Kt
WY
mG
mG
mG
mG
cc
mG
mG
mG
mG
yT
nX
Kt
mG
yj
mG
Kt
Ak
yT
mG
mG
mG
mG
cc
mG
mG
mG
mG
WY
Kt
pr
Zy
"}
(7,1,1) = {"
Zy
pr
Kt
WY
mG
mG
Oz
mG
Kt
mG
mG
mG
ie
mG
IW
Kt
mG
mG
mG
Kt
IW
mG
ie
mG
mG
mG
Kt
mG
Oz
mG
mG
WY
Kt
pr
Zy
"}
(8,1,1) = {"
Zy
pr
Kt
WY
mG
mG
mG
Rp
Kt
Rp
JL
mG
mG
mG
JL
Kt
qA
Rp
qA
Kt
JL
mG
mG
mG
JL
Rp
Kt
Rp
mG
mG
mG
WY
Kt
pr
Zy
"}
(9,1,1) = {"
Zy
pr
Kt
Kt
Kt
cc
Kt
Kt
Kt
Kt
Kt
Gb
Gb
Gb
Gb
Kt
Kt
Kt
Kt
Kt
Gb
Gb
Gb
Gb
Kt
Kt
Kt
Kt
Kt
cc
Kt
Kt
Kt
pr
Zy
"}
(10,1,1) = {"
Zy
pr
Kt
Rp
mG
mG
mG
Rp
Kt
uM
bm
bm
bm
bm
bm
bm
bm
bm
bm
bm
bm
bm
bm
bm
bm
Nt
Kt
Rp
mG
mG
mG
Rp
Kt
pr
Zy
"}
(11,1,1) = {"
Zy
pr
Kt
mG
mG
JY
mG
JL
Kt
eM
su
su
su
su
su
su
su
aM
aM
aM
su
su
su
su
su
lo
Kt
JL
In
mG
mG
mG
Kt
pr
Zy
"}
(12,1,1) = {"
Zy
pr
Kt
aT
mG
mG
ie
mG
kz
eM
su
ot
su
su
kd
aM
hz
KS
su
aM
aM
kd
su
Si
su
lo
zl
mG
mG
mG
AI
QH
Kt
pr
Zy
"}
(13,1,1) = {"
Zy
pr
Kt
bA
mG
yT
mG
mG
kz
eM
su
su
su
su
aM
aM
su
su
su
su
aM
aM
aM
su
su
lo
zl
mG
mG
yT
mG
bA
Kt
pr
Zy
"}
(14,1,1) = {"
Zy
pr
Kt
QH
AI
mG
mG
mG
kz
eM
su
TL
su
aM
aM
Si
su
su
su
aM
aM
su
aM
KS
aM
lo
zl
mG
ie
mG
mG
aT
Kt
pr
Zy
"}
(15,1,1) = {"
Zy
pr
Kt
mG
mG
mG
In
JL
Kt
eM
su
aM
aM
aM
ot
mC
su
hq
hq
aM
iw
su
su
su
aM
lo
Kt
JL
mG
mG
Tn
mG
Kt
pr
Zy
"}
(16,1,1) = {"
Zy
pr
Kt
Rp
mG
mG
mG
Rp
Kt
eM
su
su
aM
aM
aM
su
su
hq
hq
su
su
su
kd
aM
aM
lo
Kt
Rp
mG
Bh
mG
Rp
Kt
pr
Zy
"}
(17,1,1) = {"
Zy
pr
Kt
Kt
Kt
cc
Kt
Kt
Kt
eM
su
Si
aM
su
aM
aM
hq
hq
hq
hq
su
JR
su
aM
su
lo
Kt
Kt
Kt
cc
Kt
Kt
Kt
pr
Zy
"}
(18,1,1) = {"
Zy
pr
pr
pr
pr
su
su
QO
bm
wt
su
su
aM
kd
su
aM
hq
hq
hq
hq
su
su
aM
aM
su
Up
bm
QO
su
pr
pr
pr
pr
pr
Zy
"}
(19,1,1) = {"
Zy
pr
pr
pr
pr
pr
pr
su
su
sA
su
KS
aM
su
su
hq
hq
hq
hq
hq
su
aM
KS
aM
su
sA
su
su
su
pr
pr
pr
pr
pr
Zy
"}
(20,1,1) = {"
Zy
pr
pr
pr
pr
pr
pr
pr
su
sA
su
aM
su
su
hq
hq
hq
hq
hq
hq
aM
aM
su
aM
aM
sA
su
su
pr
pr
pr
pr
pr
pr
Zy
"}
(21,1,1) = {"
Zy
pr
pr
pr
pr
pr
pr
su
su
sA
aM
aM
aM
aM
hq
hq
hq
UM
hq
hq
hq
su
su
su
su
sA
su
pr
pr
pr
pr
pr
pr
pr
Zy
"}
(22,1,1) = {"
Zy
pr
pr
pr
pr
pr
su
su
su
sA
aM
su
su
aM
aM
hq
hq
hq
hq
hq
hq
su
su
mC
su
sA
su
pr
pr
pr
pr
pr
pr
pr
Zy
"}
(23,1,1) = {"
Zy
pr
pr
pr
pr
su
su
su
su
sA
aM
aM
su
su
su
hq
hq
hq
hq
hq
hq
su
su
su
aM
sA
su
pr
pr
pr
pr
pr
pr
pr
Zy
"}
(24,1,1) = {"
Zy
pr
pr
pr
pr
su
su
cb
nh
vk
su
aM
su
mC
su
su
kd
hq
hq
hq
hq
su
kd
su
aM
ug
nh
cb
su
su
pr
pr
pr
pr
Zy
"}
(25,1,1) = {"
Zy
pr
Kt
Kt
Kt
cc
Kt
Kt
Kt
eM
su
aM
TL
su
su
su
aM
sA
hq
hq
aM
su
su
aM
aM
lo
Kt
Kt
Kt
mG
Kt
Kt
su
pr
Zy
"}
(26,1,1) = {"
Zy
pr
uu
mG
Bh
mG
mG
Rp
Kt
eM
su
su
aM
aM
su
ot
aM
aM
su
su
aM
aM
su
aM
su
lo
Kt
Rp
mG
mG
mG
su
su
pr
Zy
"}
(27,1,1) = {"
Zy
pr
Kt
mG
mG
mG
mG
mG
Kt
eM
su
su
su
Dw
aM
aM
aM
su
mC
su
su
aM
aM
hz
su
lo
Kt
mG
AI
mG
su
su
uu
pr
Zy
"}
(28,1,1) = {"
Zy
pr
Kt
AI
mG
VJ
mG
VJ
kz
eM
su
iw
su
su
aM
su
su
su
su
su
Si
aM
aM
ot
su
lo
zl
VJ
mG
VJ
su
su
Kt
pr
Zy
"}
(29,1,1) = {"
Zy
pr
su
su
mG
VJ
mG
VJ
kz
eM
su
su
TL
aM
KS
aM
su
su
kd
su
aM
TL
aM
aM
su
lo
zl
VJ
TI
hY
su
su
Kt
pr
Zy
"}
(30,1,1) = {"
Zy
pr
su
su
mG
VJ
mG
VJ
kz
eM
su
aM
aM
su
su
aM
hz
su
su
KS
aM
su
su
aM
su
lo
zl
VJ
mG
hY
su
su
Kt
pr
Zy
"}
(31,1,1) = {"
Zy
pr
su
su
dg
mG
mG
mG
Kt
eM
su
aM
su
su
su
su
aM
aM
aM
aM
su
su
su
aM
aM
lo
Kt
mG
mG
su
dg
su
Kt
pr
Zy
"}
(32,1,1) = {"
Zy
pr
su
su
su
mG
mG
Rp
Kt
KO
nh
nh
nh
nh
nh
nh
nh
nh
nh
nh
nh
nh
nh
nh
nh
Mq
Kt
Rp
mG
mG
su
su
Kt
pr
Zy
"}
(33,1,1) = {"
Zy
pr
uu
su
su
rg
Kt
Kt
Kt
Kt
Kt
rV
rV
rV
rV
Kt
Kt
Kt
Kt
Kt
rV
rV
rV
rV
Kt
Kt
Kt
Kt
Kt
cc
Kt
su
su
pr
Zy
"}
(34,1,1) = {"
Zy
pr
uu
su
su
su
mG
AI
Kt
gE
mG
SG
VJ
VJ
SG
Kt
Rp
ax
qA
Kt
SG
VJ
VJ
SG
mG
Rp
Kt
AI
mG
mG
mG
mG
su
pr
Zy
"}
(35,1,1) = {"
Zy
pr
Kt
su
ZA
su
su
mG
uu
mG
mG
mG
mG
mG
mG
Kt
mG
ie
mG
Kt
mG
mG
mG
mG
mG
mG
Kt
mG
mG
mG
mG
su
uu
pr
Zy
"}
(36,1,1) = {"
Zy
pr
Kt
mG
su
su
su
su
cc
mG
mG
VJ
VJ
Fw
VJ
pV
mG
yT
mG
pV
VJ
Fw
VJ
VJ
mG
mG
cc
mG
mG
Hj
su
su
su
pr
Zy
"}
(37,1,1) = {"
Zy
pr
Kt
mG
su
su
su
su
Kt
mG
mG
mG
su
su
su
Kt
mG
ie
mG
Kt
mG
su
su
mG
mG
mG
Kt
mG
mG
mG
su
mG
su
pr
Zy
"}
(38,1,1) = {"
Zy
pr
Kt
ie
mG
su
qC
su
Kt
gE
mG
hY
Mk
hY
hY
Kt
qA
ax
Rp
Kt
hY
hY
Mk
hY
su
Rp
Kt
In
mG
su
su
UD
uu
pr
Zy
"}
(39,1,1) = {"
Zy
pr
Kt
Kt
Kt
su
su
su
Kt
Kt
nY
nY
uu
uu
nY
Kt
Kt
Kt
Kt
Kt
Kt
nY
Kt
Kt
nY
Kt
Kt
Kt
Kt
su
uu
uu
uu
pr
Zy
"}
(40,1,1) = {"
Zy
pr
pr
pr
pr
pr
pr
pr
pr
pr
pr
pr
pr
pr
pr
pr
pr
pr
pr
pr
pr
pr
pr
pr
pr
pr
pr
pr
pr
pr
pr
pr
pr
pr
Zy
"}
(41,1,1) = {"
Zy
Zy
Zy
Zy
Zy
Zy
Zy
Zy
Zy
Zy
Zy
Zy
Zy
Zy
Zy
Zy
Zy
Zy
Zy
Zy
Zy
Zy
Zy
Zy
Zy
Zy
Zy
Zy
Zy
Zy
Zy
Zy
Zy
Zy
Zy
"}
