//MAP CONVERTED BY dmm2tgm.py THIS HEADER COMMENT PREVENTS RECONVERSION, DO NOT REMOVE
"aa" = (
/obj/structure/bed/chair/bay/comfy/blue{
	dir = 8
	},
/mob/living/simple_mob/humanoid/merc/ranged/space/suppressor/elite,
/turf/simulated/shuttle/floor/black,
/area/submap/dronelord)
"aj" = (
/turf/simulated/shuttle/wall/voidcraft/orange,
/area/submap/dronelord)
"ax" = (
/obj/structure/table/glass,
/obj/random/firstaid,
/obj/random/firstaid,
/obj/random/firstaid,
/obj/machinery/light/poi,
/turf/simulated/shuttle/floor/white,
/area/submap/dronelord)
"ay" = (
/mob/living/simple_mob/mechanical/combat_drone{
	faction = "syndicate"
	},
/turf/simulated/shuttle/floor/purple,
/area/submap/dronelord)
"bl" = (
/obj/structure/table/steel_reinforced,
/obj/machinery/recharger,
/turf/simulated/shuttle/floor/black,
/area/submap/dronelord)
"bA" = (
/obj/machinery/power/apc{
	dir = 1;
	pixel_y = 24
	},
/obj/structure/cable{
	d2 = 2;
	icon_state = "0-2"
	},
/obj/machinery/light/poi{
	dir = 1
	},
/turf/simulated/shuttle/floor/yellow,
/area/submap/dronelord)
"cw" = (
/obj/machinery/porta_turret/poi{
	faction = "syndicate"
	},
/turf/simulated/shuttle/floor/red,
/area/submap/dronelord)
"cS" = (
/obj/machinery/body_scanconsole,
/turf/simulated/shuttle/floor/white,
/area/submap/dronelord)
"dq" = (
/obj/structure/table/standard,
/turf/simulated/shuttle/floor/purple,
/area/submap/dronelord)
"dw" = (
/obj/item/gun/projectile/heavysniper,
/obj/item/tank/jetpack/oxygen,
/turf/simulated/shuttle/floor/black,
/area/submap/dronelord)
"ec" = (
/obj/structure/closet/toolcloset,
/obj/random/tool/power,
/obj/random/tool/power,
/obj/random/tool/power,
/turf/simulated/shuttle/floor/yellow,
/area/submap/dronelord)
"eD" = (
/obj/structure/table/steel_reinforced,
/obj/machinery/recharger,
/obj/machinery/light/poi{
	dir = 1
	},
/turf/simulated/shuttle/floor/black,
/area/submap/dronelord)
"eL" = (
/obj/machinery/portable_atmospherics/canister/empty/oxygen,
/turf/simulated/shuttle/floor/yellow,
/area/submap/dronelord)
"fU" = (
/obj/structure/grille/rustic{
	health = 25;
	name = "reinforced grille"
	},
/obj/structure/window/plastitanium/full,
/obj/structure/window/reinforced/survival_pod{
	dir = 4
	},
/obj/structure/window/reinforced/survival_pod{
	dir = 1
	},
/obj/structure/window/reinforced/survival_pod{
	dir = 8
	},
/obj/machinery/door/blast/regular,
/turf/simulated/shuttle/floor/black,
/area/submap/dronelord)
"gQ" = (
/obj/machinery/power/terminal{
	dir = 1;
	icon_state = "term"
	},
/obj/structure/cable{
	d2 = 8;
	icon_state = "0-8"
	},
/turf/simulated/shuttle/floor/yellow,
/area/submap/dronelord)
"jy" = (
/obj/structure/table/glass,
/obj/item/storage/firstaid/clotting,
/turf/simulated/shuttle/floor/white,
/area/submap/dronelord)
"ko" = (
/turf/simulated/shuttle/wall/voidcraft/lightblue,
/area/submap/dronelord)
"kD" = (
/mob/living/simple_mob/mechanical/combat_drone{
	faction = "syndicate"
	},
/obj/structure/cable{
	d1 = 1;
	d2 = 8;
	icon_state = "1-8"
	},
/obj/structure/cable{
	d1 = 1;
	d2 = 4;
	icon_state = "1-4"
	},
/turf/simulated/shuttle/floor/yellow,
/area/submap/dronelord)
"kG" = (
/obj/effect/map_helper/no_phaseshift/area,
/turf/simulated/shuttle/floor/voidcraft,
/area/submap/dronelord)
"lO" = (
/mob/living/simple_mob/mechanical/combat_drone{
	faction = "syndicate"
	},
/turf/simulated/shuttle/floor/red,
/area/submap/dronelord)
"mG" = (
/obj/machinery/porta_turret/poi{
	faction = "syndicate"
	},
/obj/machinery/light/poi,
/turf/simulated/shuttle/floor/darkred,
/area/submap/dronelord)
"mO" = (
/obj/structure/grille/rustic{
	health = 25;
	name = "reinforced grille"
	},
/obj/structure/window/plastitanium/full,
/obj/structure/window/reinforced/survival_pod{
	dir = 4
	},
/obj/structure/window/reinforced/survival_pod{
	dir = 8
	},
/obj/machinery/door/blast/regular,
/turf/simulated/shuttle/floor/black,
/area/submap/dronelord)
"od" = (
/turf/simulated/shuttle/floor/white,
/area/submap/dronelord)
"sV" = (
/obj/structure/table/standard,
/obj/item/telecube/randomized,
/turf/simulated/shuttle/floor/purple,
/area/submap/dronelord)
"tK" = (
/turf/simulated/mineral/floor/ignore_mapgen/sif,
/area/submap/dronelord)
"wv" = (
/mob/living/simple_mob/mechanical/combat_drone{
	faction = "syndicate"
	},
/turf/simulated/shuttle/floor/black,
/area/submap/dronelord)
"wZ" = (
/obj/structure/shuttle/engine/propulsion{
	dir = 4;
	icon_state = "propulsion_r"
	},
/turf/simulated/shuttle/wall/voidcraft/orange,
/area/submap/dronelord)
"xz" = (
/obj/structure/table/glass,
/obj/item/storage/firstaid/adv,
/turf/simulated/shuttle/floor/white,
/area/submap/dronelord)
"yh" = (
/turf/simulated/wall/durasteel,
/area/submap/dronelord)
"zi" = (
/obj/machinery/porta_turret/poi{
	faction = "syndicate"
	},
/turf/simulated/shuttle/plating,
/area/submap/dronelord)
"BM" = (
/obj/machinery/porta_turret/poi{
	faction = "syndicate"
	},
/turf/simulated/shuttle/floor/purple,
/area/submap/dronelord)
"En" = (
/obj/structure/closet/secure_closet/guncabinet,
/obj/item/gun/projectile/giskard/olivaw,
/obj/item/gun/energy/lasershotgun,
/obj/item/gun/energy/particle/cannon,
/turf/simulated/shuttle/floor/red,
/area/submap/dronelord)
"Fc" = (
/obj/structure/grille/rustic{
	health = 25;
	name = "reinforced grille"
	},
/obj/structure/window/plastitanium/full,
/obj/structure/window/reinforced/survival_pod{
	dir = 4
	},
/obj/structure/window/reinforced/survival_pod,
/obj/structure/window/reinforced/survival_pod{
	dir = 8
	},
/obj/machinery/door/blast/regular,
/turf/simulated/shuttle/floor/black,
/area/submap/dronelord)
"FQ" = (
/obj/machinery/power/smes/buildable/point_of_interest,
/turf/simulated/shuttle/floor/yellow,
/area/submap/dronelord)
"Gi" = (
/obj/machinery/porta_turret/poi{
	faction = "syndicate"
	},
/obj/machinery/light/poi{
	dir = 1
	},
/turf/simulated/shuttle/floor/darkred,
/area/submap/dronelord)
"GM" = (
/mob/living/simple_mob/mechanical/combat_drone{
	faction = "syndicate"
	},
/turf/simulated/shuttle/floor/white,
/area/submap/dronelord)
"Ic" = (
/obj/machinery/computer{
	dir = 4
	},
/turf/simulated/shuttle/floor/black,
/area/submap/dronelord)
"Ix" = (
/obj/machinery/light/poi{
	dir = 8
	},
/turf/simulated/shuttle/floor/voidcraft,
/area/submap/dronelord)
"IU" = (
/turf/simulated/shuttle/floor/red,
/area/submap/dronelord)
"Ja" = (
/obj/machinery/power/port_gen/pacman/super,
/obj/structure/cable{
	d2 = 2;
	icon_state = "0-2"
	},
/turf/simulated/shuttle/floor/yellow,
/area/submap/dronelord)
"JY" = (
/turf/simulated/shuttle/floor/yellow,
/area/submap/dronelord)
"Kp" = (
/obj/machinery/door/airlock/external,
/turf/simulated/shuttle/floor/voidcraft,
/area/submap/dronelord)
"Kv" = (
/turf/simulated/shuttle/floor/voidcraft,
/area/submap/dronelord)
"KU" = (
/obj/structure/table/steel_reinforced,
/obj/item/stack/material/glass{
	amount = 50;
	pixel_x = 3;
	pixel_y = 3
	},
/obj/item/stack/material/steel{
	amount = 50
	},
/turf/simulated/shuttle/floor/black,
/area/submap/dronelord)
"Lv" = (
/obj/machinery/autolathe,
/obj/machinery/light/poi,
/turf/simulated/shuttle/floor/black,
/area/submap/dronelord)
"Ov" = (
/turf/simulated/shuttle/floor/purple,
/area/submap/dronelord)
"OA" = (
/obj/structure/cable{
	d1 = 1;
	d2 = 4;
	icon_state = "1-4"
	},
/turf/simulated/shuttle/floor/yellow,
/area/submap/dronelord)
"RI" = (
/obj/item/tank/jetpack/oxygen,
/obj/item/gun/projectile/automatic/sts35,
/turf/simulated/shuttle/floor/black,
/area/submap/dronelord)
"RV" = (
/turf/template_noop,
/area/template_noop)
"Sw" = (
/obj/machinery/bodyscanner,
/turf/simulated/shuttle/floor/white,
/area/submap/dronelord)
"TX" = (
/obj/structure/shuttle/engine/heater{
	dir = 4
	},
/obj/structure/window/reinforced{
	dir = 8
	},
/turf/simulated/shuttle/wall/voidcraft/orange,
/area/submap/dronelord)
"Ul" = (
/obj/structure/closet/secure_closet/guncabinet,
/obj/item/gun/projectile/multi_cannon,
/obj/machinery/light/poi{
	dir = 1
	},
/obj/item/ammo_casing/macrobattery/buff,
/obj/item/ammo_casing/macrobattery/ouchie,
/obj/item/ammo_casing/macrobattery/healie,
/turf/simulated/shuttle/floor/red,
/area/submap/dronelord)
"Uz" = (
/obj/structure/table/standard,
/obj/item/card/emag/used,
/obj/machinery/light/poi,
/turf/simulated/shuttle/floor/purple,
/area/submap/dronelord)
"VO" = (
/turf/simulated/shuttle/floor/black,
/area/submap/dronelord)
"WO" = (
/obj/structure/closet/secure_closet/guncabinet,
/obj/item/gun/magnetic/matfed,
/obj/item/gun/energy/ionrifle,
/obj/item/gun/energy/sickshot,
/turf/simulated/shuttle/floor/red,
/area/submap/dronelord)
"YR" = (
/obj/machinery/light/poi{
	dir = 4
	},
/turf/simulated/shuttle/floor/voidcraft,
/area/submap/dronelord)

(1,1,1) = {"
RV
RV
RV
RV
RV
RV
RV
RV
RV
RV
RV
RV
RV
RV
RV
RV
RV
RV
RV
"}
(2,1,1) = {"
RV
RV
RV
RV
RV
tK
tK
tK
tK
tK
tK
tK
tK
tK
RV
RV
RV
RV
RV
"}
(3,1,1) = {"
RV
RV
RV
RV
tK
tK
tK
tK
tK
tK
tK
tK
tK
tK
tK
RV
RV
RV
RV
"}
(4,1,1) = {"
RV
RV
RV
tK
tK
tK
tK
tK
tK
tK
tK
tK
tK
tK
tK
tK
RV
RV
RV
"}
(5,1,1) = {"
RV
RV
tK
tK
tK
tK
tK
tK
tK
tK
tK
tK
tK
tK
tK
tK
tK
RV
RV
"}
(6,1,1) = {"
RV
tK
tK
tK
tK
tK
aj
aj
fU
mO
Fc
aj
aj
tK
tK
tK
tK
tK
RV
"}
(7,1,1) = {"
RV
tK
tK
tK
tK
aj
aj
Ic
Ic
Ic
Ic
Ic
aj
aj
tK
tK
tK
tK
RV
"}
(8,1,1) = {"
RV
tK
tK
tK
tK
aj
bl
VO
aa
VO
aa
VO
KU
aj
tK
tK
tK
tK
RV
"}
(9,1,1) = {"
RV
tK
tK
tK
tK
aj
eD
VO
VO
wv
VO
VO
Lv
aj
tK
tK
tK
tK
RV
"}
(10,1,1) = {"
RV
tK
tK
tK
tK
aj
aj
aj
VO
VO
VO
aj
aj
aj
tK
tK
tK
tK
RV
"}
(11,1,1) = {"
RV
tK
tK
tK
zi
aj
aj
aj
aj
VO
aj
aj
aj
aj
zi
tK
tK
tK
RV
"}
(12,1,1) = {"
RV
tK
tK
tK
tK
aj
aj
cw
aj
Kp
aj
BM
aj
aj
tK
tK
tK
tK
RV
"}
(13,1,1) = {"
RV
tK
tK
tK
tK
aj
En
IU
aj
Kv
aj
Ov
dq
aj
tK
tK
tK
tK
RV
"}
(14,1,1) = {"
RV
tK
tK
tK
tK
aj
Ul
lO
Kp
Kv
Kp
ay
Uz
aj
tK
tK
tK
tK
RV
"}
(15,1,1) = {"
RV
tK
tK
tK
tK
aj
WO
IU
aj
YR
aj
Ov
sV
aj
tK
tK
tK
tK
RV
"}
(16,1,1) = {"
RV
tK
tK
tK
tK
aj
aj
cw
aj
Kp
aj
BM
aj
aj
tK
tK
tK
tK
RV
"}
(17,1,1) = {"
RV
tK
tK
tK
zi
aj
aj
aj
aj
Kv
aj
aj
aj
aj
zi
tK
tK
tK
RV
"}
(18,1,1) = {"
RV
tK
tK
tK
tK
aj
dw
yh
Gi
kG
mG
yh
RI
aj
tK
tK
tK
tK
RV
"}
(19,1,1) = {"
RV
tK
tK
tK
tK
aj
aj
aj
aj
Kv
aj
aj
aj
aj
tK
tK
tK
tK
RV
"}
(20,1,1) = {"
RV
tK
tK
tK
tK
aj
ec
JY
aj
Kp
aj
od
Sw
aj
tK
tK
tK
tK
RV
"}
(21,1,1) = {"
RV
tK
tK
tK
tK
aj
Ja
OA
aj
Ix
aj
od
cS
aj
tK
tK
tK
tK
RV
"}
(22,1,1) = {"
RV
tK
tK
tK
tK
aj
bA
kD
Kp
Kv
Kp
GM
ax
aj
tK
tK
tK
tK
RV
"}
(23,1,1) = {"
RV
tK
tK
tK
zi
aj
FQ
gQ
aj
Kv
ko
od
xz
aj
zi
tK
tK
tK
RV
"}
(24,1,1) = {"
RV
tK
tK
tK
tK
aj
eL
eL
aj
Kv
ko
od
jy
aj
tK
tK
tK
tK
RV
"}
(25,1,1) = {"
RV
tK
tK
tK
tK
TX
TX
TX
aj
Kp
aj
TX
TX
TX
tK
tK
tK
tK
RV
"}
(26,1,1) = {"
RV
tK
tK
tK
tK
wZ
wZ
wZ
aj
Kv
aj
wZ
wZ
wZ
tK
tK
tK
tK
RV
"}
(27,1,1) = {"
RV
tK
tK
tK
tK
tK
tK
tK
tK
tK
tK
tK
tK
tK
tK
tK
tK
tK
RV
"}
(28,1,1) = {"
RV
RV
tK
tK
tK
tK
tK
tK
tK
tK
tK
tK
tK
tK
tK
tK
tK
RV
RV
"}
(29,1,1) = {"
RV
RV
RV
tK
tK
tK
tK
tK
tK
tK
tK
tK
tK
tK
tK
tK
RV
RV
RV
"}
(30,1,1) = {"
RV
RV
RV
RV
tK
tK
tK
tK
tK
tK
tK
tK
tK
tK
tK
RV
RV
RV
RV
"}
(31,1,1) = {"
RV
RV
RV
RV
RV
tK
tK
tK
tK
tK
tK
tK
tK
tK
RV
RV
RV
RV
RV
"}
(32,1,1) = {"
RV
RV
RV
RV
RV
RV
RV
RV
RV
RV
RV
RV
RV
RV
RV
RV
RV
RV
RV
"}
