//MAP CONVERTED BY dmm2tgm.py THIS HEADER COMMENT PREVENTS RECONVERSION, DO NOT REMOVE
"bc" = (
/obj/effect/floor_decal/borderfloorblack{
	dir = 6
	},
/turf/simulated/floor/reinforced,
/area/submap/eclipsedigsight)
"bl" = (
/obj/machinery/light{
	dir = 4
	},
/obj/effect/floor_decal/corner/grey/diagonal,
/obj/structure/bed/double/padded,
/obj/item/bedsheet/orangedouble,
/turf/simulated/floor/tiled/monotile,
/area/submap/eclipsedigsight)
"cm" = (
/obj/machinery/door/airlock/research,
/turf/simulated/floor/reinforced,
/area/submap/eclipsedigsight)
"cB" = (
/obj/effect/floor_decal/corner/purple/diagonal,
/obj/structure/table/reinforced,
/obj/item/archaeological_find,
/obj/item/archaeological_find,
/obj/random/firstaid,
/turf/simulated/floor/tiled/monotile,
/area/submap/eclipsedigsight)
"ed" = (
/obj/effect/floor_decal/borderfloorblack,
/turf/simulated/floor/reinforced,
/area/submap/eclipsedigsight)
"es" = (
/obj/machinery/door/airlock/research,
/turf/simulated/floor/tiled/monotile,
/area/submap/eclipsedigsight)
"eW" = (
/obj/structure/grille/cult{
	name = "Alien grille"
	},
/obj/structure/window/titanium/full,
/obj/structure/window/phoronreinforced{
	dir = 8
	},
/obj/structure/window/phoronreinforced{
	dir = 1
	},
/obj/structure/window/phoronreinforced{
	dir = 4
	},
/turf/simulated/floor/reinforced,
/area/submap/eclipsedigsight)
"fa" = (
/obj/structure/window/phoronreinforced,
/obj/structure/window/phoronreinforced{
	dir = 1
	},
/obj/structure/grille/cult{
	name = "Alien grille"
	},
/obj/structure/window/titanium/full,
/turf/simulated/floor/tiled/monotile,
/area/submap/eclipsedigsight)
"fq" = (
/obj/structure/cliff/automatic{
	dir = 8
	},
/turf/simulated/floor/outdoors/dirt,
/area/submap/eclipsedigsight)
"fF" = (
/obj/structure/cliff/automatic{
	dir = 2
	},
/turf/simulated/floor/outdoors/dirt,
/area/submap/eclipsedigsight)
"gt" = (
/obj/machinery/artifact,
/turf/simulated/floor/reinforced,
/area/submap/eclipsedigsight)
"gZ" = (
/obj/effect/floor_decal/corner/purple/diagonal,
/obj/machinery/light{
	dir = 4
	},
/obj/structure/table/reinforced,
/obj/item/anodevice,
/obj/item/melee/baton/loaded,
/turf/simulated/floor/tiled/monotile,
/area/submap/eclipsedigsight)
"hU" = (
/turf/template_noop,
/area/template_noop)
"jv" = (
/obj/effect/floor_decal/borderfloorblack{
	dir = 8
	},
/turf/simulated/floor/reinforced,
/area/submap/eclipsedigsight)
"kZ" = (
/turf/simulated/floor/reinforced,
/area/submap/eclipsedigsight)
"lk" = (
/obj/effect/floor_decal/corner/purple/diagonal,
/obj/machinery/light,
/mob/living/simple_mob/humanoid/eclipse/solar/teslanoodle,
/turf/simulated/floor/tiled/monotile,
/area/submap/eclipsedigsight)
"ly" = (
/obj/effect/floor_decal/corner/purple/diagonal,
/obj/machinery/cell_charger,
/obj/item/melee/baton/loaded,
/obj/item/geiger,
/obj/structure/table/reinforced,
/turf/simulated/floor/tiled/monotile,
/area/submap/eclipsedigsight)
"lF" = (
/obj/structure/cliff/automatic/corner,
/turf/simulated/floor/outdoors/dirt,
/area/submap/eclipsedigsight)
"md" = (
/obj/structure/cliff/automatic/corner,
/turf/simulated/floor/lava{
	nitrogen = 93.7835;
	oxygen = 20.7263;
	temperature = 243.15
	},
/area/submap/eclipsedigsight)
"mm" = (
/turf/simulated/wall/r_wall,
/area/submap/eclipsedigsight)
"mU" = (
/obj/structure/cliff/automatic{
	dir = 4
	},
/turf/simulated/floor/outdoors/dirt,
/area/submap/eclipsedigsight)
"nN" = (
/obj/structure/cliff/automatic{
	dir = 10
	},
/turf/simulated/floor/outdoors/dirt,
/area/submap/eclipsedigsight)
"nP" = (
/obj/structure/cliff/automatic/corner{
	dir = 9
	},
/turf/simulated/floor/lava{
	nitrogen = 93.7835;
	oxygen = 20.7263;
	temperature = 243.15
	},
/area/submap/eclipsedigsight)
"nQ" = (
/obj/effect/floor_decal/borderfloorwhite{
	dir = 9
	},
/turf/simulated/floor/reinforced,
/area/submap/eclipsedigsight)
"pW" = (
/turf/simulated/floor/outdoors/dirt,
/area/submap/eclipsedigsight)
"rk" = (
/obj/effect/floor_decal/corner/purple/diagonal,
/mob/living/simple_mob/humanoid/eclipse/solar/firemoff,
/turf/simulated/floor/tiled/monotile,
/area/submap/eclipsedigsight)
"rn" = (
/obj/effect/floor_decal/borderfloorwhite{
	dir = 10
	},
/turf/simulated/floor/reinforced,
/area/submap/eclipsedigsight)
"rA" = (
/obj/structure/cliff/automatic{
	dir = 6
	},
/turf/simulated/floor/outdoors/dirt,
/area/submap/eclipsedigsight)
"sb" = (
/obj/effect/floor_decal/corner/purple/diagonal,
/obj/machinery/light{
	dir = 4
	},
/turf/simulated/floor/tiled/monotile,
/area/submap/eclipsedigsight)
"sE" = (
/obj/effect/floor_decal/corner/purple/diagonal,
/obj/structure/table/reinforced,
/obj/item/archaeological_find,
/obj/item/archaeological_find,
/turf/simulated/floor/tiled/monotile,
/area/submap/eclipsedigsight)
"sH" = (
/obj/effect/floor_decal/corner/purple/diagonal,
/turf/simulated/floor/tiled/monotile,
/area/submap/eclipsedigsight)
"sQ" = (
/obj/effect/floor_decal/corner/purple/diagonal,
/obj/structure/table/reinforced,
/obj/item/archaeological_find,
/obj/item/archaeological_find,
/obj/random/tool/alien,
/obj/item/paper{
	info = "High volume of precursor artifacts have been located within the surrounding mountain range. Our scouting teams have even engaged with several living precursor remnants, and those armed with similar gear. Causalities have been kept to a minimum,  but this area is full of hostiles. We had a mass firefight with a group of invaders, several seeming to return from the death, just within the last week. We are making a request to the Head Admiral to gain access to one mecha unit.";
	name = "Status Report"
	},
/turf/simulated/floor/tiled/monotile,
/area/submap/eclipsedigsight)
"th" = (
/obj/machinery/power/apc{
	pixel_y = -24
	},
/obj/machinery/power/terminal{
	dir = 1;
	icon_state = "term"
	},
/turf/simulated/floor/reinforced,
/area/submap/eclipsedigsight)
"uQ" = (
/obj/structure/grille/cult{
	name = "Alien grille"
	},
/obj/structure/window/titanium/full,
/obj/structure/window/phoronreinforced{
	dir = 8
	},
/obj/structure/window/phoronreinforced{
	dir = 1
	},
/obj/structure/window/phoronreinforced{
	dir = 4
	},
/obj/structure/window/phoronreinforced,
/turf/simulated/floor/reinforced,
/area/submap/eclipsedigsight)
"vY" = (
/obj/effect/floor_decal/corner/grey/diagonal,
/mob/living/simple_mob/humanoid/eclipse/solar/radiation,
/turf/simulated/floor/tiled/monotile,
/area/submap/eclipsedigsight)
"wd" = (
/obj/effect/floor_decal/corner/grey/diagonal,
/obj/structure/table/reinforced,
/obj/random/maintenance/foodstuff,
/obj/random/maintenance/foodstuff,
/obj/item/archaeological_find,
/turf/simulated/floor/tiled/monotile,
/area/submap/eclipsedigsight)
"wm" = (
/obj/structure/cliff/automatic{
	dir = 6
	},
/turf/simulated/floor/lava{
	nitrogen = 93.7835;
	oxygen = 20.7263;
	temperature = 243.15
	},
/area/submap/eclipsedigsight)
"wH" = (
/obj/effect/floor_decal/corner/purple/diagonal,
/obj/structure/table/reinforced,
/obj/item/anodevice,
/turf/simulated/floor/tiled/monotile,
/area/submap/eclipsedigsight)
"xF" = (
/obj/effect/floor_decal/corner/purple/diagonal,
/obj/structure/table/reinforced,
/obj/item/storage/box/monkeycubes,
/turf/simulated/floor/tiled/monotile,
/area/submap/eclipsedigsight)
"zN" = (
/obj/effect/floor_decal/borderfloorblack{
	dir = 1
	},
/turf/simulated/floor/reinforced,
/area/submap/eclipsedigsight)
"AK" = (
/obj/effect/floor_decal/corner/purple/diagonal,
/obj/structure/table/reinforced,
/obj/machinery/cell_charger,
/obj/item/melee/baton/loaded,
/obj/item/geiger,
/turf/simulated/floor/tiled/monotile,
/area/submap/eclipsedigsight)
"CL" = (
/turf/simulated/wall,
/area/submap/eclipsedigsight)
"CQ" = (
/obj/effect/floor_decal/corner/purple/diagonal,
/obj/item/anodevice,
/obj/machinery/cell_charger,
/obj/item/melee/baton/loaded,
/obj/structure/table/reinforced,
/turf/simulated/floor/tiled/monotile,
/area/submap/eclipsedigsight)
"Dp" = (
/obj/effect/floor_decal/corner/purple/diagonal,
/obj/item/anodevice,
/obj/item/storage/box/monkeycubes,
/obj/structure/table/reinforced,
/turf/simulated/floor/tiled/monotile,
/area/submap/eclipsedigsight)
"Dq" = (
/obj/structure/cliff/automatic/corner{
	dir = 9
	},
/turf/simulated/floor/outdoors/dirt,
/area/submap/eclipsedigsight)
"DN" = (
/obj/machinery/door/window/southright,
/turf/simulated/floor/reinforced,
/area/submap/eclipsedigsight)
"DV" = (
/obj/effect/floor_decal/borderfloorwhite{
	dir = 8
	},
/turf/simulated/floor/reinforced,
/area/submap/eclipsedigsight)
"EM" = (
/obj/machinery/power/smes/buildable/point_of_interest,
/turf/simulated/floor/reinforced,
/area/submap/eclipsedigsight)
"EY" = (
/obj/effect/floor_decal/corner/grey/diagonal,
/mob/living/simple_mob/humanoid/eclipse/solar/guardian,
/turf/simulated/floor/tiled/monotile,
/area/submap/eclipsedigsight)
"Fc" = (
/turf/simulated/floor/lava{
	nitrogen = 93.7835;
	oxygen = 20.7263;
	temperature = 243.15
	},
/area/submap/eclipsedigsight)
"FE" = (
/obj/effect/floor_decal/borderfloorwhite,
/turf/simulated/floor/reinforced,
/area/submap/eclipsedigsight)
"FQ" = (
/obj/effect/floor_decal/borderfloorblack{
	dir = 10
	},
/turf/simulated/floor/reinforced,
/area/submap/eclipsedigsight)
"FS" = (
/obj/effect/floor_decal/corner/grey/diagonal,
/obj/structure/bed/double/padded,
/obj/item/bedsheet/orangedouble,
/turf/simulated/floor/tiled/monotile,
/area/submap/eclipsedigsight)
"Gg" = (
/obj/structure/cliff/automatic/corner{
	dir = 10
	},
/turf/simulated/floor/lava{
	nitrogen = 93.7835;
	oxygen = 20.7263;
	temperature = 243.15
	},
/area/submap/eclipsedigsight)
"Hx" = (
/obj/structure/cliff/automatic{
	dir = 9
	},
/turf/simulated/floor/outdoors/dirt,
/area/submap/eclipsedigsight)
"Is" = (
/mob/living/simple_mob/humanoid/eclipse/solar/hellhound,
/turf/simulated/floor/outdoors/dirt,
/area/submap/eclipsedigsight)
"IA" = (
/obj/effect/floor_decal/corner/purple/diagonal,
/obj/structure/table/reinforced,
/obj/item/archaeological_find,
/obj/item/archaeological_find,
/obj/random/rigsuit,
/turf/simulated/floor/tiled/monotile,
/area/submap/eclipsedigsight)
"JB" = (
/obj/structure/window/phoronreinforced,
/obj/structure/window/phoronreinforced{
	dir = 8
	},
/obj/structure/window/phoronreinforced{
	dir = 1
	},
/obj/structure/grille/cult{
	name = "Alien grille"
	},
/obj/structure/window/titanium/full,
/turf/simulated/floor/tiled/monotile,
/area/submap/eclipsedigsight)
"JD" = (
/obj/structure/cliff/automatic,
/turf/simulated/floor/outdoors/dirt,
/area/submap/eclipsedigsight)
"JI" = (
/obj/machinery/door/window/southright{
	dir = 8
	},
/turf/simulated/floor/reinforced,
/area/submap/eclipsedigsight)
"KF" = (
/obj/structure/cliff/automatic{
	dir = 10
	},
/turf/simulated/floor/lava{
	nitrogen = 93.7835;
	oxygen = 20.7263;
	temperature = 243.15
	},
/area/submap/eclipsedigsight)
"KQ" = (
/obj/machinery/light{
	dir = 1
	},
/obj/effect/floor_decal/corner/purple/diagonal,
/turf/simulated/floor/tiled/monotile,
/area/submap/eclipsedigsight)
"Le" = (
/obj/effect/floor_decal/borderfloorblack{
	dir = 4
	},
/turf/simulated/floor/reinforced,
/area/submap/eclipsedigsight)
"Ma" = (
/obj/effect/floor_decal/borderfloorwhite{
	dir = 1
	},
/turf/simulated/floor/reinforced,
/area/submap/eclipsedigsight)
"Mk" = (
/obj/effect/floor_decal/corner/purple/diagonal,
/obj/structure/table/reinforced,
/obj/item/archaeological_find,
/obj/item/archaeological_find,
/obj/random/toolbox,
/obj/machinery/light,
/turf/simulated/floor/tiled/monotile,
/area/submap/eclipsedigsight)
"MD" = (
/mob/living/simple_mob/humanoid/eclipse/solar/snipertesh,
/obj/item/stack/material/void_opal,
/turf/simulated/floor/outdoors/dirt,
/area/submap/eclipsedigsight)
"MR" = (
/obj/effect/floor_decal/corner/purple/diagonal,
/obj/machinery/door/window/southright,
/turf/simulated/floor/tiled/monotile,
/area/submap/eclipsedigsight)
"NS" = (
/obj/effect/floor_decal/corner/purple/diagonal,
/mob/living/simple_mob/humanoid/eclipse/lunar/silvernoodle,
/turf/simulated/floor/tiled/monotile,
/area/submap/eclipsedigsight)
"Oy" = (
/obj/effect/floor_decal/corner/purple/diagonal,
/obj/machinery/vending/foodfish,
/turf/simulated/floor/tiled/monotile,
/area/submap/eclipsedigsight)
"ON" = (
/obj/machinery/light,
/mob/living/simple_mob/humanoid/eclipse/lunar/pummler,
/turf/simulated/floor/reinforced,
/area/submap/eclipsedigsight)
"OT" = (
/obj/effect/map_helper/no_phaseshift/area,
/turf/simulated/floor/outdoors/dirt,
/area/submap/eclipsedigsight)
"Pb" = (
/obj/effect/floor_decal/borderfloorwhite{
	dir = 5
	},
/turf/simulated/floor/reinforced,
/area/submap/eclipsedigsight)
"Pv" = (
/obj/structure/grille/cult{
	name = "Alien grille"
	},
/obj/structure/window/titanium/full,
/obj/structure/window/phoronreinforced{
	dir = 8
	},
/obj/structure/window/phoronreinforced{
	dir = 1
	},
/obj/structure/window/phoronreinforced,
/obj/structure/window/phoronreinforced{
	dir = 4
	},
/turf/simulated/floor/reinforced,
/area/submap/eclipsedigsight)
"PT" = (
/obj/structure/cliff/automatic{
	dir = 8
	},
/turf/simulated/floor/lava{
	nitrogen = 93.7835;
	oxygen = 20.7263;
	temperature = 243.15
	},
/area/submap/eclipsedigsight)
"PW" = (
/mob/living/simple_mob/humanoid/eclipse/lunar/ravanger,
/turf/simulated/floor/outdoors/dirt,
/area/submap/eclipsedigsight)
"Qb" = (
/obj/structure/cliff/automatic{
	dir = 5
	},
/turf/simulated/floor/outdoors/dirt,
/area/submap/eclipsedigsight)
"Qd" = (
/obj/structure/cliff/automatic/corner{
	dir = 6
	},
/turf/simulated/floor/outdoors/dirt,
/area/submap/eclipsedigsight)
"Ro" = (
/obj/effect/floor_decal/borderfloorwhite{
	dir = 6
	},
/turf/simulated/floor/reinforced,
/area/submap/eclipsedigsight)
"Td" = (
/obj/effect/floor_decal/borderfloorblack{
	dir = 5
	},
/turf/simulated/floor/reinforced,
/area/submap/eclipsedigsight)
"Th" = (
/obj/effect/floor_decal/corner/purple/diagonal,
/obj/machinery/light{
	dir = 8
	},
/turf/simulated/floor/tiled/monotile,
/area/submap/eclipsedigsight)
"TE" = (
/obj/effect/floor_decal/corner/grey/diagonal,
/turf/simulated/floor/tiled/monotile,
/area/submap/eclipsedigsight)
"TO" = (
/obj/effect/floor_decal/corner/purple/diagonal,
/mob/living/simple_mob/humanoid/eclipse/lunar/shotgunner,
/turf/simulated/floor/tiled/monotile,
/area/submap/eclipsedigsight)
"UD" = (
/obj/machinery/light{
	dir = 8
	},
/obj/effect/floor_decal/corner/grey/diagonal,
/obj/structure/bed/double/padded,
/obj/item/bedsheet/orangedouble,
/turf/simulated/floor/tiled/monotile,
/area/submap/eclipsedigsight)
"UV" = (
/obj/effect/floor_decal/corner/purple/diagonal,
/obj/item/storage/box/monkeycubes,
/obj/structure/table/reinforced,
/turf/simulated/floor/tiled/monotile,
/area/submap/eclipsedigsight)
"Vh" = (
/obj/effect/floor_decal/borderfloorblack{
	dir = 9
	},
/turf/simulated/floor/reinforced,
/area/submap/eclipsedigsight)
"Vl" = (
/obj/effect/floor_decal/borderfloorwhite{
	dir = 4
	},
/turf/simulated/floor/reinforced,
/area/submap/eclipsedigsight)
"VA" = (
/obj/machinery/light{
	dir = 1
	},
/obj/effect/floor_decal/corner/grey/diagonal,
/turf/simulated/floor/tiled/monotile,
/area/submap/eclipsedigsight)
"VS" = (
/obj/structure/cliff/automatic/corner{
	dir = 10
	},
/turf/simulated/floor/outdoors/dirt,
/area/submap/eclipsedigsight)
"Wc" = (
/obj/effect/floor_decal/corner/purple/diagonal,
/obj/machinery/vending/giftvendor,
/turf/simulated/floor/tiled/monotile,
/area/submap/eclipsedigsight)
"WX" = (
/obj/effect/floor_decal/corner/purple/diagonal,
/obj/machinery/light{
	dir = 8
	},
/obj/structure/table/reinforced,
/obj/item/anodevice,
/obj/item/melee/baton/loaded,
/turf/simulated/floor/tiled/monotile,
/area/submap/eclipsedigsight)
"Xx" = (
/obj/structure/cliff/automatic/corner{
	dir = 6
	},
/turf/simulated/floor/lava{
	nitrogen = 93.7835;
	oxygen = 20.7263;
	temperature = 243.15
	},
/area/submap/eclipsedigsight)
"Ys" = (
/obj/effect/floor_decal/corner/grey/diagonal,
/mob/living/simple_mob/humanoid/eclipse/lunar/bulletstorm,
/turf/simulated/floor/tiled/monotile,
/area/submap/eclipsedigsight)
"YH" = (
/obj/structure/cliff/automatic{
	dir = 2
	},
/turf/simulated/floor/lava{
	nitrogen = 93.7835;
	oxygen = 20.7263;
	temperature = 243.15
	},
/area/submap/eclipsedigsight)
"Zk" = (
/obj/structure/window/phoronreinforced,
/obj/structure/window/phoronreinforced{
	dir = 4
	},
/obj/structure/window/phoronreinforced{
	dir = 1
	},
/obj/structure/grille/cult{
	name = "Alien grille"
	},
/obj/structure/window/titanium/full,
/turf/simulated/floor/tiled/monotile,
/area/submap/eclipsedigsight)
"Zo" = (
/obj/structure/grille/cult{
	name = "Alien grille"
	},
/obj/structure/window/titanium/full,
/obj/structure/window/phoronreinforced{
	dir = 1
	},
/obj/structure/window/phoronreinforced{
	dir = 4
	},
/obj/structure/window/phoronreinforced,
/obj/structure/window/phoronreinforced{
	dir = 8
	},
/turf/simulated/floor/reinforced,
/area/submap/eclipsedigsight)
"Zv" = (
/obj/effect/floor_decal/corner/purple/diagonal,
/obj/structure/table/reinforced,
/obj/item/archaeological_find,
/obj/item/archaeological_find,
/obj/random/tool/alien,
/turf/simulated/floor/tiled/monotile,
/area/submap/eclipsedigsight)
"Zw" = (
/obj/structure/cliff/automatic{
	dir = 4
	},
/turf/simulated/floor/lava{
	nitrogen = 93.7835;
	oxygen = 20.7263;
	temperature = 243.15
	},
/area/submap/eclipsedigsight)
"ZT" = (
/obj/effect/floor_decal/corner/purple/diagonal,
/obj/machinery/light,
/turf/simulated/floor/tiled/monotile,
/area/submap/eclipsedigsight)

(1,1,1) = {"
hU
hU
hU
hU
hU
hU
hU
hU
hU
hU
hU
hU
hU
hU
hU
hU
hU
hU
hU
hU
hU
hU
hU
hU
hU
hU
hU
hU
hU
hU
hU
hU
hU
hU
hU
hU
hU
hU
hU
hU
"}
(2,1,1) = {"
hU
hU
hU
hU
hU
hU
hU
hU
hU
hU
hU
hU
hU
hU
hU
hU
hU
hU
hU
hU
hU
hU
hU
hU
hU
hU
hU
hU
hU
hU
hU
hU
hU
hU
hU
hU
hU
hU
hU
hU
"}
(3,1,1) = {"
hU
hU
hU
hU
Hx
fq
fq
fq
fq
Dq
pW
pW
pW
VS
fq
fq
fq
fq
fq
fq
fq
fq
fq
fq
fq
Dq
pW
pW
pW
VS
fq
fq
fq
fq
fq
nN
hU
hU
hU
hU
"}
(4,1,1) = {"
hU
hU
hU
Hx
Dq
pW
pW
pW
pW
pW
pW
pW
pW
pW
pW
pW
pW
pW
pW
pW
pW
pW
pW
pW
pW
pW
pW
pW
pW
pW
pW
pW
pW
pW
pW
VS
nN
hU
hU
hU
"}
(5,1,1) = {"
hU
hU
Hx
Dq
pW
pW
pW
pW
pW
pW
pW
pW
pW
pW
pW
pW
pW
pW
pW
pW
pW
pW
pW
pW
pW
pW
pW
pW
pW
pW
pW
pW
pW
pW
pW
pW
VS
nN
hU
hU
"}
(6,1,1) = {"
hU
hU
JD
pW
pW
pW
pW
pW
mm
mm
mm
mm
mm
mm
mm
mm
mm
pW
pW
pW
pW
pW
pW
mm
mm
mm
mm
mm
mm
mm
mm
mm
mm
mm
mm
mm
pW
fF
hU
hU
"}
(7,1,1) = {"
hU
hU
JD
pW
pW
pW
pW
pW
mm
FS
UD
FS
FS
FS
UD
FS
mm
pW
pW
pW
pW
pW
pW
mm
Oy
sH
Th
Zv
IA
sE
JB
Dp
CQ
ly
UV
mm
pW
fF
hU
hU
"}
(8,1,1) = {"
hU
hU
JD
pW
pW
pW
pW
pW
es
TE
TE
TE
Ys
TE
TE
TE
mm
pW
pW
pW
PW
pW
pW
es
sH
sH
sH
sH
sH
ZT
fa
KQ
sH
sH
ZT
mm
pW
fF
hU
hU
"}
(9,1,1) = {"
hU
hU
JD
pW
pW
pW
pW
pW
mm
TE
wd
wd
wd
wd
wd
TE
mm
pW
pW
pW
pW
pW
pW
es
sH
sH
sH
sE
cB
sE
Zk
sH
sH
sH
sH
mm
pW
fF
hU
hU
"}
(10,1,1) = {"
hU
hU
JD
pW
pW
pW
pW
pW
mm
TE
TE
vY
TE
EY
TE
TE
mm
pW
pW
pW
Is
pW
pW
mm
Wc
sH
sb
sH
sH
sH
MR
sH
sH
sH
sH
mm
pW
fF
hU
hU
"}
(11,1,1) = {"
hU
hU
JD
pW
pW
pW
pW
pW
mm
TE
wd
wd
wd
wd
wd
TE
mm
pW
pW
pW
pW
pW
pW
mm
mm
mm
mm
mm
mm
mm
mm
mm
sH
sH
sH
mm
pW
fF
hU
hU
"}
(12,1,1) = {"
hU
hU
JD
pW
pW
pW
pW
pW
mm
VA
TE
TE
Ys
TE
TE
TE
mm
pW
pW
pW
pW
pW
pW
pW
pW
pW
pW
pW
pW
pW
pW
mm
NS
sH
lk
mm
pW
fF
hU
hU
"}
(13,1,1) = {"
hU
hU
JD
pW
pW
pW
pW
pW
mm
FS
bl
FS
FS
FS
bl
FS
mm
pW
pW
pW
pW
pW
pW
pW
pW
pW
pW
pW
pW
pW
pW
mm
sH
sH
sH
mm
pW
fF
hU
hU
"}
(14,1,1) = {"
hU
hU
JD
pW
pW
pW
pW
pW
mm
mm
mm
mm
mm
mm
mm
mm
mm
pW
pW
mm
mm
mm
mm
mm
mm
pW
pW
pW
pW
pW
pW
mm
uQ
JI
eW
mm
pW
fF
hU
hU
"}
(15,1,1) = {"
hU
hU
JD
pW
pW
Hx
PT
PT
PT
PT
PT
PT
PT
KF
pW
pW
pW
pW
pW
mm
wH
WX
AK
xF
mm
pW
pW
pW
pW
pW
pW
mm
Vh
DV
FQ
mm
pW
fF
hU
hU
"}
(16,1,1) = {"
hU
hU
JD
pW
pW
JD
Fc
Fc
Fc
Fc
Fc
Fc
Fc
Gg
KF
pW
pW
pW
pW
mm
sH
sH
sH
sH
es
pW
pW
pW
pW
pW
pW
mm
Ma
gt
FE
mm
pW
fF
hU
hU
"}
(17,1,1) = {"
hU
hU
JD
pW
pW
JD
Fc
Fc
Fc
Fc
Fc
Fc
Fc
Fc
YH
pW
pW
pW
OT
mm
sH
sH
sH
sH
mm
pW
pW
pW
pW
pW
pW
mm
Td
Vl
bc
mm
pW
fF
hU
hU
"}
(18,1,1) = {"
hU
hU
JD
pW
pW
Qb
Zw
Zw
Zw
Zw
md
Fc
Fc
Fc
YH
mm
mm
mm
mm
mm
sH
ZT
CL
CL
mm
pW
pW
pW
pW
pW
pW
mm
mm
mm
mm
mm
pW
fF
hU
hU
"}
(19,1,1) = {"
hU
hU
JD
pW
pW
pW
pW
pW
pW
pW
JD
Fc
Fc
Xx
wm
mm
nQ
jv
rn
Pv
sH
TO
sH
IA
mm
pW
pW
pW
pW
pW
pW
pW
pW
pW
pW
pW
pW
fF
hU
hU
"}
(20,1,1) = {"
hU
hU
JD
pW
pW
pW
pW
pW
MD
pW
JD
Fc
Fc
YH
pW
mm
zN
gt
ed
DN
sH
sH
sH
Mk
mm
pW
pW
pW
pW
pW
pW
pW
pW
pW
pW
pW
pW
fF
hU
hU
"}
(21,1,1) = {"
hU
hU
JD
pW
pW
pW
pW
pW
pW
pW
JD
Fc
Xx
wm
pW
mm
Pb
Le
Ro
Zo
sH
rk
sH
sQ
mm
pW
pW
pW
pW
pW
pW
pW
pW
pW
pW
pW
pW
fF
hU
hU
"}
(22,1,1) = {"
hU
hU
JD
pW
pW
pW
Hx
PT
PT
PT
nP
Fc
YH
pW
pW
mm
mm
mm
mm
mm
sH
ZT
CL
CL
mm
pW
pW
pW
pW
pW
pW
mm
mm
mm
mm
pW
pW
fF
hU
hU
"}
(23,1,1) = {"
hU
hU
JD
pW
pW
pW
JD
Fc
Fc
Fc
Fc
Fc
YH
pW
pW
pW
pW
pW
pW
mm
sH
sH
sH
sH
mm
pW
pW
pW
pW
pW
pW
cm
kZ
ON
mm
pW
pW
fF
hU
hU
"}
(24,1,1) = {"
hU
hU
JD
pW
pW
pW
JD
Fc
Fc
Fc
Fc
Xx
wm
pW
pW
pW
pW
pW
pW
mm
sH
sH
sH
sH
es
pW
pW
pW
pW
pW
pW
mm
EM
th
mm
pW
pW
fF
hU
hU
"}
(25,1,1) = {"
hU
hU
JD
pW
pW
pW
JD
Fc
Fc
Fc
Xx
wm
pW
pW
pW
pW
pW
pW
pW
mm
wH
gZ
AK
xF
mm
pW
pW
pW
pW
pW
pW
mm
mm
mm
mm
pW
pW
fF
hU
hU
"}
(26,1,1) = {"
hU
hU
Qb
lF
pW
pW
Dq
pW
pW
Xx
wm
pW
pW
pW
pW
pW
pW
pW
pW
mm
mm
mm
mm
mm
mm
pW
pW
pW
pW
pW
pW
pW
pW
pW
pW
pW
Qd
rA
hU
hU
"}
(27,1,1) = {"
hU
hU
hU
Qb
lF
pW
pW
pW
pW
pW
pW
pW
pW
pW
pW
pW
pW
pW
pW
pW
pW
pW
pW
pW
pW
pW
pW
pW
pW
pW
pW
pW
pW
pW
pW
Qd
rA
hU
hU
hU
"}
(28,1,1) = {"
hU
hU
hU
hU
Qb
mU
mU
mU
mU
mU
mU
mU
mU
mU
mU
mU
mU
mU
lF
pW
pW
pW
Qd
mU
mU
mU
mU
mU
mU
mU
mU
mU
mU
mU
mU
rA
hU
hU
hU
hU
"}
(29,1,1) = {"
hU
hU
hU
hU
hU
hU
hU
hU
hU
hU
hU
hU
hU
hU
hU
hU
hU
hU
hU
hU
hU
hU
hU
hU
hU
hU
hU
hU
hU
hU
hU
hU
hU
hU
hU
hU
hU
hU
hU
hU
"}
(30,1,1) = {"
hU
hU
hU
hU
hU
hU
hU
hU
hU
hU
hU
hU
hU
hU
hU
hU
hU
hU
hU
hU
hU
hU
hU
hU
hU
hU
hU
hU
hU
hU
hU
hU
hU
hU
hU
hU
hU
hU
hU
hU
"}
