//MAP CONVERTED BY dmm2tgm.py THIS HEADER COMMENT PREVENTS RECONVERSION, DO NOT REMOVE
"ah" = (
/turf/simulated/floor/wood,
/area/submap/eclipseaqua)
"au" = (
/obj/structure/grille,
/obj/structure/window/reinforced{
	dir = 8
	},
/obj/structure/window/reinforced{
	dir = 4
	},
/turf/simulated/floor/tiled/dark,
/area/submap/eclipseaqua)
"aV" = (
/obj/item/stool/padded,
/obj/machinery/light{
	dir = 8
	},
/obj/effect/floor_decal/corner/grey,
/obj/effect/floor_decal/corner/black{
	dir = 1
	},
/turf/simulated/floor/tiled/dark,
/area/submap/eclipseaqua)
"ca" = (
/obj/structure/table/rack,
/obj/item/rig/combat/equipped,
/obj/item/rig_module/vision/nvg,
/obj/random/energy/highend,
/obj/effect/floor_decal/corner/blue/diagonal,
/turf/simulated/floor/tiled/dark,
/area/submap/eclipseaqua)
"cC" = (
/obj/item/stool/padded,
/obj/machinery/light,
/obj/effect/floor_decal/corner/grey,
/obj/effect/floor_decal/corner/black{
	dir = 1
	},
/turf/simulated/floor/tiled/dark,
/area/submap/eclipseaqua)
"dm" = (
/obj/machinery/portable_atmospherics/hydroponics,
/obj/item/seeds/celery,
/obj/machinery/light,
/obj/effect/floor_decal/corner/grey,
/obj/effect/floor_decal/corner/black{
	dir = 1
	},
/turf/simulated/floor/tiled/dark,
/area/submap/eclipseaqua)
"eb" = (
/obj/structure/cable{
	d1 = 1;
	d2 = 8;
	icon_state = "1-8"
	},
/obj/effect/floor_decal/corner/grey,
/obj/effect/floor_decal/corner/black{
	dir = 1
	},
/turf/simulated/floor/tiled/dark,
/area/submap/eclipseaqua)
"ew" = (
/obj/machinery/light,
/turf/simulated/floor/outdoors/dirt,
/area/submap/eclipseaqua)
"eK" = (
/obj/structure/table/steel,
/obj/random/maintenance/foodstuff,
/obj/random/maintenance/foodstuff,
/obj/random/maintenance/foodstuff,
/obj/item/paper{
	info = "Secured the old fortress. Attempts to set up mass stimm farms have been unfruitful. Supply drops continue to get intercepted by cultists, pirates or the various mercenary groups.  Lake reads to be much deeper then it appears to be. Please forward a suggestion to the Precursor Initiative to send a task force to investigate. For the possibility of precursor ruins or sunken technology.";
	name = "Status Report"
	},
/obj/effect/floor_decal/corner/grey,
/obj/effect/floor_decal/corner/black{
	dir = 1
	},
/turf/simulated/floor/tiled/dark,
/area/submap/eclipseaqua)
"fi" = (
/obj/machinery/light{
	dir = 1
	},
/turf/simulated/floor/outdoors/dirt,
/area/submap/eclipseaqua)
"gA" = (
/mob/living/simple_mob/humanoid/eclipse/solar/snipertesh,
/obj/effect/floor_decal/corner/grey,
/obj/effect/floor_decal/corner/black{
	dir = 1
	},
/turf/simulated/floor/tiled/dark,
/area/submap/eclipseaqua)
"gH" = (
/mob/living/simple_mob/humanoid/eclipse/lunar/ravanger,
/obj/effect/floor_decal/corner/grey,
/obj/effect/floor_decal/corner/black{
	dir = 1
	},
/turf/simulated/floor/tiled/dark,
/area/submap/eclipseaqua)
"gR" = (
/mob/living/simple_mob/humanoid/eclipse/lunar/shotgunner,
/turf/simulated/floor/outdoors/dirt,
/area/submap/eclipseaqua)
"iy" = (
/obj/structure/cable{
	d1 = 2;
	d2 = 4;
	icon_state = "2-4"
	},
/obj/effect/floor_decal/corner/grey,
/obj/effect/floor_decal/corner/black{
	dir = 1
	},
/turf/simulated/floor/tiled/dark,
/area/submap/eclipseaqua)
"jw" = (
/obj/machinery/light{
	dir = 8
	},
/obj/effect/floor_decal/corner/grey,
/obj/effect/floor_decal/corner/black{
	dir = 1
	},
/turf/simulated/floor/tiled/dark,
/area/submap/eclipseaqua)
"jR" = (
/obj/machinery/light,
/obj/structure/bed/double/padded,
/obj/item/bedsheet/bluedouble,
/obj/effect/floor_decal/corner/grey,
/obj/effect/floor_decal/corner/black{
	dir = 1
	},
/turf/simulated/floor/tiled/dark,
/area/submap/eclipseaqua)
"kd" = (
/mob/living/simple_mob/humanoid/eclipse/lunar/pummler,
/obj/effect/floor_decal/corner/blue/diagonal,
/turf/simulated/floor/tiled/dark,
/area/submap/eclipseaqua)
"lR" = (
/obj/effect/floor_decal/corner/blue/diagonal,
/turf/simulated/floor/tiled/dark,
/area/submap/eclipseaqua)
"lS" = (
/obj/structure/table/steel,
/obj/item/storage/box/ambrosiadeus,
/obj/effect/floor_decal/corner/grey,
/obj/effect/floor_decal/corner/black{
	dir = 1
	},
/turf/simulated/floor/tiled/dark,
/area/submap/eclipseaqua)
"mi" = (
/turf/template_noop,
/area/template_noop)
"mL" = (
/obj/structure/table/steel,
/obj/random/ammo,
/obj/random/ammo,
/obj/random/projectile/random,
/obj/effect/floor_decal/corner/grey,
/obj/effect/floor_decal/corner/black{
	dir = 1
	},
/turf/simulated/floor/tiled/dark,
/area/submap/eclipseaqua)
"nc" = (
/obj/structure/railing,
/turf/simulated/floor/water,
/area/submap/eclipseaqua)
"nf" = (
/obj/machinery/light{
	dir = 1
	},
/obj/effect/floor_decal/corner/grey,
/obj/effect/floor_decal/corner/black{
	dir = 1
	},
/turf/simulated/floor/tiled/dark,
/area/submap/eclipseaqua)
"nz" = (
/obj/machinery/biogenerator,
/obj/effect/floor_decal/corner/grey,
/obj/effect/floor_decal/corner/black{
	dir = 1
	},
/turf/simulated/floor/tiled/dark,
/area/submap/eclipseaqua)
"ob" = (
/obj/machinery/door/airlock/voidcraft,
/turf/simulated/floor/tiled/dark,
/area/submap/eclipseaqua)
"pq" = (
/obj/machinery/power/smes/buildable/point_of_interest,
/obj/effect/floor_decal/corner/grey,
/obj/effect/floor_decal/corner/black{
	dir = 1
	},
/turf/simulated/floor/tiled/dark,
/area/submap/eclipseaqua)
"pE" = (
/obj/structure/railing{
	dir = 1
	},
/turf/simulated/floor/water,
/area/submap/eclipseaqua)
"pN" = (
/obj/structure/grille,
/obj/structure/window/reinforced{
	dir = 8
	},
/obj/structure/window/reinforced,
/turf/simulated/floor/tiled/dark,
/area/submap/eclipseaqua)
"rH" = (
/obj/structure/grille,
/obj/structure/window/reinforced{
	dir = 1
	},
/obj/structure/window/reinforced{
	dir = 8
	},
/turf/simulated/floor/tiled/dark,
/area/submap/eclipseaqua)
"rR" = (
/mob/living/simple_mob/humanoid/eclipse/lunar/silvernoodle,
/obj/effect/floor_decal/corner/grey,
/obj/effect/floor_decal/corner/black{
	dir = 1
	},
/turf/simulated/floor/tiled/dark,
/area/submap/eclipseaqua)
"sp" = (
/obj/machinery/light{
	dir = 4
	},
/obj/effect/floor_decal/corner/blue/diagonal,
/turf/simulated/floor/tiled/dark,
/area/submap/eclipseaqua)
"sX" = (
/obj/machinery/light{
	dir = 4
	},
/obj/effect/floor_decal/corner/grey,
/obj/effect/floor_decal/corner/black{
	dir = 1
	},
/turf/simulated/floor/tiled/dark,
/area/submap/eclipseaqua)
"ta" = (
/turf/simulated/floor/water,
/area/submap/eclipseaqua)
"uU" = (
/obj/structure/reagent_dispensers/fueltank,
/obj/effect/floor_decal/corner/grey,
/obj/effect/floor_decal/corner/black{
	dir = 1
	},
/turf/simulated/floor/tiled/dark,
/area/submap/eclipseaqua)
"vt" = (
/obj/structure/grille,
/obj/structure/window/reinforced{
	dir = 4
	},
/turf/simulated/floor/tiled/dark,
/area/submap/eclipseaqua)
"vu" = (
/obj/machinery/power/terminal{
	dir = 8;
	icon_state = "term"
	},
/obj/structure/cable{
	d2 = 4;
	icon_state = "0-4"
	},
/obj/effect/floor_decal/corner/grey,
/obj/effect/floor_decal/corner/black{
	dir = 1
	},
/turf/simulated/floor/tiled/dark,
/area/submap/eclipseaqua)
"xL" = (
/obj/machinery/light{
	dir = 1
	},
/obj/effect/floor_decal/corner/blue/diagonal,
/turf/simulated/floor/tiled/dark,
/area/submap/eclipseaqua)
"xO" = (
/mob/living/simple_mob/humanoid/eclipse/solar/guardian,
/obj/effect/floor_decal/corner/grey,
/obj/effect/floor_decal/corner/black{
	dir = 1
	},
/turf/simulated/floor/tiled/dark,
/area/submap/eclipseaqua)
"yn" = (
/obj/structure/table/steel,
/obj/random/maintenance/research,
/obj/random/maintenance/research,
/obj/random/maintenance/security,
/obj/effect/floor_decal/corner/grey,
/obj/effect/floor_decal/corner/black{
	dir = 1
	},
/turf/simulated/floor/tiled/dark,
/area/submap/eclipseaqua)
"yX" = (
/obj/structure/window/titanium,
/obj/structure/window/titanium{
	dir = 1
	},
/obj/structure/window/titanium{
	dir = 4
	},
/obj/structure/window/titanium{
	dir = 8
	},
/obj/item/stack/material/void_opal,
/obj/structure/table/rack,
/obj/effect/map_helper/no_phaseshift/area,
/obj/effect/floor_decal/corner/blue/diagonal,
/turf/simulated/floor/reinforced/airless,
/area/submap/eclipseaqua)
"zo" = (
/obj/machinery/light{
	dir = 4
	},
/turf/simulated/floor/outdoors/dirt,
/area/submap/eclipseaqua)
"zB" = (
/obj/machinery/portable_atmospherics/hydroponics,
/obj/item/seeds/celery,
/obj/machinery/light{
	dir = 4
	},
/obj/effect/floor_decal/corner/grey,
/obj/effect/floor_decal/corner/black{
	dir = 1
	},
/turf/simulated/floor/tiled/dark,
/area/submap/eclipseaqua)
"Cn" = (
/obj/structure/grille,
/obj/structure/window/reinforced{
	dir = 1
	},
/turf/simulated/floor/tiled/dark,
/area/submap/eclipseaqua)
"Cv" = (
/obj/machinery/power/apc{
	pixel_y = -24
	},
/obj/structure/cable,
/obj/effect/floor_decal/corner/grey,
/obj/effect/floor_decal/corner/black{
	dir = 1
	},
/turf/simulated/floor/tiled/dark,
/area/submap/eclipseaqua)
"CM" = (
/mob/living/simple_mob/humanoid/eclipse/lunar/wheel,
/obj/effect/floor_decal/corner/blue/diagonal,
/turf/simulated/floor/tiled/dark,
/area/submap/eclipseaqua)
"Dt" = (
/obj/machinery/door/airlock/voidcraft,
/obj/effect/floor_decal/corner/grey,
/turf/simulated/floor/tiled/dark,
/area/submap/eclipseaqua)
"Dv" = (
/obj/structure/table/rack,
/obj/random/rigsuit,
/obj/item/rig_module/mounted/egun,
/obj/random/energy/highend,
/obj/effect/floor_decal/corner/blue/diagonal,
/turf/simulated/floor/tiled/dark,
/area/submap/eclipseaqua)
"Dw" = (
/obj/structure/table/steel,
/obj/random/ammo,
/obj/random/ammo,
/obj/random/energy/highend,
/obj/effect/floor_decal/corner/grey,
/obj/effect/floor_decal/corner/black{
	dir = 1
	},
/turf/simulated/floor/tiled/dark,
/area/submap/eclipseaqua)
"Ej" = (
/obj/structure/cable{
	d1 = 4;
	d2 = 8;
	icon_state = "4-8"
	},
/obj/effect/floor_decal/corner/grey,
/obj/effect/floor_decal/corner/black{
	dir = 1
	},
/turf/simulated/floor/tiled/dark,
/area/submap/eclipseaqua)
"Ek" = (
/obj/structure/grille,
/obj/structure/window/reinforced{
	dir = 1
	},
/obj/structure/window/reinforced,
/turf/simulated/floor/tiled/dark,
/area/submap/eclipseaqua)
"Ev" = (
/obj/structure/table/rack,
/obj/random/rigsuit,
/obj/item/rig_module/chem_dispenser/combat,
/obj/random/energy/highend,
/obj/effect/floor_decal/corner/blue/diagonal,
/turf/simulated/floor/tiled/dark,
/area/submap/eclipseaqua)
"EE" = (
/obj/structure/grille,
/obj/structure/window/reinforced{
	dir = 8
	},
/obj/structure/window/reinforced{
	dir = 1
	},
/turf/simulated/floor/tiled/dark,
/area/submap/eclipseaqua)
"Ho" = (
/mob/living/simple_mob/humanoid/eclipse/solar/firemoff,
/obj/effect/floor_decal/corner/grey,
/obj/effect/floor_decal/corner/black{
	dir = 1
	},
/turf/simulated/floor/tiled/dark,
/area/submap/eclipseaqua)
"HD" = (
/obj/structure/grille,
/obj/structure/window/reinforced{
	dir = 4
	},
/obj/structure/window/reinforced{
	dir = 1
	},
/turf/simulated/floor/tiled/dark,
/area/submap/eclipseaqua)
"IS" = (
/obj/structure/table/steel,
/obj/random/maintenance/research,
/obj/random/maintenance/research,
/obj/random/maintenance/morestuff,
/obj/random/maintenance/security,
/obj/machinery/light{
	dir = 1
	},
/obj/effect/floor_decal/corner/grey,
/obj/effect/floor_decal/corner/black{
	dir = 1
	},
/turf/simulated/floor/tiled/dark,
/area/submap/eclipseaqua)
"IY" = (
/obj/structure/table/steel,
/obj/item/reagent_containers/glass/bottle/left4zed,
/obj/machinery/light{
	dir = 8
	},
/obj/effect/floor_decal/corner/grey,
/obj/effect/floor_decal/corner/black{
	dir = 1
	},
/turf/simulated/floor/tiled/dark,
/area/submap/eclipseaqua)
"JQ" = (
/obj/structure/bed/double/padded,
/obj/item/bedsheet/bluedouble,
/obj/effect/floor_decal/corner/grey,
/obj/effect/floor_decal/corner/black{
	dir = 1
	},
/turf/simulated/floor/tiled/dark,
/area/submap/eclipseaqua)
"Kh" = (
/obj/machinery/power/terminal{
	dir = 1;
	icon_state = "term"
	},
/obj/structure/cable{
	d2 = 2;
	icon_state = "0-2"
	},
/obj/effect/floor_decal/corner/grey,
/obj/effect/floor_decal/corner/black{
	dir = 1
	},
/turf/simulated/floor/tiled/dark,
/area/submap/eclipseaqua)
"Kv" = (
/obj/structure/table/steel,
/obj/random/ammo,
/obj/random/ammo,
/obj/random/handgun,
/obj/effect/floor_decal/corner/grey,
/obj/effect/floor_decal/corner/black{
	dir = 1
	},
/turf/simulated/floor/tiled/dark,
/area/submap/eclipseaqua)
"KH" = (
/obj/structure/table/steel,
/obj/random/maintenance/research,
/obj/random/maintenance/research,
/obj/random/maintenance/morestuff,
/obj/random/maintenance/security,
/obj/effect/floor_decal/corner/grey,
/obj/effect/floor_decal/corner/black{
	dir = 1
	},
/turf/simulated/floor/tiled/dark,
/area/submap/eclipseaqua)
"KI" = (
/obj/structure/table/steel,
/obj/random/maintenance/foodstuff,
/obj/random/maintenance/foodstuff,
/obj/random/maintenance/foodstuff,
/obj/effect/floor_decal/corner/grey,
/obj/effect/floor_decal/corner/black{
	dir = 1
	},
/turf/simulated/floor/tiled/dark,
/area/submap/eclipseaqua)
"KX" = (
/obj/machinery/light,
/obj/effect/floor_decal/corner/blue/diagonal,
/turf/simulated/floor/tiled/dark,
/area/submap/eclipseaqua)
"LC" = (
/obj/structure/table/steel,
/obj/random/ammo,
/obj/random/ammo,
/obj/random/medical/pillbottle,
/obj/effect/floor_decal/corner/grey,
/obj/effect/floor_decal/corner/black{
	dir = 1
	},
/turf/simulated/floor/tiled/dark,
/area/submap/eclipseaqua)
"My" = (
/obj/structure/grille,
/obj/structure/window/reinforced,
/turf/simulated/floor/tiled/dark,
/area/submap/eclipseaqua)
"Ne" = (
/obj/structure/railing{
	dir = 8
	},
/turf/simulated/floor/water,
/area/submap/eclipseaqua)
"Oi" = (
/obj/structure/grille,
/obj/structure/window/titanium/full,
/obj/structure/window/titanium{
	dir = 8
	},
/obj/structure/window/titanium{
	dir = 4
	},
/obj/structure/window/titanium,
/obj/structure/window/titanium{
	dir = 1
	},
/obj/effect/floor_decal/corner/grey,
/obj/effect/floor_decal/corner/black{
	dir = 1
	},
/turf/simulated/floor/tiled/dark,
/area/submap/eclipseaqua)
"On" = (
/obj/machinery/door/airlock/voidcraft,
/obj/effect/floor_decal/corner/grey,
/obj/effect/floor_decal/corner/black{
	dir = 1
	},
/turf/simulated/floor/tiled/dark,
/area/submap/eclipseaqua)
"Oo" = (
/obj/structure/table/steel,
/obj/random/ammo,
/obj/random/ammo,
/obj/random/grenade/lethal,
/obj/effect/floor_decal/corner/grey,
/obj/effect/floor_decal/corner/black{
	dir = 1
	},
/turf/simulated/floor/tiled/dark,
/area/submap/eclipseaqua)
"Pf" = (
/turf/simulated/floor/outdoors/dirt,
/area/submap/eclipseaqua)
"Po" = (
/obj/structure/grille,
/obj/structure/window/reinforced{
	dir = 1
	},
/obj/structure/window/reinforced{
	dir = 4
	},
/turf/simulated/floor/tiled/dark,
/area/submap/eclipseaqua)
"Qc" = (
/obj/machinery/portable_atmospherics/hydroponics,
/obj/item/seeds/celery,
/obj/effect/floor_decal/corner/grey,
/obj/effect/floor_decal/corner/black{
	dir = 1
	},
/turf/simulated/floor/tiled/dark,
/area/submap/eclipseaqua)
"Qu" = (
/turf/simulated/wall/concrete,
/area/submap/eclipseaqua)
"QB" = (
/obj/structure/table/steel,
/obj/random/ammo,
/obj/random/ammo,
/obj/random/toolbox,
/obj/effect/floor_decal/corner/grey,
/obj/effect/floor_decal/corner/black{
	dir = 1
	},
/turf/simulated/floor/tiled/dark,
/area/submap/eclipseaqua)
"Rt" = (
/turf/simulated/floor/outdoors/rocks,
/area/submap/eclipseaqua)
"Ry" = (
/obj/effect/floor_decal/corner/grey,
/obj/effect/floor_decal/corner/black{
	dir = 1
	},
/turf/simulated/floor/tiled/dark,
/area/submap/eclipseaqua)
"RH" = (
/mob/living/simple_mob/humanoid/eclipse/solar/guardian,
/obj/effect/floor_decal/corner/blue/diagonal,
/turf/simulated/floor/tiled/dark,
/area/submap/eclipseaqua)
"SE" = (
/obj/machinery/light{
	dir = 8
	},
/turf/simulated/floor/outdoors/dirt,
/area/submap/eclipseaqua)
"TA" = (
/obj/structure/table/rack,
/obj/item/rig/breacher,
/obj/item/rig_module/pat_module,
/obj/random/energy/highend,
/obj/effect/floor_decal/corner/blue/diagonal,
/turf/simulated/floor/tiled/dark,
/area/submap/eclipseaqua)
"UF" = (
/obj/structure/grille,
/obj/structure/window/reinforced,
/obj/structure/window/reinforced{
	dir = 1
	},
/turf/simulated/floor/tiled/dark,
/area/submap/eclipseaqua)
"UH" = (
/obj/structure/table/steel,
/obj/random/ammo,
/obj/random/ammo,
/obj/random/firstaid,
/obj/effect/floor_decal/corner/grey,
/obj/effect/floor_decal/corner/black{
	dir = 1
	},
/turf/simulated/floor/tiled/dark,
/area/submap/eclipseaqua)
"UI" = (
/obj/structure/table/steel,
/obj/random/maintenance/research,
/obj/random/maintenance/research,
/obj/random/maintenance/morestuff,
/obj/random/maintenance/security,
/obj/item/stack/nanopaste/advanced,
/obj/effect/floor_decal/corner/grey,
/obj/effect/floor_decal/corner/black{
	dir = 1
	},
/turf/simulated/floor/tiled/dark,
/area/submap/eclipseaqua)
"UJ" = (
/obj/structure/grille,
/obj/structure/window/titanium/full,
/obj/structure/window/titanium,
/obj/structure/window/titanium{
	dir = 4
	},
/obj/structure/window/titanium{
	dir = 1
	},
/obj/structure/window/titanium{
	dir = 8
	},
/obj/effect/floor_decal/corner/grey,
/obj/effect/floor_decal/corner/black{
	dir = 1
	},
/turf/simulated/floor/tiled/dark,
/area/submap/eclipseaqua)
"US" = (
/obj/machinery/light,
/obj/effect/floor_decal/corner/grey,
/obj/effect/floor_decal/corner/black{
	dir = 1
	},
/turf/simulated/floor/tiled/dark,
/area/submap/eclipseaqua)
"UU" = (
/obj/structure/grille,
/obj/structure/window/reinforced{
	dir = 8
	},
/turf/simulated/floor/tiled/dark,
/area/submap/eclipseaqua)
"Vg" = (
/obj/item/stool/padded,
/obj/effect/floor_decal/corner/grey,
/obj/effect/floor_decal/corner/black{
	dir = 1
	},
/turf/simulated/floor/tiled/dark,
/area/submap/eclipseaqua)
"Vn" = (
/obj/structure/table/steel,
/obj/random/ammo,
/obj/random/ammo,
/obj/random/gun/random,
/obj/effect/floor_decal/corner/grey,
/obj/effect/floor_decal/corner/black{
	dir = 1
	},
/turf/simulated/floor/tiled/dark,
/area/submap/eclipseaqua)
"Wc" = (
/obj/machinery/light{
	dir = 8
	},
/obj/effect/floor_decal/corner/blue/diagonal,
/turf/simulated/floor/tiled/dark,
/area/submap/eclipseaqua)
"WG" = (
/obj/structure/bed/double/padded,
/obj/item/bedsheet/iandouble,
/obj/effect/floor_decal/corner/grey,
/obj/effect/floor_decal/corner/black{
	dir = 1
	},
/turf/simulated/floor/tiled/dark,
/area/submap/eclipseaqua)
"WS" = (
/obj/structure/grille,
/obj/structure/window/reinforced{
	dir = 4
	},
/obj/structure/window/reinforced,
/turf/simulated/floor/tiled/dark,
/area/submap/eclipseaqua)
"Xm" = (
/obj/structure/table/steel,
/obj/random/ammo,
/obj/random/ammo,
/obj/effect/floor_decal/corner/grey,
/obj/effect/floor_decal/corner/black{
	dir = 1
	},
/turf/simulated/floor/tiled/dark,
/area/submap/eclipseaqua)
"Yt" = (
/mob/living/simple_mob/humanoid/eclipse/solar/teslanoodle,
/obj/effect/floor_decal/corner/blue/diagonal,
/turf/simulated/floor/tiled/dark,
/area/submap/eclipseaqua)
"Zm" = (
/obj/structure/cable{
	d1 = 2;
	d2 = 8;
	icon_state = "2-8"
	},
/obj/structure/cable{
	d1 = 1;
	d2 = 2;
	icon_state = "1-2"
	},
/obj/effect/floor_decal/corner/grey,
/obj/effect/floor_decal/corner/black{
	dir = 1
	},
/turf/simulated/floor/tiled/dark,
/area/submap/eclipseaqua)
"ZK" = (
/obj/structure/railing{
	dir = 4
	},
/turf/simulated/floor/water,
/area/submap/eclipseaqua)

(1,1,1) = {"
mi
mi
mi
mi
mi
mi
mi
mi
mi
mi
mi
mi
mi
mi
mi
mi
mi
mi
mi
mi
mi
mi
mi
mi
mi
mi
mi
mi
mi
mi
mi
mi
mi
mi
mi
mi
mi
mi
mi
mi
mi
mi
mi
mi
mi
"}
(2,1,1) = {"
mi
mi
mi
mi
mi
mi
mi
mi
mi
mi
mi
mi
mi
mi
mi
mi
mi
mi
mi
mi
mi
mi
mi
mi
mi
mi
mi
mi
mi
mi
mi
mi
mi
mi
mi
mi
mi
mi
mi
mi
mi
mi
mi
mi
mi
"}
(3,1,1) = {"
mi
mi
mi
mi
mi
mi
mi
mi
mi
mi
mi
mi
mi
mi
mi
mi
mi
mi
mi
Rt
Rt
Rt
Rt
Rt
Rt
Rt
mi
mi
mi
mi
mi
mi
mi
mi
mi
mi
mi
mi
mi
mi
mi
mi
mi
mi
mi
"}
(4,1,1) = {"
mi
mi
mi
mi
mi
mi
mi
mi
mi
mi
mi
mi
mi
mi
Rt
Rt
Rt
Rt
Rt
ta
nc
ah
ah
ah
pE
ta
Rt
Rt
Rt
Rt
Rt
mi
mi
mi
mi
mi
mi
mi
mi
mi
mi
mi
mi
mi
mi
"}
(5,1,1) = {"
mi
mi
mi
mi
mi
mi
mi
mi
mi
mi
mi
Rt
Rt
Rt
ta
ta
ta
ta
ta
ta
nc
ah
ah
ah
pE
ta
ta
ta
ta
ta
ta
Rt
Rt
Rt
mi
mi
mi
mi
mi
mi
mi
mi
mi
mi
mi
"}
(6,1,1) = {"
mi
mi
mi
mi
mi
mi
mi
Rt
Rt
Rt
Rt
ta
ta
ta
ta
ta
ta
ta
ta
ta
nc
ah
ah
ah
pE
ta
ta
ta
ta
ta
ta
ta
ta
ta
Rt
Rt
Rt
Rt
mi
mi
mi
mi
mi
mi
mi
"}
(7,1,1) = {"
mi
mi
mi
mi
mi
mi
Rt
ta
ta
ta
ta
ta
ta
ta
ta
ta
ta
ta
ta
ta
nc
ah
ah
ah
pE
ta
ta
ta
ta
ta
ta
ta
ta
ta
ta
ta
ta
ta
Rt
mi
mi
mi
mi
mi
mi
"}
(8,1,1) = {"
mi
mi
mi
mi
mi
Rt
ta
ta
ta
ta
ta
ta
ta
ta
ta
ta
ta
ta
ta
ta
nc
ah
ah
ah
pE
ta
ta
ta
ta
ta
ta
ta
ta
ta
ta
ta
ta
ta
ta
Rt
mi
mi
mi
mi
mi
"}
(9,1,1) = {"
mi
mi
mi
mi
mi
Rt
ta
ta
ta
ta
ta
ta
ta
ta
ta
ta
ta
ta
ta
ta
nc
ah
ah
ah
pE
ta
ta
ta
ta
ta
ta
ta
ta
ta
ta
ta
ta
ta
ta
Rt
mi
mi
mi
mi
mi
"}
(10,1,1) = {"
mi
mi
mi
mi
mi
Rt
ta
ta
ta
ta
ta
ta
ta
ta
ta
ta
ta
ta
ta
ta
nc
ah
ah
ah
pE
ta
ta
ta
ta
ta
ta
ta
ta
ta
ta
ta
ta
ta
ta
Rt
mi
mi
mi
mi
mi
"}
(11,1,1) = {"
mi
mi
mi
mi
mi
Rt
ta
ta
ta
ta
ta
ta
ta
ta
ta
ta
ta
ta
ta
ta
nc
ah
ah
ah
pE
ta
ta
ta
ta
ta
ta
ta
ta
ta
ta
ta
ta
ta
ta
Rt
mi
mi
mi
mi
mi
"}
(12,1,1) = {"
mi
mi
mi
mi
Rt
ta
ta
ta
ta
ta
ta
ta
ta
ta
ta
EE
au
au
au
Qu
Qu
Pf
Pf
Pf
Qu
Qu
au
au
au
pN
ta
ta
ta
ta
ta
ta
ta
ta
ta
ta
Rt
mi
mi
mi
mi
"}
(13,1,1) = {"
mi
mi
mi
mi
Rt
ta
ta
ta
ta
ta
ta
ta
ta
ta
rH
WS
Ry
Ry
Ry
QB
Qu
Pf
Pf
Pf
Qu
Xm
Ry
Ry
Ry
HD
pN
ta
ta
ta
ta
ta
ta
ta
ta
ta
Rt
mi
mi
mi
mi
"}
(14,1,1) = {"
mi
mi
mi
mi
Rt
ta
ta
ta
ta
ta
ta
ta
ta
rH
My
Ry
sX
gA
Ry
Xm
Qu
Pf
Pf
Pf
Qu
Dw
sX
gA
Ry
Ry
Cn
pN
ta
ta
ta
ta
ta
ta
ta
ta
Rt
mi
mi
mi
mi
"}
(15,1,1) = {"
mi
mi
mi
Rt
ta
ta
ta
ta
ta
ta
ta
ta
rH
vt
Qu
Qu
Qu
Dt
Qu
Qu
Qu
Pf
Pf
Pf
Qu
Qu
Qu
On
Qu
Qu
Qu
vt
pN
ta
ta
ta
ta
ta
ta
ta
ta
Rt
mi
mi
mi
"}
(16,1,1) = {"
mi
mi
mi
Rt
ta
ta
ta
ta
ta
ta
ta
rH
WS
Ry
Qu
lS
IY
Ry
Ry
nz
Qu
Pf
gR
Pf
Qu
Ry
Ry
Vg
aV
xO
Qu
Ry
HD
pN
ta
ta
ta
ta
ta
ta
ta
Rt
mi
mi
mi
"}
(17,1,1) = {"
mi
mi
mi
Rt
ta
ta
ta
ta
ta
ta
ta
Ek
Ry
US
Qu
uU
Ho
Ry
Ry
Ry
Dt
Pf
zo
Pf
Qu
Ry
Vg
KI
KI
cC
Qu
nf
Ry
UF
ta
ta
ta
ta
ta
ta
ta
Rt
mi
mi
mi
"}
(18,1,1) = {"
mi
mi
mi
Rt
ta
ta
ta
ta
ta
ta
ta
Ek
Ry
gA
On
Ry
Ry
Ry
Ry
dm
Qu
Qu
Qu
Qu
Qu
nf
Vg
eK
KI
Vg
On
gA
Ry
UF
ta
ta
ta
ta
ta
ta
ta
Rt
mi
mi
mi
"}
(19,1,1) = {"
mi
mi
mi
Rt
ta
ta
ta
ta
ta
ta
ta
Ek
Ry
Ry
Qu
Ry
Ry
Ry
Ry
Qc
Qu
lR
Wc
lR
ob
Ry
Ry
Vg
Vg
Ry
Qu
Ry
Ry
UF
ta
ta
ta
ta
ta
ta
ta
Rt
mi
mi
mi
"}
(20,1,1) = {"
mi
mi
Rt
ta
ta
ta
ta
ta
ta
ta
ta
Qu
Xm
Kv
Qu
Qc
Qc
zB
Ry
Qu
Qu
lR
lR
lR
Qu
Qu
Ry
sX
Ry
Ry
Qu
Oo
Xm
Qu
ta
ta
ta
ta
ta
ta
ta
ta
Rt
mi
mi
"}
(21,1,1) = {"
mi
mi
Rt
ZK
ZK
ZK
ZK
ZK
ZK
ZK
ZK
Qu
Qu
Qu
Qu
Qu
Qu
Qu
On
Qu
Ev
lR
lR
lR
ca
Qu
Qu
Qu
ob
Qu
Qu
Qu
Qu
Qu
ZK
ZK
ZK
ZK
ZK
ZK
ZK
ZK
Rt
mi
mi
"}
(22,1,1) = {"
mi
mi
Rt
ah
ah
ah
ah
ah
ah
ah
ah
Pf
Pf
Pf
Pf
Pf
Pf
Qu
lR
lR
lR
lR
Yt
lR
lR
lR
lR
Qu
Pf
Pf
Pf
Pf
Pf
Pf
ah
ah
ah
ah
ah
ah
ah
ah
Rt
mi
mi
"}
(23,1,1) = {"
mi
mi
Rt
ah
ah
ah
ah
ah
ah
ah
ah
Pf
Pf
Pf
Pf
gR
ew
Qu
xL
lR
lR
RH
yX
CM
lR
lR
KX
Qu
fi
gR
Pf
Pf
Pf
Pf
ah
ah
ah
ah
ah
ah
ah
ah
Rt
mi
mi
"}
(24,1,1) = {"
mi
mi
Rt
ah
ah
ah
ah
ah
ah
ah
ah
Pf
Pf
Pf
Pf
Pf
Pf
Qu
lR
lR
lR
lR
kd
lR
lR
lR
lR
Qu
Pf
Pf
Pf
Pf
Pf
Pf
ah
ah
ah
ah
ah
ah
ah
ah
Rt
mi
mi
"}
(25,1,1) = {"
mi
mi
Rt
Ne
Ne
Ne
Ne
Ne
Ne
Ne
Ne
Qu
Qu
Qu
Qu
Qu
ob
Qu
Qu
Qu
TA
lR
lR
lR
Dv
Qu
ob
Qu
Qu
Qu
Qu
Qu
Qu
Qu
Ne
Ne
Ne
Ne
Ne
Ne
Ne
Ne
Rt
mi
mi
"}
(26,1,1) = {"
mi
mi
Rt
ta
ta
ta
ta
ta
ta
ta
ta
Qu
Xm
LC
Qu
jw
Ry
UJ
pq
Qu
Qu
lR
lR
lR
Qu
Qu
Ry
jw
JQ
KH
Qu
Vn
Xm
Qu
ta
ta
ta
ta
ta
ta
ta
ta
Rt
mi
mi
"}
(27,1,1) = {"
mi
mi
mi
Rt
ta
ta
ta
ta
ta
ta
ta
Ek
Ry
Ry
Qu
Ry
Ry
Ry
vu
Ry
ob
lR
sp
lR
Qu
WG
Ry
Ry
Ry
JQ
Qu
Ry
Ry
Ek
ta
ta
ta
ta
ta
ta
ta
Rt
mi
mi
mi
"}
(28,1,1) = {"
mi
mi
mi
Rt
ta
ta
ta
ta
ta
ta
ta
Ek
Ry
gA
Dt
Ry
Ry
Ry
Ej
US
Qu
Qu
Qu
Qu
Qu
IS
Ry
gH
Ry
Ry
Dt
gA
Ry
Ek
ta
ta
ta
ta
ta
ta
ta
Rt
mi
mi
mi
"}
(29,1,1) = {"
mi
mi
mi
Rt
ta
ta
ta
ta
ta
ta
ta
Ek
Ry
US
Qu
Oi
rR
iy
Zm
Cv
Qu
Pf
SE
Pf
ob
Ry
Ry
Ry
Ry
jR
Qu
nf
Ry
Ek
ta
ta
ta
ta
ta
ta
ta
Rt
mi
mi
mi
"}
(30,1,1) = {"
mi
mi
mi
Rt
ta
ta
ta
ta
ta
ta
ta
Po
pN
Ry
Qu
pq
Kh
eb
Ry
Ry
Qu
Pf
gR
Pf
Qu
JQ
KH
Ry
yn
UI
Qu
Ry
EE
WS
ta
ta
ta
ta
ta
ta
ta
Rt
mi
mi
mi
"}
(31,1,1) = {"
mi
mi
mi
Rt
ta
ta
ta
ta
ta
ta
ta
ta
Po
UU
Qu
Qu
Qu
Dt
Qu
Qu
Qu
Pf
Pf
Pf
Qu
Qu
Qu
Dt
Qu
Qu
Qu
UU
WS
ta
ta
ta
ta
ta
ta
ta
ta
Rt
mi
mi
mi
"}
(32,1,1) = {"
mi
mi
mi
mi
Rt
ta
ta
ta
ta
ta
ta
ta
ta
Po
My
Ry
jw
gA
Ry
mL
Qu
Pf
Pf
Pf
Qu
UH
Ry
gA
jw
Ry
Cn
WS
ta
ta
ta
ta
ta
ta
ta
ta
Rt
mi
mi
mi
mi
"}
(33,1,1) = {"
mi
mi
mi
mi
Rt
ta
ta
ta
ta
ta
ta
ta
ta
ta
Po
pN
Ry
Ry
Ry
Xm
Qu
Pf
Pf
Pf
Qu
Xm
Ry
Ry
Ry
EE
WS
ta
ta
ta
ta
ta
ta
ta
ta
ta
Rt
mi
mi
mi
mi
"}
(34,1,1) = {"
mi
mi
mi
mi
Rt
ta
ta
ta
ta
ta
ta
ta
ta
ta
ta
Po
au
au
au
Qu
Qu
Pf
Pf
Pf
Qu
Qu
au
au
au
WS
ta
ta
ta
ta
ta
ta
ta
ta
ta
ta
Rt
mi
mi
mi
mi
"}
(35,1,1) = {"
mi
mi
mi
mi
mi
Rt
ta
ta
ta
ta
ta
ta
ta
ta
ta
ta
ta
ta
ta
ta
nc
ah
ah
ah
pE
ta
ta
ta
ta
ta
ta
ta
ta
ta
ta
ta
ta
ta
ta
Rt
mi
mi
mi
mi
mi
"}
(36,1,1) = {"
mi
mi
mi
mi
mi
Rt
ta
ta
ta
ta
ta
ta
ta
ta
ta
ta
ta
ta
ta
ta
nc
ah
ah
ah
pE
ta
ta
ta
ta
ta
ta
ta
ta
ta
ta
ta
ta
ta
ta
Rt
mi
mi
mi
mi
mi
"}
(37,1,1) = {"
mi
mi
mi
mi
mi
Rt
ta
ta
ta
ta
ta
ta
ta
ta
ta
ta
ta
ta
ta
ta
nc
ah
ah
ah
pE
ta
ta
ta
ta
ta
ta
ta
ta
ta
ta
ta
ta
ta
ta
Rt
mi
mi
mi
mi
mi
"}
(38,1,1) = {"
mi
mi
mi
mi
mi
Rt
ta
ta
ta
ta
ta
ta
ta
ta
ta
ta
ta
ta
ta
ta
nc
ah
ah
ah
pE
ta
ta
ta
ta
ta
ta
ta
ta
ta
ta
ta
ta
ta
ta
Rt
mi
mi
mi
mi
mi
"}
(39,1,1) = {"
mi
mi
mi
mi
mi
mi
Rt
ta
ta
ta
ta
ta
ta
ta
ta
ta
ta
ta
ta
ta
nc
ah
ah
ah
pE
ta
ta
ta
ta
ta
ta
ta
ta
ta
ta
ta
ta
ta
Rt
mi
mi
mi
mi
mi
mi
"}
(40,1,1) = {"
mi
mi
mi
mi
mi
mi
mi
Rt
Rt
Rt
Rt
ta
ta
ta
ta
ta
ta
ta
ta
ta
nc
ah
ah
ah
pE
ta
ta
ta
ta
ta
ta
ta
ta
ta
Rt
Rt
Rt
Rt
mi
mi
mi
mi
mi
mi
mi
"}
(41,1,1) = {"
mi
mi
mi
mi
mi
mi
mi
mi
mi
mi
mi
Rt
Rt
Rt
ta
ta
ta
ta
ta
ta
nc
ah
ah
ah
pE
ta
ta
ta
ta
ta
ta
Rt
Rt
Rt
mi
mi
mi
mi
mi
mi
mi
mi
mi
mi
mi
"}
(42,1,1) = {"
mi
mi
mi
mi
mi
mi
mi
mi
mi
mi
mi
mi
mi
mi
Rt
Rt
Rt
Rt
Rt
ta
nc
ah
ah
ah
pE
ta
Rt
Rt
Rt
Rt
Rt
mi
mi
mi
mi
mi
mi
mi
mi
mi
mi
mi
mi
mi
mi
"}
(43,1,1) = {"
mi
mi
mi
mi
mi
mi
mi
mi
mi
mi
mi
mi
mi
mi
mi
mi
mi
mi
mi
Rt
Rt
Rt
Rt
Rt
Rt
Rt
mi
mi
mi
mi
mi
mi
mi
mi
mi
mi
mi
mi
mi
mi
mi
mi
mi
mi
mi
"}
(44,1,1) = {"
mi
mi
mi
mi
mi
mi
mi
mi
mi
mi
mi
mi
mi
mi
mi
mi
mi
mi
mi
mi
mi
mi
mi
mi
mi
mi
mi
mi
mi
mi
mi
mi
mi
mi
mi
mi
mi
mi
mi
mi
mi
mi
mi
mi
mi
"}
(45,1,1) = {"
mi
mi
mi
mi
mi
mi
mi
mi
mi
mi
mi
mi
mi
mi
mi
mi
mi
mi
mi
mi
mi
mi
mi
mi
mi
mi
mi
mi
mi
mi
mi
mi
mi
mi
mi
mi
mi
mi
mi
mi
mi
mi
mi
mi
mi
"}
