//MAP CONVERTED BY dmm2tgm.py THIS HEADER COMMENT PREVENTS RECONVERSION, DO NOT REMOVE
"al" = (
/obj/machinery/light{
	dir = 1
	},
/obj/effect/floor_decal/corner/grey/diagonal,
/turf/simulated/floor/tiled/steel,
/area/submap/eclipsemountain)
"bu" = (
/obj/machinery/door/airlock,
/obj/effect/floor_decal/corner/black/diagonal,
/turf/simulated/floor/tiled/steel,
/area/submap/eclipsemountain)
"bN" = (
/obj/effect/floor_decal/corner/black/diagonal,
/mob/living/simple_mob/humanoid/eclipse/solar/firemoff{
	loot_list = list(/obj/item/slime_extract/sepia = 1, /obj/item/bone/skull = 100, /obj/item/prop/alien/junk = 50)
	},
/turf/simulated/floor/tiled/dark,
/area/submap/eclipsemountain)
"bY" = (
/obj/structure/table/wooden_reinforced,
/obj/random/contraband,
/turf/simulated/floor/wood{
	oxygen = 20.7263;
	nitrogen = 93.7835;
	temperature = 243.15
	},
/area/submap/eclipsemountain)
"cW" = (
/obj/structure/grille,
/obj/structure/window/phoronreinforced{
	dir = 1
	},
/obj/structure/window/phoronreinforced{
	dir = 8
	},
/obj/structure/window/phoronreinforced,
/obj/effect/floor_decal/corner/red/diagonal,
/turf/simulated/floor/tiled/red,
/area/submap/eclipsemountain)
"do" = (
/obj/structure/bed/chair/office/dark,
/mob/living/simple_mob/humanoid/eclipse/solar/snipertesh,
/obj/machinery/light{
	dir = 1
	},
/obj/effect/floor_decal/corner/red/diagonal,
/turf/simulated/floor/tiled/red,
/area/submap/eclipsemountain)
"dt" = (
/obj/structure/railing/grey{
	dir = 1
	},
/turf/simulated/floor/wood{
	oxygen = 20.7263;
	nitrogen = 93.7835;
	temperature = 243.15
	},
/area/submap/eclipsemountain)
"dJ" = (
/turf/simulated/floor/bluegrid,
/area/submap/eclipsemountain)
"ec" = (
/obj/structure/table/gold,
/obj/random/ammo,
/obj/random/maintenance/security,
/obj/machinery/light{
	dir = 8
	},
/obj/effect/floor_decal/corner/yellow/diagonal,
/turf/simulated/floor/tiled/yellow,
/area/submap/eclipsemountain)
"fX" = (
/obj/structure/table/darkglass,
/obj/machinery/button/remote/blast_door{
	id = "puzzlemtC"
	},
/obj/effect/floor_decal/corner/grey/diagonal,
/turf/simulated/floor/tiled/steel,
/area/submap/eclipsemountain)
"hw" = (
/obj/structure/cliff/automatic,
/turf/simulated/floor/outdoors/dirt,
/area/submap/eclipsemountain)
"iU" = (
/turf/simulated/floor/tiled/steel,
/area/submap/eclipsemountain)
"jt" = (
/obj/structure/table/wooden_reinforced,
/obj/random/tool/alien,
/obj/machinery/light,
/obj/random/contraband,
/turf/simulated/floor/wood{
	oxygen = 20.7263;
	nitrogen = 93.7835;
	temperature = 243.15
	},
/area/submap/eclipsemountain)
"jK" = (
/obj/machinery/door/airlock,
/obj/structure/fans/hardlight/colorable/abductor,
/turf/simulated/floor/tiled/steel,
/area/submap/eclipsemountain)
"ki" = (
/turf/simulated/floor/tiled/red,
/area/submap/eclipsemountain)
"kx" = (
/obj/effect/floor_decal/corner/grey/diagonal,
/turf/simulated/floor/tiled/steel,
/area/submap/eclipsemountain)
"kR" = (
/obj/machinery/light{
	dir = 1
	},
/obj/effect/floor_decal/corner/black/diagonal,
/turf/simulated/floor/tiled/dark,
/area/submap/eclipsemountain)
"kX" = (
/obj/structure/table/steel,
/obj/random/material/precious,
/obj/effect/floor_decal/corner/black/diagonal,
/turf/simulated/floor/tiled/dark,
/area/submap/eclipsemountain)
"la" = (
/obj/random/landmine,
/turf/simulated/floor/outdoors/dirt,
/area/submap/eclipsemountain)
"ls" = (
/obj/machinery/porta_turret/ai_defense{
	faction = "eclipse"
	},
/obj/effect/floor_decal/corner/grey/diagonal,
/turf/simulated/floor/tiled/steel,
/area/submap/eclipsemountain)
"lX" = (
/obj/structure/grille,
/obj/structure/window/phoronreinforced{
	dir = 1
	},
/obj/structure/window/phoronreinforced{
	dir = 8
	},
/obj/structure/window/phoronreinforced{
	dir = 4
	},
/obj/effect/floor_decal/corner/red/diagonal,
/turf/simulated/floor/tiled/red,
/area/submap/eclipsemountain)
"mL" = (
/obj/structure/table/steel,
/obj/random/medical/pillbottle,
/obj/random/material,
/obj/effect/floor_decal/corner/black/diagonal,
/turf/simulated/floor/tiled/dark,
/area/submap/eclipsemountain)
"nL" = (
/obj/machinery/door/blast/puzzle{
	id = "puzzlemtA"
	},
/turf/simulated/floor/tiled/steel,
/area/submap/eclipsemountain)
"pm" = (
/obj/machinery/porta_turret/ai_defense{
	faction = "eclipse"
	},
/turf/simulated/floor/tiled/red,
/area/submap/eclipsemountain)
"pE" = (
/obj/machinery/door/blast/regular{
	id = "eclipsegate"
	},
/obj/effect/floor_decal/corner/grey/diagonal,
/turf/simulated/floor/tiled/steel,
/area/submap/eclipsemountain)
"qn" = (
/obj/machinery/light,
/obj/effect/floor_decal/corner/black/diagonal,
/turf/simulated/floor/tiled/dark,
/area/submap/eclipsemountain)
"qv" = (
/obj/machinery/light{
	dir = 4
	},
/obj/effect/floor_decal/corner/black/diagonal,
/turf/simulated/floor/tiled/dark,
/area/submap/eclipsemountain)
"qO" = (
/obj/machinery/door/blast/puzzle{
	id = "puzzlemtB"
	},
/turf/simulated/floor/tiled/steel,
/area/submap/eclipsemountain)
"rI" = (
/mob/living/simple_mob/humanoid/eclipse/solar/radiation,
/turf/simulated/floor/tiled/steel,
/area/submap/eclipsemountain)
"rJ" = (
/obj/machinery/telecomms/relay/preset,
/turf/simulated/floor/tiled/dark,
/area/submap/eclipsemountain)
"sr" = (
/obj/structure/table/steel,
/obj/effect/floor_decal/corner/black/diagonal,
/obj/random/medical/pillbottle,
/turf/simulated/floor/tiled/dark,
/area/submap/eclipsemountain)
"sy" = (
/obj/structure/table/gold,
/obj/random/ammo,
/obj/random/maintenance/security,
/obj/random/maintenance/research,
/obj/effect/floor_decal/corner/yellow/diagonal,
/turf/simulated/floor/tiled/yellow,
/area/submap/eclipsemountain)
"sC" = (
/obj/machinery/light{
	dir = 8
	},
/obj/effect/floor_decal/corner/black/diagonal,
/turf/simulated/floor/tiled/dark,
/area/submap/eclipsemountain)
"tI" = (
/obj/structure/railing/grey{
	dir = 1
	},
/mob/living/simple_mob/humanoid/eclipse/solar/snipertesh,
/turf/simulated/floor/wood{
	oxygen = 20.7263;
	nitrogen = 93.7835;
	temperature = 243.15
	},
/area/submap/eclipsemountain)
"tQ" = (
/mob/living/simple_mob/humanoid/eclipse/lunar/ravanger,
/obj/effect/floor_decal/corner/grey/diagonal,
/turf/simulated/floor/tiled/steel,
/area/submap/eclipsemountain)
"tS" = (
/obj/machinery/power/terminal{
	dir = 1;
	icon_state = "term"
	},
/obj/structure/cable{
	icon_state = "0-2"
	},
/obj/structure/cable{
	icon_state = "2-4"
	},
/obj/structure/cable{
	icon_state = "2-8"
	},
/turf/simulated/floor/tiled/steel,
/area/submap/eclipsemountain)
"uw" = (
/obj/effect/map_helper/no_phaseshift/area,
/turf/simulated/floor/tiled/red,
/area/submap/eclipsemountain)
"uz" = (
/mob/living/simple_mob/humanoid/eclipse/lunar/pummler,
/obj/effect/floor_decal/corner/black/diagonal,
/turf/simulated/floor/tiled/dark,
/area/submap/eclipsemountain)
"uC" = (
/obj/effect/floor_decal/corner/red/diagonal,
/turf/simulated/floor/tiled/red,
/area/submap/eclipsemountain)
"vb" = (
/obj/structure/table/steel,
/obj/machinery/button/remote/blast_door{
	id = "eclipsegate"
	},
/obj/effect/floor_decal/corner/red/diagonal,
/turf/simulated/floor/tiled/red,
/area/submap/eclipsemountain)
"vx" = (
/obj/machinery/power/terminal{
	dir = 1;
	icon_state = "term"
	},
/obj/structure/cable{
	icon_state = "0-4"
	},
/turf/simulated/floor/tiled/steel,
/area/submap/eclipsemountain)
"vC" = (
/obj/effect/floor_decal/corner/grey/diagonal,
/mob/living/simple_mob/humanoid/eclipse/lunar/shotgunner{
	loot_list = list(/obj/item/slime_extract/sepia = 1, /obj/item/bone/skull = 100, /obj/item/prop/alien/junk = 50)
	},
/turf/simulated/floor/tiled/steel,
/area/submap/eclipsemountain)
"vO" = (
/obj/structure/railing/grey{
	dir = 8
	},
/turf/simulated/floor/wood{
	oxygen = 20.7263;
	nitrogen = 93.7835;
	temperature = 243.15
	},
/area/submap/eclipsemountain)
"xO" = (
/obj/structure/bed/double/padded,
/obj/item/bedsheet/purpledouble,
/obj/effect/floor_decal/corner/yellow/diagonal,
/turf/simulated/floor/tiled/yellow,
/area/submap/eclipsemountain)
"yy" = (
/obj/structure/table/steel,
/obj/random/material/refined,
/obj/effect/floor_decal/corner/grey/diagonal,
/turf/simulated/floor/tiled/steel,
/area/submap/eclipsemountain)
"yY" = (
/obj/structure/cliff/automatic{
	dir = 2
	},
/turf/simulated/floor/outdoors/dirt,
/area/submap/eclipsemountain)
"zb" = (
/obj/structure/railing/grey{
	dir = 8
	},
/mob/living/simple_mob/humanoid/eclipse/lunar/bulletstorm,
/turf/simulated/floor/wood{
	oxygen = 20.7263;
	nitrogen = 93.7835;
	temperature = 243.15
	},
/area/submap/eclipsemountain)
"zZ" = (
/obj/machinery/power/terminal{
	dir = 1;
	icon_state = "term"
	},
/obj/structure/cable{
	icon_state = "0-8"
	},
/turf/simulated/floor/tiled/steel,
/area/submap/eclipsemountain)
"AR" = (
/mob/living/simple_mob/humanoid/eclipse/lunar/wheel,
/obj/effect/floor_decal/corner/black/diagonal,
/turf/simulated/floor/tiled/dark,
/area/submap/eclipsemountain)
"Cy" = (
/obj/structure/cliff/automatic{
	dir = 10
	},
/turf/simulated/floor/outdoors/dirt,
/area/submap/eclipsemountain)
"Cz" = (
/turf/simulated/floor/outdoors/dirt,
/area/submap/eclipsemountain)
"De" = (
/obj/structure/table/darkglass,
/obj/machinery/button/remote/blast_door{
	id = "puzzlemtB"
	},
/obj/effect/floor_decal/corner/black/diagonal,
/turf/simulated/floor/tiled/dark,
/area/submap/eclipsemountain)
"Ec" = (
/obj/machinery/power/terminal{
	dir = 1;
	icon_state = "term"
	},
/obj/structure/cable{
	icon_state = "0-8"
	},
/obj/structure/cable{
	icon_state = "4-8"
	},
/turf/simulated/floor/tiled/steel,
/area/submap/eclipsemountain)
"EA" = (
/obj/structure/table/rack,
/obj/random/rigsuit,
/obj/random/weapon,
/obj/machinery/light{
	dir = 4
	},
/turf/simulated/floor/tiled/red,
/area/submap/eclipsemountain)
"EZ" = (
/obj/structure/cliff/automatic{
	dir = 9
	},
/turf/simulated/floor/outdoors/dirt,
/area/submap/eclipsemountain)
"Fg" = (
/obj/machinery/porta_turret/ai_defense{
	faction = "eclipse"
	},
/obj/machinery/light{
	dir = 1
	},
/turf/simulated/floor/tiled/red,
/area/submap/eclipsemountain)
"GC" = (
/obj/machinery/power/apc{
	pixel_y = -24
	},
/obj/structure/cable,
/turf/simulated/floor/tiled/steel,
/area/submap/eclipsemountain)
"HN" = (
/obj/structure/cliff/automatic{
	dir = 4
	},
/turf/simulated/floor/outdoors/dirt,
/area/submap/eclipsemountain)
"Ii" = (
/obj/item/rig/robotics,
/turf/simulated/floor/bluegrid,
/area/submap/eclipsemountain)
"Il" = (
/obj/structure/cliff/automatic{
	dir = 8
	},
/turf/simulated/floor/outdoors/dirt,
/area/submap/eclipsemountain)
"Is" = (
/mob/living/simple_mob/humanoid/eclipse/solar/teslanoodle,
/turf/simulated/floor/bluegrid,
/area/submap/eclipsemountain)
"IQ" = (
/obj/effect/floor_decal/corner/grey/diagonal,
/mob/living/simple_mob/humanoid/eclipse/solar/hellhound{
	loot_list = list(/obj/item/slime_extract/sepia = 1, /obj/item/bone/skull = 100, /obj/item/cell/device/weapon/recharge/alien/hybrid = 50)
	},
/turf/simulated/floor/tiled/steel,
/area/submap/eclipsemountain)
"Jg" = (
/turf/template_noop,
/area/template_noop)
"JK" = (
/obj/structure/table/steel,
/obj/effect/floor_decal/corner/red/diagonal,
/turf/simulated/floor/tiled/red,
/area/submap/eclipsemountain)
"JO" = (
/turf/simulated/floor/wood{
	oxygen = 20.7263;
	nitrogen = 93.7835;
	temperature = 243.15
	},
/area/submap/eclipsemountain)
"Ky" = (
/obj/machinery/door/blast/puzzle{
	id = "puzzlemtC"
	},
/turf/simulated/floor/reinforced,
/area/submap/eclipsemountain)
"Ln" = (
/obj/structure/table/steel,
/obj/random/medical/pillbottle,
/obj/random/material/refined,
/obj/effect/floor_decal/corner/grey/diagonal,
/turf/simulated/floor/tiled/steel,
/area/submap/eclipsemountain)
"LT" = (
/obj/structure/table/gold,
/obj/random/ammo,
/obj/random/maintenance/security,
/obj/random/maintenance/research,
/obj/machinery/light{
	dir = 4
	},
/obj/effect/floor_decal/corner/yellow/diagonal,
/turf/simulated/floor/tiled/yellow,
/area/submap/eclipsemountain)
"LV" = (
/obj/effect/floor_decal/corner/black/diagonal,
/turf/simulated/floor/tiled/dark,
/area/submap/eclipsemountain)
"Mr" = (
/obj/structure/table/gold,
/obj/random/ammo,
/obj/random/maintenance/security,
/obj/machinery/light,
/obj/effect/floor_decal/corner/yellow/diagonal,
/turf/simulated/floor/tiled/yellow,
/area/submap/eclipsemountain)
"Ms" = (
/obj/structure/cliff/automatic/corner{
	dir = 10
	},
/turf/simulated/floor/outdoors/dirt,
/area/submap/eclipsemountain)
"My" = (
/obj/structure/table/rack,
/obj/random/rigsuit,
/obj/random/weapon,
/obj/machinery/light{
	dir = 8
	},
/turf/simulated/floor/tiled/red,
/area/submap/eclipsemountain)
"MK" = (
/obj/structure/table/rack,
/obj/random/projectile/random,
/obj/random/gun/random,
/obj/random/handgun,
/obj/item/rig/merc,
/turf/simulated/floor/tiled/red,
/area/submap/eclipsemountain)
"MM" = (
/turf/simulated/wall/r_wall,
/area/submap/eclipsemountain)
"Nv" = (
/obj/machinery/door/window/southright,
/obj/effect/floor_decal/corner/red/diagonal,
/turf/simulated/floor/tiled/red,
/area/submap/eclipsemountain)
"Oa" = (
/mob/living/simple_mob/humanoid/eclipse/lunar/pummler,
/turf/simulated/floor/tiled/steel,
/area/submap/eclipsemountain)
"Od" = (
/turf/simulated/floor/reinforced/phoron{
	phoron = 100
	},
/area/submap/eclipsemountain)
"Ov" = (
/obj/machinery/light{
	dir = 4
	},
/obj/effect/floor_decal/corner/grey/diagonal,
/turf/simulated/floor/tiled/steel,
/area/submap/eclipsemountain)
"OM" = (
/obj/structure/cliff/automatic/corner{
	dir = 9
	},
/turf/simulated/floor/outdoors/dirt,
/area/submap/eclipsemountain)
"Pq" = (
/obj/structure/cliff/automatic/corner{
	dir = 6
	},
/turf/simulated/floor/outdoors/dirt,
/area/submap/eclipsemountain)
"PL" = (
/obj/machinery/light,
/obj/effect/floor_decal/corner/grey/diagonal,
/turf/simulated/floor/tiled/steel,
/area/submap/eclipsemountain)
"PP" = (
/obj/structure/grille,
/obj/structure/window/phoronreinforced{
	dir = 8
	},
/obj/structure/window/phoronreinforced{
	dir = 4
	},
/obj/structure/window/phoronreinforced,
/obj/effect/floor_decal/corner/red/diagonal,
/turf/simulated/floor/tiled/red,
/area/submap/eclipsemountain)
"QT" = (
/obj/structure/table/wooden_reinforced,
/obj/random/toolbox,
/turf/simulated/floor/wood{
	oxygen = 20.7263;
	nitrogen = 93.7835;
	temperature = 243.15
	},
/area/submap/eclipsemountain)
"Rg" = (
/obj/machinery/power/smes/buildable/point_of_interest,
/turf/simulated/floor/tiled/steel,
/area/submap/eclipsemountain)
"Tb" = (
/obj/machinery/door/airlock,
/turf/simulated/floor/tiled/steel,
/area/submap/eclipsemountain)
"Tc" = (
/obj/structure/table/wooden_reinforced,
/obj/random/tool/alien,
/obj/random/contraband,
/obj/machinery/light{
	dir = 4
	},
/turf/simulated/floor/wood{
	oxygen = 20.7263;
	nitrogen = 93.7835;
	temperature = 243.15
	},
/area/submap/eclipsemountain)
"Tp" = (
/obj/structure/table/gold,
/obj/random/maintenance/security,
/obj/random/maintenance/research,
/obj/effect/floor_decal/corner/yellow/diagonal,
/turf/simulated/floor/tiled/yellow,
/area/submap/eclipsemountain)
"TT" = (
/obj/structure/table/rack,
/obj/random/projectile/random,
/obj/random/gun/random,
/obj/random/handgun,
/obj/item/rig/hephaestus/equipped,
/turf/simulated/floor/tiled/red,
/area/submap/eclipsemountain)
"UA" = (
/obj/structure/cliff/automatic{
	dir = 6
	},
/turf/simulated/floor/outdoors/dirt,
/area/submap/eclipsemountain)
"Vp" = (
/obj/structure/table/gold,
/obj/random/ammo,
/obj/random/maintenance/security,
/obj/random/maintenance/research,
/obj/item/paper{
	info = "Our radio array is set up. Bits are pieces are unstable, although we remedied that by bouncing rare signals up to southern cross. They hopefully won't notice a few stray signals.";
	name = "Status Report"
	},
/obj/effect/floor_decal/corner/yellow/diagonal,
/turf/simulated/floor/tiled/yellow,
/area/submap/eclipsemountain)
"VM" = (
/obj/effect/floor_decal/corner/yellow/diagonal,
/turf/simulated/floor/tiled/yellow,
/area/submap/eclipsemountain)
"Wd" = (
/obj/machinery/power/terminal{
	dir = 1;
	icon_state = "term"
	},
/obj/structure/cable{
	icon_state = "0-4"
	},
/obj/structure/cable{
	icon_state = "4-8"
	},
/turf/simulated/floor/tiled/steel,
/area/submap/eclipsemountain)
"WC" = (
/obj/structure/cable{
	icon_state = "1-2"
	},
/obj/item/stack/material/void_opal,
/obj/structure/table/rack,
/turf/simulated/floor/tiled/steel,
/area/submap/eclipsemountain)
"XK" = (
/obj/structure/cliff/automatic/corner,
/turf/simulated/floor/outdoors/dirt,
/area/submap/eclipsemountain)
"XM" = (
/obj/structure/table/gold,
/obj/random/maintenance/security,
/obj/random/maintenance/research,
/obj/machinery/light{
	dir = 1
	},
/obj/effect/floor_decal/corner/yellow/diagonal,
/turf/simulated/floor/tiled/yellow,
/area/submap/eclipsemountain)
"XQ" = (
/obj/structure/grille,
/obj/structure/window/phoronreinforced{
	dir = 1
	},
/obj/structure/window/phoronreinforced{
	dir = 4
	},
/obj/structure/window/phoronreinforced,
/obj/effect/floor_decal/corner/red/diagonal,
/turf/simulated/floor/tiled/red,
/area/submap/eclipsemountain)
"Yh" = (
/turf/simulated/wall/dungeon,
/area/submap/eclipsemountain)
"YC" = (
/obj/structure/table/steel,
/obj/random/mainttoyloot/nofail,
/obj/random/material/refined,
/obj/effect/floor_decal/corner/grey/diagonal,
/turf/simulated/floor/tiled/steel,
/area/submap/eclipsemountain)
"YO" = (
/mob/living/simple_mob/humanoid/eclipse/lunar/silvernoodle,
/turf/simulated/floor/bluegrid,
/area/submap/eclipsemountain)
"YQ" = (
/mob/living/simple_mob/humanoid/eclipse/solar/radiation,
/obj/effect/floor_decal/corner/black/diagonal,
/turf/simulated/floor/tiled/dark,
/area/submap/eclipsemountain)
"Zr" = (
/obj/structure/table/darkglass,
/obj/machinery/button/remote/blast_door{
	id = "puzzlemtA"
	},
/obj/effect/floor_decal/corner/grey/diagonal,
/turf/simulated/floor/tiled/steel,
/area/submap/eclipsemountain)

(1,1,1) = {"
Jg
Jg
Jg
Jg
Jg
Jg
Jg
Jg
Jg
Jg
Jg
Jg
Jg
Jg
Jg
Jg
Jg
Jg
Jg
Jg
Jg
Jg
Jg
Jg
Jg
Jg
Jg
Jg
Jg
Jg
Jg
Jg
Jg
Jg
Jg
Jg
Jg
Jg
Jg
Jg
"}
(2,1,1) = {"
Jg
Pq
HN
HN
HN
HN
HN
HN
HN
HN
HN
HN
HN
HN
HN
HN
HN
HN
HN
HN
HN
HN
HN
HN
HN
HN
HN
HN
HN
HN
HN
HN
HN
HN
HN
HN
HN
HN
XK
Jg
"}
(3,1,1) = {"
Jg
yY
Cz
Cz
Cz
la
Cz
Cz
Cz
Cz
Cz
Cz
Cz
Cz
Cz
Cz
Cz
Cz
Cz
Cz
Cz
Cz
Cz
Cz
Cz
Cz
Cz
Cz
Cz
Cz
Cz
Cz
Cz
Cz
Cz
Cz
Cz
Cz
hw
Jg
"}
(4,1,1) = {"
Jg
yY
Cz
la
Cz
Cz
Cz
Cz
Pq
HN
HN
HN
HN
HN
HN
HN
HN
HN
HN
HN
HN
HN
HN
HN
HN
HN
HN
HN
HN
HN
HN
HN
HN
HN
HN
HN
XK
Cz
hw
Jg
"}
(5,1,1) = {"
Jg
yY
Cz
Cz
Cz
Cz
la
Cz
Cz
Cz
la
Cz
Cz
Cz
Cz
Cz
la
la
Cz
la
Cz
Cz
Cz
Cz
Cz
Cz
Cz
la
Cz
MM
MM
MM
MM
MM
MM
MM
hw
Cz
hw
Jg
"}
(6,1,1) = {"
Jg
yY
Cz
Cz
la
Cz
Cz
Cz
la
Cz
Cz
la
Cz
Cz
la
Cz
Cz
Cz
Cz
Cz
Cz
la
Cz
Cz
Cz
la
Cz
Cz
Cz
Tb
kx
kx
kx
kx
tQ
MM
hw
Cz
hw
Jg
"}
(7,1,1) = {"
Jg
yY
Cz
la
Cz
Cz
Cz
Cz
Cz
Cz
Cz
Cz
Cz
la
Cz
Cz
Cz
Cz
la
Cz
Cz
Cz
Cz
la
Cz
Cz
Cz
Cz
Cz
MM
kx
kx
Ov
kx
kx
MM
hw
Cz
hw
Jg
"}
(8,1,1) = {"
Jg
yY
Cz
Cz
Cz
Cz
la
Cz
Ms
Il
Il
Il
Cy
Cz
Cz
la
Cz
Cz
Cz
Cz
la
Cz
Cz
Cz
Cz
Cz
Cz
la
Cz
MM
lX
PP
MM
pE
pE
MM
hw
Cz
hw
Jg
"}
(9,1,1) = {"
Jg
yY
Cz
Cz
Cz
Cz
Cz
Cz
Cz
Cz
Cz
Cz
yY
Cz
Cz
Cz
Cz
Cz
Cz
Cz
Cz
Cz
Cz
Cz
la
Cz
Cz
Cz
Cz
MM
uC
JK
cW
kx
kx
MM
hw
Cz
hw
Jg
"}
(10,1,1) = {"
Jg
yY
Cz
la
Cz
Cz
Pq
HN
HN
HN
HN
HN
UA
Cz
la
Cz
Cz
la
Cz
la
Cz
Cz
la
Cz
Cz
Cz
Cz
Cz
Cz
MM
do
vb
XQ
kx
PL
MM
hw
Cz
hw
Jg
"}
(11,1,1) = {"
Jg
yY
Cz
Cz
Cz
Cz
yY
la
Cz
Cz
Cz
Cz
la
Cz
Cz
Cz
Cz
Cz
Cz
Cz
Cz
Cz
Cz
Cz
Cz
Cz
la
Cz
Cz
MM
uC
uC
Nv
kx
kx
MM
hw
Cz
hw
Jg
"}
(12,1,1) = {"
Jg
yY
la
Cz
Cz
Cz
yY
Cz
Cz
Cz
Cz
Cz
Pq
HN
HN
HN
HN
HN
HN
HN
HN
HN
HN
XK
Cz
Cz
Cz
Cz
Cz
MM
MM
MM
MM
MM
Tb
MM
hw
Cz
hw
Jg
"}
(13,1,1) = {"
Jg
yY
Cz
Cz
Cz
Cz
yY
Cz
Cz
la
Cz
Pq
UA
Cz
Cz
Cz
MM
MM
MM
MM
MM
MM
MM
MM
MM
jK
MM
MM
XK
Cz
Cz
Cz
Cz
Cz
Cz
Cz
hw
Cz
hw
Jg
"}
(14,1,1) = {"
Jg
yY
Cz
Cz
Cz
la
yY
Cz
la
Pq
HN
UA
Cz
Cz
Cz
Cz
MM
kx
sC
kx
kx
sC
kx
MM
kx
LV
kx
MM
hw
Cz
la
Cz
Cz
Cz
Cz
la
hw
Cz
hw
Jg
"}
(15,1,1) = {"
Jg
yY
Cz
Cz
Cz
Cz
yY
Cz
Cz
yY
MM
MM
vO
zb
vO
MM
MM
LV
LV
sr
kX
LV
LV
MM
kR
LV
qn
MM
hw
Cz
Cz
Cz
Cz
la
Cz
Cz
hw
Cz
hw
Jg
"}
(16,1,1) = {"
Jg
yY
Cz
la
Cz
Cz
yY
la
Cz
yY
MM
QT
JO
JO
JO
JO
MM
kx
LV
yy
yy
LV
kx
MM
kx
LV
kx
MM
hw
Cz
Cz
Cz
Cz
Cz
Cz
Cz
hw
Cz
hw
Jg
"}
(17,1,1) = {"
Jg
yY
Cz
Cz
Cz
Cz
yY
Cz
Cz
yY
dt
JO
JO
JO
JO
JO
jK
AR
LV
mL
mL
LV
YQ
bu
LV
LV
LV
MM
hw
Cz
la
Cz
Cz
Cz
la
Cz
hw
Cz
hw
Jg
"}
(18,1,1) = {"
Jg
yY
Cz
Cz
Cz
Cz
yY
Cz
Pq
UA
tI
JO
JO
JO
JO
jt
MM
kx
LV
Ln
YC
LV
kx
MM
kx
LV
kx
MM
hw
Cz
Cz
Cz
la
Cz
Cz
Cz
hw
Cz
hw
Jg
"}
(19,1,1) = {"
Jg
yY
Cz
Cz
la
Cz
yY
Cz
yY
Cz
dt
JO
JO
JO
JO
QT
MM
LV
LV
kX
kX
LV
LV
MM
kR
bN
qn
MM
hw
Cz
Cz
Cz
Cz
Cz
la
Cz
hw
Cz
hw
Jg
"}
(20,1,1) = {"
Jg
yY
Cz
Cz
Cz
Cz
yY
Cz
yY
Cz
MM
JO
JO
Tc
QT
bY
MM
kx
qv
kx
kx
qv
kx
MM
kx
LV
kx
MM
hw
Cz
Cz
la
Cz
Cz
Cz
Cz
hw
Cz
hw
Jg
"}
(21,1,1) = {"
Jg
yY
Cz
Cz
Cz
Cz
yY
Cz
yY
Cz
MM
MM
Tb
MM
MM
MM
MM
Yh
Yh
Yh
Yh
MM
MM
MM
LV
LV
LV
MM
hw
Cz
Cz
Cz
Cz
la
Cz
Cz
hw
Cz
hw
Jg
"}
(22,1,1) = {"
Jg
yY
Cz
la
Cz
Cz
yY
Cz
yY
Cz
MM
Tp
VM
ec
xO
sy
Yh
Yh
My
pm
Yh
Od
Od
MM
kx
LV
kx
MM
hw
Cz
Cz
Cz
la
Cz
Cz
Cz
hw
Cz
hw
Jg
"}
(23,1,1) = {"
Jg
yY
Cz
Cz
Cz
la
yY
la
yY
Cz
MM
xO
kx
VM
vC
xO
Yh
TT
ki
ki
Yh
Ky
Ky
MM
kR
LV
qn
MM
hw
Cz
la
Cz
Cz
la
Cz
Cz
hw
Cz
hw
Jg
"}
(24,1,1) = {"
Jg
yY
Cz
Cz
Cz
Cz
yY
Cz
yY
Cz
MM
XM
VM
Vp
VM
Mr
Yh
Fg
ki
uw
qO
iU
iU
nL
kx
uz
kx
MM
hw
Cz
Cz
Cz
Cz
Cz
Cz
la
hw
Cz
hw
Jg
"}
(25,1,1) = {"
Jg
yY
Cz
Cz
Cz
Cz
yY
Cz
Ms
Cy
MM
xO
IQ
VM
kx
xO
Yh
MK
ki
ki
Yh
Ky
Ky
MM
LV
LV
LV
MM
hw
Cz
Cz
Cz
Cz
Cz
Cz
Cz
hw
Cz
hw
Jg
"}
(26,1,1) = {"
Jg
yY
Cz
Cz
la
Cz
yY
Cz
Cz
yY
MM
sy
VM
LT
xO
sy
Yh
Yh
EA
pm
Yh
Od
Od
MM
Zr
De
fX
MM
hw
Cz
Cz
la
Cz
Cz
la
Cz
hw
Cz
hw
Jg
"}
(27,1,1) = {"
Jg
yY
la
Cz
Cz
Cz
yY
Cz
Cz
yY
MM
MM
Tb
MM
MM
MM
MM
Yh
Yh
Yh
Yh
MM
MM
MM
MM
MM
MM
MM
hw
Cz
Cz
Cz
Cz
la
Cz
Cz
hw
Cz
hw
Jg
"}
(28,1,1) = {"
Jg
yY
la
Cz
Cz
Cz
yY
Cz
Cz
yY
Cz
MM
kx
kx
kx
ls
MM
dJ
dJ
dJ
dJ
dJ
dJ
dJ
dJ
dJ
MM
EZ
OM
Cz
la
Cz
Cz
Cz
Cz
Cz
hw
Cz
hw
Jg
"}
(29,1,1) = {"
Jg
yY
Cz
Cz
Cz
la
yY
Cz
Cz
yY
Cz
MM
al
kx
kx
PL
MM
dJ
rJ
dJ
rJ
Is
rJ
dJ
rJ
dJ
MM
hw
Cz
Cz
Cz
Cz
Cz
Cz
Cz
Cz
hw
Cz
hw
Jg
"}
(30,1,1) = {"
Jg
yY
Cz
la
Cz
Cz
yY
Cz
la
yY
Cz
MM
ls
kx
kx
kx
Tb
dJ
rJ
dJ
rJ
Ii
rJ
dJ
rJ
dJ
MM
hw
Cz
Cz
MM
MM
Tb
Tb
MM
MM
hw
Cz
hw
Jg
"}
(31,1,1) = {"
Jg
yY
Cz
Cz
Cz
Cz
yY
Cz
Cz
Ms
Cy
MM
MM
MM
MM
MM
MM
dJ
rJ
dJ
rJ
YO
rJ
dJ
rJ
dJ
MM
hw
Cz
Cz
MM
Rg
vx
iU
iU
MM
hw
Cz
hw
Jg
"}
(32,1,1) = {"
Jg
yY
Cz
Cz
Cz
la
yY
Cz
Cz
Cz
Ms
Il
Cy
Cz
Cz
Cz
MM
dJ
dJ
dJ
dJ
dJ
dJ
dJ
dJ
dJ
MM
hw
Cz
Cz
MM
Rg
Wd
rI
iU
MM
hw
Cz
hw
Jg
"}
(33,1,1) = {"
Jg
yY
Cz
la
Cz
Cz
yY
Cz
Cz
Cz
la
Cz
Ms
Cy
Cz
Cz
MM
MM
MM
MM
MM
MM
MM
MM
MM
MM
MM
hw
Cz
Cz
MM
Rg
tS
WC
GC
MM
hw
Cz
hw
Jg
"}
(34,1,1) = {"
Jg
yY
Cz
Cz
Cz
Cz
yY
Cz
Cz
Cz
Cz
Cz
Cz
Ms
Il
Il
Il
Il
Il
Il
Il
Il
Il
Il
Il
Il
Il
OM
Cz
Cz
MM
Rg
Ec
Oa
iU
MM
hw
Cz
hw
Jg
"}
(35,1,1) = {"
Jg
yY
Cz
Cz
Cz
Cz
yY
Cz
Cz
Cz
Cz
Cz
la
Cz
Cz
Cz
Cz
Cz
Cz
Cz
Cz
Cz
la
Cz
Cz
Cz
Cz
Cz
Cz
Cz
MM
Rg
zZ
iU
iU
MM
hw
Cz
hw
Jg
"}
(36,1,1) = {"
Jg
yY
la
Cz
Cz
Cz
yY
Cz
la
Cz
Cz
Cz
Cz
Cz
la
Cz
Cz
Cz
la
Cz
Cz
Cz
Cz
Cz
Cz
Cz
Cz
la
Cz
Cz
MM
MM
MM
MM
MM
MM
hw
Cz
hw
Jg
"}
(37,1,1) = {"
Jg
yY
Cz
Cz
Cz
la
Ms
Il
Il
Il
Il
Il
Il
Il
Il
Il
Il
Il
Il
Il
Il
Il
Il
Il
Il
Il
Il
Il
Il
Il
Il
Il
Il
Il
Il
Il
OM
Cz
hw
Jg
"}
(38,1,1) = {"
Jg
yY
Cz
Cz
Cz
Cz
Cz
Cz
Cz
Cz
Cz
Cz
Cz
Cz
Cz
Cz
Cz
Cz
Cz
Cz
Cz
Cz
Cz
Cz
Cz
Cz
Cz
Cz
Cz
Cz
Cz
Cz
Cz
Cz
Cz
Cz
Cz
Cz
hw
Jg
"}
(39,1,1) = {"
Jg
yY
Cz
Cz
Cz
Cz
Il
Il
Il
Il
Il
Il
Il
Il
Il
Il
Il
Il
Il
Il
Il
Il
Il
Il
Il
Il
Il
Il
Il
Il
Il
Il
Il
Il
Il
Il
Il
Il
OM
Jg
"}
(40,1,1) = {"
Jg
Jg
Jg
Jg
Jg
Jg
Jg
Jg
Jg
Jg
Jg
Jg
Jg
Jg
Jg
Jg
Jg
Jg
Jg
Jg
Jg
Jg
Jg
Jg
Jg
Jg
Jg
Jg
Jg
Jg
Jg
Jg
Jg
Jg
Jg
Jg
Jg
Jg
Jg
Jg
"}
