//MAP CONVERTED BY dmm2tgm.py THIS HEADER COMMENT PREVENTS RECONVERSION, DO NOT REMOVE
"aH" = (
/mob/living/simple_mob/mechanical/cyber_horror/plasma_cyber_horror,
/obj/effect/floor_decal/corner/red/diagonal,
/turf/simulated/floor/tiled/dark,
/area/submap/fallenlab)
"aZ" = (
/obj/structure/table/darkglass,
/obj/item/ammo_casing/microbattery/medical/burn3,
/obj/random/maintenance/medical,
/obj/random/maintenance/medical,
/turf/simulated/floor/tiled/dark,
/area/submap/fallenlab)
"bH" = (
/obj/effect/floor_decal/corner/red/diagonal,
/turf/simulated/floor/tiled/dark,
/area/submap/fallenlab)
"bV" = (
/obj/machinery/oxygen_pump/mobile/anesthetic,
/obj/effect/floor_decal/corner/orange/diagonal,
/turf/simulated/floor/tiled/dark,
/area/submap/fallenlab)
"cQ" = (
/obj/effect/floor_decal/corner/orange/diagonal,
/mob/living/simple_mob/mechanical/cyber_horror/grey,
/turf/simulated/floor/tiled/dark,
/area/submap/fallenlab)
"dx" = (
/obj/effect/floor_decal/corner/red/diagonal,
/mob/living/simple_mob/mechanical/cyber_horror/grey,
/turf/simulated/floor/tiled/dark,
/area/submap/fallenlab)
"eq" = (
/obj/structure/closet/toolcloset,
/obj/effect/floor_decal/corner/orange/diagonal,
/turf/simulated/floor/tiled/dark,
/area/submap/fallenlab)
"es" = (
/turf/simulated/wall/ironphoron,
/area/submap/fallenlab)
"fh" = (
/mob/living/simple_mob/mechanical/cyber_horror/cat_cyber_horror,
/turf/simulated/floor/tiled/dark,
/area/submap/fallenlab)
"fl" = (
/obj/structure/salvageable/implant_container,
/obj/effect/decal/cleanable/dirt,
/obj/effect/decal/cleanable/dirt,
/obj/effect/floor_decal/corner/orange/diagonal,
/turf/simulated/floor/tiled/dark,
/area/submap/fallenlab)
"fr" = (
/mob/living/simple_mob/mechanical/cyber_horror/tajaran,
/obj/effect/decal/cleanable/dirt,
/obj/effect/decal/cleanable/dirt,
/obj/effect/floor_decal/corner/orange/diagonal,
/turf/simulated/floor/tiled/dark,
/area/submap/fallenlab)
"fL" = (
/obj/machinery/door/airlock/multi_tile/metal/mait,
/obj/effect/decal/cleanable/dirt,
/obj/effect/decal/cleanable/dirt,
/obj/effect/decal/cleanable/dirt,
/obj/effect/floor_decal/corner/red/diagonal,
/turf/simulated/floor/tiled/dark,
/area/submap/fallenlab)
"fY" = (
/obj/structure/table/standard,
/obj/random/maintenance/medical,
/obj/random/maintenance/engineering,
/obj/effect/floor_decal/corner/red/diagonal,
/turf/simulated/floor/tiled/dark,
/area/submap/fallenlab)
"gy" = (
/mob/living/simple_mob/mechanical/cyber_horror/corgi,
/obj/effect/decal/cleanable/dirt,
/obj/effect/decal/cleanable/dirt,
/obj/effect/floor_decal/corner/orange/diagonal,
/turf/simulated/floor/tiled/dark,
/area/submap/fallenlab)
"gN" = (
/obj/machinery/oxygen_pump/mobile/anesthetic,
/obj/effect/floor_decal/corner/red/diagonal,
/turf/simulated/floor/tiled/dark,
/area/submap/fallenlab)
"gP" = (
/obj/structure/table/standard,
/obj/item/ammo_casing/microbattery/medical/haste,
/obj/random/material/refined,
/obj/random/material/precious,
/obj/effect/floor_decal/corner/red/diagonal,
/turf/simulated/floor/tiled/dark,
/area/submap/fallenlab)
"hc" = (
/obj/machinery/porta_turret/stationary/syndie/CIWS,
/turf/simulated/floor/plating,
/area/submap/fallenlab)
"iw" = (
/mob/living/simple_mob/mechanical/cyber_horror/vox,
/obj/effect/floor_decal/corner/orange/diagonal,
/turf/simulated/floor/tiled/dark,
/area/submap/fallenlab)
"jh" = (
/obj/effect/decal/cleanable/dirt,
/obj/effect/decal/cleanable/dirt,
/obj/effect/decal/cleanable/dirt,
/obj/effect/decal/cleanable/dirt,
/obj/effect/floor_decal/corner/orange/diagonal,
/turf/simulated/floor/tiled/dark,
/area/submap/fallenlab)
"kh" = (
/obj/effect/floor_decal/corner/orange/diagonal,
/turf/simulated/floor/tiled/dark,
/area/submap/fallenlab)
"ki" = (
/obj/effect/decal/cleanable/dirt,
/obj/effect/floor_decal/corner/orange/diagonal,
/turf/simulated/floor/tiled/dark,
/area/submap/fallenlab)
"kq" = (
/obj/structure/table/darkglass,
/obj/random/medical,
/obj/random/maintenance/medical,
/obj/random/maintenance/medical,
/obj/effect/floor_decal/corner/red/diagonal,
/turf/simulated/floor/tiled/dark,
/area/submap/fallenlab)
"kW" = (
/obj/effect/decal/cleanable/dirt,
/obj/effect/decal/cleanable/dirt,
/obj/effect/floor_decal/corner/orange/diagonal,
/turf/simulated/floor/tiled/dark,
/area/submap/fallenlab)
"kZ" = (
/obj/structure/salvageable/data,
/obj/effect/decal/cleanable/dirt,
/obj/effect/floor_decal/corner/red/diagonal,
/turf/simulated/floor/tiled/dark,
/area/submap/fallenlab)
"lh" = (
/turf/simulated/floor/grass,
/area/submap/fallenlab)
"mf" = (
/obj/machinery/door/airlock,
/obj/effect/floor_decal/corner/orange/diagonal,
/turf/simulated/floor/tiled/dark,
/area/submap/fallenlab)
"mo" = (
/obj/structure/table/standard,
/obj/random/material/refined,
/obj/random/material/precious,
/obj/effect/floor_decal/corner/orange/diagonal,
/obj/item/clothing/suit/armor/crusader,
/turf/simulated/floor/tiled/dark,
/area/submap/fallenlab)
"ny" = (
/obj/structure/salvageable/data,
/obj/effect/floor_decal/corner/red/diagonal,
/turf/simulated/floor/tiled/dark,
/area/submap/fallenlab)
"qK" = (
/obj/structure/table/darkglass,
/obj/random/maintenance/medical,
/obj/random/maintenance/medical,
/obj/effect/floor_decal/corner/orange/diagonal,
/turf/simulated/floor/tiled/dark,
/area/submap/fallenlab)
"qL" = (
/obj/effect/decal/cleanable/dirt,
/obj/effect/decal/cleanable/dirt,
/obj/effect/decal/cleanable/dirt,
/obj/effect/floor_decal/corner/red/diagonal,
/turf/simulated/floor/tiled/dark,
/area/submap/fallenlab)
"rk" = (
/obj/machinery/portable_atmospherics/canister/oxygen,
/turf/simulated/floor/tiled/dark,
/area/submap/fallenlab)
"rv" = (
/obj/machinery/door/airlock/external,
/turf/simulated/floor/tiled/dark,
/area/submap/fallenlab)
"rL" = (
/mob/living/simple_mob/mechanical/cyber_horror/tajaran,
/obj/effect/floor_decal/corner/orange/diagonal,
/turf/simulated/floor/tiled/dark,
/area/submap/fallenlab)
"sf" = (
/obj/machinery/optable,
/obj/effect/decal/cleanable/dirt,
/obj/effect/floor_decal/corner/orange/diagonal,
/turf/simulated/floor/tiled/dark,
/area/submap/fallenlab)
"sg" = (
/obj/structure/table/standard,
/obj/random/maintenance/medical,
/obj/random/maintenance/engineering,
/obj/effect/floor_decal/corner/orange/diagonal,
/turf/simulated/floor/tiled/dark,
/area/submap/fallenlab)
"sM" = (
/obj/effect/decal/cleanable/dirt,
/obj/effect/floor_decal/corner/red/diagonal,
/turf/simulated/floor/tiled/dark,
/area/submap/fallenlab)
"sN" = (
/obj/structure/dispenser/oxygen,
/turf/simulated/floor/tiled/dark,
/area/submap/fallenlab)
"sS" = (
/obj/structure/table/standard,
/obj/item/nif,
/obj/random/maintenance/foodstuff,
/obj/random/maintenance/foodstuff,
/obj/effect/floor_decal/corner/orange/diagonal,
/turf/simulated/floor/tiled/dark,
/area/submap/fallenlab)
"tc" = (
/obj/structure/table/standard,
/obj/item/ammo_casing/microbattery/medical/brute3,
/obj/random/maintenance/medical,
/obj/random/maintenance/engineering,
/obj/effect/floor_decal/corner/red/diagonal,
/turf/simulated/floor/tiled/dark,
/area/submap/fallenlab)
"tl" = (
/obj/structure/table/darkglass,
/obj/item/ammo_casing/microbattery/medical/brute3,
/obj/random/maintenance/medical,
/obj/random/maintenance/medical,
/obj/effect/floor_decal/corner/orange/diagonal,
/turf/simulated/floor/tiled/dark,
/area/submap/fallenlab)
"tI" = (
/obj/structure/table/standard,
/obj/random/maintenance/foodstuff,
/obj/random/maintenance/foodstuff,
/obj/effect/floor_decal/corner/orange/diagonal,
/turf/simulated/floor/tiled/dark,
/area/submap/fallenlab)
"vt" = (
/obj/machinery/optable,
/obj/effect/floor_decal/corner/orange/diagonal,
/turf/simulated/floor/tiled/dark,
/area/submap/fallenlab)
"wi" = (
/obj/structure/table/standard,
/obj/item/gun/projectile/cell_loaded/medical,
/obj/random/maintenance/medical,
/obj/random/maintenance/engineering,
/obj/effect/floor_decal/corner/orange/diagonal,
/turf/simulated/floor/tiled/dark,
/area/submap/fallenlab)
"xo" = (
/obj/structure/table/darkglass,
/obj/item/storage/toolbox/syndicate/powertools,
/obj/random/maintenance/research,
/obj/random/maintenance/research,
/obj/effect/floor_decal/corner/orange/diagonal,
/turf/simulated/floor/tiled/dark,
/area/submap/fallenlab)
"xI" = (
/mob/living/simple_mob/mechanical/cyber_horror/ling_cyber_horror,
/obj/effect/decal/cleanable/dirt,
/obj/effect/floor_decal/corner/red/diagonal,
/turf/simulated/floor/tiled/dark,
/area/submap/fallenlab)
"ye" = (
/obj/structure/salvageable/server,
/obj/effect/floor_decal/corner/red/diagonal,
/turf/simulated/floor/tiled/dark,
/area/submap/fallenlab)
"yC" = (
/obj/machinery/door/airlock,
/turf/simulated/floor/tiled/dark,
/area/submap/fallenlab)
"zJ" = (
/obj/structure/salvageable/computer,
/obj/effect/floor_decal/corner/red/diagonal,
/turf/simulated/floor/tiled/dark,
/area/submap/fallenlab)
"Ay" = (
/obj/structure/salvageable/console_broken_os,
/obj/effect/floor_decal/corner/orange/diagonal,
/turf/simulated/floor/tiled/dark,
/area/submap/fallenlab)
"AE" = (
/mob/living/simple_mob/mechanical/cyber_horror/cat_cyber_horror,
/obj/effect/decal/cleanable/dirt,
/obj/effect/decal/cleanable/dirt,
/obj/effect/floor_decal/corner/orange/diagonal,
/obj/effect/floor_decal/corner/orange/diagonal,
/turf/simulated/floor/tiled/dark,
/area/submap/fallenlab)
"AU" = (
/obj/structure/salvageable/data,
/obj/effect/decal/cleanable/dirt,
/obj/effect/decal/cleanable/dirt,
/obj/effect/floor_decal/corner/orange/diagonal,
/turf/simulated/floor/tiled/dark,
/area/submap/fallenlab)
"Bi" = (
/obj/structure/table/darkglass,
/obj/random/maintenance/morestuff,
/obj/effect/floor_decal/corner/red/diagonal,
/turf/simulated/floor/tiled/dark,
/area/submap/fallenlab)
"Ck" = (
/mob/living/simple_mob/mechanical/cyber_horror/vox,
/obj/effect/decal/cleanable/dirt,
/obj/effect/decal/cleanable/dirt,
/obj/effect/floor_decal/corner/red/diagonal,
/turf/simulated/floor/tiled/dark,
/area/submap/fallenlab)
"Cw" = (
/obj/effect/decal/cleanable/dirt,
/obj/effect/decal/cleanable/dirt,
/obj/effect/floor_decal/corner/red/diagonal,
/obj/effect/floor_decal/corner/orange/diagonal,
/turf/simulated/floor/tiled/dark,
/area/submap/fallenlab)
"Cx" = (
/obj/structure/salvageable/data,
/obj/effect/floor_decal/corner/orange/diagonal,
/turf/simulated/floor/tiled/dark,
/area/submap/fallenlab)
"CW" = (
/obj/structure/table/darkglass,
/obj/random/maintenance/morestuff,
/obj/effect/floor_decal/corner/orange/diagonal,
/turf/simulated/floor/tiled/dark,
/area/submap/fallenlab)
"Dz" = (
/obj/effect/decal/cleanable/dirt,
/obj/effect/decal/cleanable/dirt,
/obj/effect/decal/cleanable/dirt,
/obj/effect/floor_decal/corner/orange/diagonal,
/turf/simulated/floor/tiled/dark,
/area/submap/fallenlab)
"DM" = (
/obj/structure/table/rack,
/obj/item/clothing/suit/space/void/syndicate_contract,
/obj/item/clothing/head/helmet/space/void/syndicate_contract,
/turf/simulated/floor/tiled/dark,
/area/submap/fallenlab)
"Et" = (
/mob/living/simple_mob/mechanical/cyber_horror/cat_cyber_horror,
/obj/effect/decal/cleanable/dirt,
/obj/effect/floor_decal/corner/red/diagonal,
/turf/simulated/floor/tiled/dark,
/area/submap/fallenlab)
"Gi" = (
/turf/simulated/wall/iron,
/area/submap/fallenlab)
"GJ" = (
/mob/living/simple_mob/mechanical/cyber_horror/ling_cyber_horror,
/obj/effect/decal/cleanable/dirt,
/obj/effect/decal/cleanable/dirt,
/obj/effect/floor_decal/corner/red/diagonal,
/turf/simulated/floor/tiled/dark,
/area/submap/fallenlab)
"HP" = (
/turf/simulated/floor/tiled/dark,
/area/submap/fallenlab)
"Iq" = (
/obj/machinery/optable,
/obj/effect/decal/cleanable/dirt,
/obj/effect/floor_decal/corner/red/diagonal,
/turf/simulated/floor/tiled/dark,
/area/submap/fallenlab)
"Iw" = (
/mob/living/simple_mob/mechanical/cyber_horror/tajaran,
/obj/effect/decal/cleanable/dirt,
/obj/effect/floor_decal/corner/orange/diagonal,
/turf/simulated/floor/tiled/dark,
/area/submap/fallenlab)
"Ix" = (
/obj/effect/decal/cleanable/dirt,
/turf/simulated/floor/tiled/dark,
/area/submap/fallenlab)
"KF" = (
/obj/machinery/oxygen_pump/mobile/anesthetic,
/obj/effect/decal/cleanable/dirt,
/obj/effect/floor_decal/corner/orange/diagonal,
/turf/simulated/floor/tiled/dark,
/area/submap/fallenlab)
"KI" = (
/obj/structure/table/darkglass,
/obj/random/maintenance/medical,
/obj/random/maintenance/medical,
/obj/effect/floor_decal/corner/red/diagonal,
/obj/random/medical,
/turf/simulated/floor/tiled/dark,
/area/submap/fallenlab)
"KR" = (
/obj/structure/table/darkglass,
/obj/random/maintenance/research,
/obj/random/maintenance/research,
/obj/effect/floor_decal/corner/red/diagonal,
/turf/simulated/floor/tiled/dark,
/area/submap/fallenlab)
"Ld" = (
/obj/structure/table/darkglass,
/obj/item/ammo_casing/microbattery/medical/burn3,
/obj/random/toolbox,
/obj/random/maintenance/research,
/obj/random/maintenance/research,
/obj/effect/floor_decal/corner/orange/diagonal,
/turf/simulated/floor/tiled/dark,
/area/submap/fallenlab)
"Mp" = (
/obj/structure/table/standard,
/obj/item/ammo_magazine/cell_mag/medical/advanced,
/obj/random/maintenance/medical,
/obj/random/maintenance/engineering,
/obj/effect/floor_decal/corner/orange/diagonal,
/turf/simulated/floor/tiled/dark,
/area/submap/fallenlab)
"Ni" = (
/obj/structure/table/standard,
/obj/item/ammo_casing/microbattery/medical/haste,
/obj/random/maintenance/medical,
/obj/random/maintenance/engineering,
/obj/effect/floor_decal/corner/orange/diagonal,
/turf/simulated/floor/tiled/dark,
/area/submap/fallenlab)
"NT" = (
/mob/living/simple_mob/mechanical/cyber_horror/vox,
/obj/effect/floor_decal/corner/red/diagonal,
/turf/simulated/floor/tiled/dark,
/area/submap/fallenlab)
"OG" = (
/mob/living/simple_mob/mechanical/cyber_horror/ling_cyber_horror,
/obj/effect/floor_decal/corner/red/diagonal,
/turf/simulated/floor/tiled/dark,
/area/submap/fallenlab)
"OO" = (
/obj/structure/table/standard,
/obj/item/clothing/mask/gas/syndicate,
/obj/random/maintenance/foodstuff,
/obj/random/maintenance/foodstuff,
/obj/effect/floor_decal/corner/orange/diagonal,
/turf/simulated/floor/tiled/dark,
/area/submap/fallenlab)
"PB" = (
/mob/living/simple_mob/mechanical/cyber_horror/ling_cyber_horror,
/obj/effect/floor_decal/corner/orange/diagonal,
/turf/simulated/floor/tiled/dark,
/area/submap/fallenlab)
"Qh" = (
/obj/machinery/optable,
/obj/effect/floor_decal/corner/red/diagonal,
/turf/simulated/floor/tiled/dark,
/area/submap/fallenlab)
"QH" = (
/mob/living/simple_mob/mechanical/cyber_horror/tajaran,
/obj/effect/decal/cleanable/dirt,
/obj/effect/floor_decal/corner/red/diagonal,
/turf/simulated/floor/tiled/dark,
/area/submap/fallenlab)
"Rg" = (
/obj/structure/table/standard,
/obj/random/material/refined,
/obj/effect/floor_decal/corner/orange/diagonal,
/turf/simulated/floor/tiled/dark,
/area/submap/fallenlab)
"RQ" = (
/obj/machinery/clonepod,
/obj/effect/floor_decal/corner/red/diagonal,
/turf/simulated/floor/tiled/dark,
/area/submap/fallenlab)
"RS" = (
/obj/structure/salvageable/computer,
/obj/effect/floor_decal/corner/orange/diagonal,
/turf/simulated/floor/tiled/dark,
/area/submap/fallenlab)
"SK" = (
/obj/item/clothing/suit/armor/reactive,
/mob/living/simple_mob/mechanical/cyber_horror/corgi,
/turf/simulated/floor/grass,
/area/submap/fallenlab)
"SL" = (
/mob/living/simple_mob/mechanical/cyber_horror/corgi,
/obj/effect/decal/cleanable/dirt,
/obj/effect/floor_decal/corner/red/diagonal,
/turf/simulated/floor/tiled/dark,
/area/submap/fallenlab)
"SX" = (
/turf/template_noop,
/area/template_noop)
"Ub" = (
/obj/structure/table/standard,
/obj/random/material/refined,
/obj/random/material/precious,
/obj/effect/floor_decal/corner/red/diagonal,
/turf/simulated/floor/tiled/dark,
/area/submap/fallenlab)
"Uf" = (
/obj/machinery/clonepod,
/obj/effect/floor_decal/corner/orange/diagonal,
/turf/simulated/floor/tiled/dark,
/area/submap/fallenlab)
"UG" = (
/obj/machinery/oxygen_pump/mobile/anesthetic,
/obj/effect/decal/cleanable/dirt,
/obj/effect/decal/cleanable/dirt,
/obj/effect/floor_decal/corner/red/diagonal,
/turf/simulated/floor/tiled/dark,
/area/submap/fallenlab)
"UK" = (
/obj/machinery/door/airlock/multi_tile/metal/mait,
/obj/effect/floor_decal/corner/orange/diagonal,
/turf/simulated/floor/tiled/dark,
/area/submap/fallenlab)
"Wd" = (
/obj/structure/salvageable/console_broken_os,
/obj/effect/floor_decal/corner/red/diagonal,
/turf/simulated/floor/tiled/dark,
/area/submap/fallenlab)
"XG" = (
/obj/effect/decal/cleanable/dirt,
/obj/effect/floor_decal/corner/orange/diagonal,
/mob/living/simple_mob/mechanical/cyber_horror/corgi,
/turf/simulated/floor/tiled/dark,
/area/submap/fallenlab)
"XJ" = (
/obj/effect/decal/cleanable/dirt,
/obj/effect/decal/cleanable/dirt,
/obj/effect/floor_decal/corner/red/diagonal,
/turf/simulated/floor/tiled/dark,
/area/submap/fallenlab)
"XS" = (
/obj/structure/salvageable/data,
/obj/effect/decal/cleanable/dirt,
/obj/effect/decal/cleanable/dirt,
/obj/effect/decal/cleanable/dirt,
/obj/effect/floor_decal/corner/orange/diagonal,
/turf/simulated/floor/tiled/dark,
/area/submap/fallenlab)
"Yn" = (
/mob/living/simple_mob/mechanical/cyber_horror/plasma_cyber_horror,
/turf/simulated/floor/grass,
/area/submap/fallenlab)
"Yv" = (
/obj/machinery/door/airlock/external/bolted,
/turf/simulated/floor/tiled/dark,
/area/submap/fallenlab)
"ZC" = (
/obj/machinery/door/airlock/external,
/obj/effect/floor_decal/corner/red/diagonal,
/turf/simulated/floor/tiled/dark,
/area/submap/fallenlab)

(1,1,1) = {"
SX
SX
SX
SX
SX
SX
SX
SX
SX
SX
SX
SX
SX
SX
SX
SX
SX
SX
SX
SX
SX
SX
SX
SX
SX
SX
SX
SX
SX
"}
(2,1,1) = {"
SX
Gi
Gi
Gi
Gi
Gi
Gi
Gi
Gi
Gi
Gi
Gi
Gi
Gi
Gi
Gi
Gi
Gi
Gi
Gi
Gi
Gi
hc
SX
SX
SX
SX
SX
SX
"}
(3,1,1) = {"
SX
Gi
KR
cQ
bH
ki
Gi
rL
bH
Cx
bH
ki
XJ
ki
bH
kh
ye
Gi
rk
sN
rk
Gi
SX
SX
SX
SX
SX
SX
SX
"}
(4,1,1) = {"
SX
Gi
xo
bH
kW
sM
yC
bH
ki
sM
kW
qL
kW
qL
XS
Cw
ki
rv
fh
HP
HP
rv
SX
SX
SX
SX
SX
SX
SX
"}
(5,1,1) = {"
SX
Gi
KR
kh
XJ
ki
Gi
ki
qL
ki
kZ
kW
Et
Ay
bH
kh
sM
Gi
DM
DM
DM
Gi
hc
SX
SX
SX
SX
SX
SX
"}
(6,1,1) = {"
SX
Gi
Uf
bH
Dz
Bi
Gi
Gi
yC
Gi
Gi
Gi
Gi
Gi
Gi
Gi
Gi
Gi
Gi
Gi
Gi
Gi
Gi
Gi
SX
SX
SX
SX
SX
"}
(7,1,1) = {"
SX
Gi
RQ
kW
qL
sf
Gi
kh
sM
ki
bH
Iw
sM
Dz
fL
ki
XJ
kh
sM
ki
bH
XG
gP
Gi
SX
SX
SX
SX
SX
"}
(8,1,1) = {"
SX
Gi
Ay
XJ
kW
UG
Gi
sM
Dz
sM
jh
XJ
kW
sM
kh
sM
ki
XJ
kW
OG
kW
XJ
RS
Gi
SX
SX
SX
SX
SX
"}
(9,1,1) = {"
SX
Gi
Wd
kh
sM
KF
Gi
iw
XJ
ki
bH
eq
Gi
Gi
Gi
Gi
Gi
tI
sM
ki
sM
ki
zJ
Gi
SX
SX
SX
SX
SX
"}
(10,1,1) = {"
SX
Gi
Uf
bH
kW
Iq
Gi
tc
sg
fY
Mp
Gi
es
lh
Yn
lh
es
Gi
sS
XJ
kW
Ck
mo
Gi
SX
SX
SX
SX
SX
"}
(11,1,1) = {"
SX
Gi
RQ
kh
qL
CW
Gi
Gi
Gi
Gi
Gi
es
lh
lh
lh
lh
lh
es
Gi
Gi
Gi
Gi
Gi
Gi
Gi
Gi
Gi
Gi
SX
"}
(12,1,1) = {"
SX
Gi
qK
aH
kW
sM
Gi
XJ
kW
sM
Gi
lh
lh
lh
lh
lh
lh
lh
Gi
XJ
ki
bH
Gi
sM
fr
bH
aZ
Gi
SX
"}
(13,1,1) = {"
SX
Gi
kq
kh
SL
Dz
rv
kh
xI
kW
Yv
Yn
lh
lh
SK
lh
lh
Yn
Yv
ki
GJ
ki
ZC
kW
XJ
kh
KI
Gi
SX
"}
(14,1,1) = {"
SX
Gi
tl
bH
kh
sM
Gi
bH
kh
XJ
Gi
lh
lh
lh
lh
lh
lh
lh
Gi
bH
ki
bH
Gi
bH
kW
bH
qK
Gi
SX
"}
(15,1,1) = {"
SX
Gi
Gi
Gi
Gi
Gi
Gi
Gi
Gi
Gi
Gi
es
lh
lh
lh
lh
lh
es
Gi
Gi
Gi
Gi
Gi
CW
qL
ki
RQ
Gi
SX
"}
(16,1,1) = {"
SX
SX
SX
SX
SX
Gi
Rg
dx
kh
bH
tI
Gi
es
lh
Yn
lh
es
Gi
wi
fY
Ni
fY
Gi
Qh
ki
sM
Uf
Gi
SX
"}
(17,1,1) = {"
SX
SX
SX
SX
SX
Gi
zJ
ki
sM
ki
NT
OO
Gi
Gi
Gi
Gi
Gi
eq
bH
kh
XJ
PB
Gi
bV
bH
gy
Wd
Gi
SX
"}
(18,1,1) = {"
SX
SX
SX
SX
SX
Gi
RS
bH
ki
sM
ki
sM
kW
XJ
UK
sM
ki
bH
Dz
XJ
kW
bH
Gi
gN
ki
XJ
Ay
Gi
SX
"}
(19,1,1) = {"
SX
SX
SX
SX
SX
Gi
Ub
ki
QH
kW
XJ
kW
sM
ki
Ix
kW
sM
rL
bH
kW
sM
kh
Gi
vt
sM
kW
RQ
Gi
SX
"}
(20,1,1) = {"
SX
SX
SX
SX
SX
Gi
Gi
Gi
Gi
Gi
Gi
Gi
Gi
Gi
Gi
Gi
Gi
Gi
Gi
Gi
mf
Gi
Gi
Bi
kh
XJ
Uf
Gi
SX
"}
(21,1,1) = {"
SX
SX
SX
SX
SX
SX
hc
Gi
DM
DM
DM
Gi
bH
kh
Wd
kh
bH
AE
qL
kW
sM
Cx
Gi
kh
XJ
kW
KR
Gi
SX
"}
(22,1,1) = {"
SX
SX
SX
SX
SX
SX
SX
rv
HP
HP
fh
ZC
kh
bH
kW
sM
fl
XJ
Dz
Ck
ki
sM
mf
sM
Dz
bH
Ld
Gi
SX
"}
(23,1,1) = {"
SX
SX
SX
SX
SX
SX
SX
Gi
rk
sN
rk
Gi
bH
AU
sM
ki
sM
ki
ny
kh
sM
kW
Gi
kW
bH
cQ
KR
Gi
SX
"}
(24,1,1) = {"
SX
SX
SX
SX
SX
SX
hc
Gi
Gi
Gi
Gi
Gi
Gi
Gi
Gi
Gi
Gi
Gi
Gi
Gi
Gi
Gi
Gi
Gi
Gi
Gi
Gi
Gi
SX
"}
(25,1,1) = {"
SX
SX
SX
SX
SX
SX
SX
SX
SX
SX
SX
SX
SX
SX
SX
SX
SX
SX
SX
SX
SX
SX
SX
SX
SX
SX
SX
SX
SX
"}
