//MAP CONVERTED BY dmm2tgm.py THIS HEADER COMMENT PREVENTS RECONVERSION, DO NOT REMOVE
"a" = (
/turf/simulated/floor/lava/harmless,
/area/submap/fallenportal)
"b" = (
/obj/structure/table/borosilicate,
/obj/item/spellbook/oneuse/charge,
/turf/simulated/floor/tiled/asteroid_steel,
/area/submap/fallenportal)
"c" = (
/mob/living/simple_mob/humanoid/cultist/human/bloodjaunt,
/turf/simulated/floor/cult{
	oxygen = 20.7263
	},
/area/submap/fallenportal)
"e" = (
/obj/structure/table/borosilicate,
/obj/random/handgun,
/turf/simulated/floor/cult{
	oxygen = 20.7263
	},
/area/submap/fallenportal)
"f" = (
/obj/structure/simple_door/cult,
/turf/simulated/floor/cult,
/area/submap/fallenportal)
"g" = (
/turf/simulated/floor/gorefloor{
	oxygen = 20.7263;
	nitrogen = 93.7835;
	temperature = 243.15
	},
/area/submap/fallenportal)
"h" = (
/mob/living/simple_mob/construct/artificer/caster,
/turf/simulated/floor/gorefloor2,
/area/submap/fallenportal)
"i" = (
/turf/simulated/floor/gorefloor2{
	nitrogen = 93.7835;
	oxygen = 20.7263;
	temperature = 243.15
	},
/area/submap/fallenportal)
"j" = (
/turf/simulated/floor/cult{
	oxygen = 20.7263;
	nitrogen = 93.7835
	},
/area/submap/fallenportal)
"k" = (
/obj/structure/table/borosilicate,
/obj/item/flame/candle/everburn,
/turf/simulated/floor/tiled/asteroid_steel,
/area/submap/fallenportal)
"l" = (
/turf/template_noop,
/area/submap/fallenportal)
"m" = (
/obj/fire,
/turf/simulated/floor/cult,
/area/submap/fallenportal)
"n" = (
/obj/structure/closet/crate,
/obj/item/clothing/suit/space/cult,
/obj/item/clothing/head/helmet/space/cult,
/obj/item/clothing/shoes/cult,
/obj/item/storage/backpack/cultpack,
/obj/item/melee/cultblade,
/obj/item/archaeological_find,
/obj/item/archaeological_find,
/obj/item/archaeological_find,
/turf/simulated/floor/gorefloor2,
/area/submap/fallenportal)
"o" = (
/obj/structure/closet/crate,
/obj/item/soulstone,
/obj/item/soulstone,
/obj/item/soulstone,
/obj/item/material/knife/ritual,
/obj/item/storage/backpack/cultpack,
/obj/item/clothing/suit/space/cult,
/obj/item/clothing/shoes/cult,
/obj/item/clothing/head/helmet/space/cult,
/obj/item/archaeological_find,
/obj/item/archaeological_find,
/obj/item/archaeological_find,
/turf/simulated/floor/cult,
/area/submap/fallenportal)
"p" = (
/obj/structure/closet/crate/secure/loot,
/obj/item/twohanded/fireaxe/fluff/mjollnir,
/turf/simulated/floor/cult,
/area/submap/fallenportal)
"q" = (
/obj/structure/table/borosilicate,
/obj/item/flame/candle/candelabra/everburn,
/turf/simulated/floor/tiled/asteroid_steel,
/area/submap/fallenportal)
"r" = (
/obj/fire,
/turf/simulated/floor/gorefloor,
/area/submap/fallenportal)
"t" = (
/turf/simulated/floor/tiled/asteroid_steel,
/area/submap/fallenportal)
"u" = (
/obj/item/deadringer,
/obj/item/vampiric,
/obj/item/clothing/suit/armor/pcarrier/bulletproof/full,
/turf/simulated/floor/gorefloor2,
/area/submap/fallenportal)
"v" = (
/turf/simulated/floor/cult{
	oxygen = 20.7263
	},
/area/submap/fallenportal)
"w" = (
/obj/structure/table/borosilicate,
/obj/item/telecube/randomized,
/turf/simulated/floor/tiled/asteroid_steel,
/area/submap/fallenportal)
"x" = (
/mob/living/simple_mob/construct/artificer/caster,
/turf/simulated/floor/cult,
/area/submap/fallenportal)
"y" = (
/mob/living/simple_mob/vore/demonAI/wendigo{
	faction = "cult"
	},
/turf/simulated/floor/cult{
	oxygen = 20.7263;
	nitrogen = 93.7835
	},
/area/submap/fallenportal)
"z" = (
/obj/structure/closet/crate,
/obj/item/soulstone,
/obj/item/soulstone,
/obj/item/soulstone,
/obj/item/material/knife/ritual,
/obj/item/material/knife/ritual,
/obj/item/storage/backpack/cultpack,
/obj/item/clothing/suit/space/cult,
/obj/item/clothing/shoes/cult,
/obj/item/clothing/head/helmet/space/cult,
/obj/item/storage/belt/bandolier,
/obj/item/storage/pill_bottle/dice_nerd,
/obj/item/shield/riot/tele,
/turf/simulated/floor/tiled/asteroid_steel,
/area/submap/fallenportal)
"A" = (
/obj/structure/simple_door/sandstone,
/turf/simulated/floor/tiled/asteroid_steel,
/area/submap/fallenportal)
"C" = (
/mob/living/simple_mob/humanoid/cultist/hunter,
/turf/simulated/floor/tiled/asteroid_steel,
/area/submap/fallenportal)
"D" = (
/turf/simulated/floor/gorefloor2,
/area/submap/fallenportal)
"E" = (
/mob/living/simple_mob/vore/demonAI{
	faction = "cult"
	},
/turf/simulated/floor/cult{
	oxygen = 20.7263;
	nitrogen = 93.7835
	},
/area/submap/fallenportal)
"F" = (
/obj/structure/table/borosilicate,
/obj/random/weapon/guarenteed,
/turf/simulated/floor/cult{
	oxygen = 20.7263
	},
/area/submap/fallenportal)
"G" = (
/turf/simulated/wall/sandstone,
/area/submap/fallenportal)
"H" = (
/turf/simulated/floor/gorefloor,
/area/submap/fallenportal)
"I" = (
/mob/living/simple_mob/construct/wraith,
/turf/simulated/floor/cult,
/area/submap/fallenportal)
"J" = (
/turf/simulated/wall/cult,
/area/submap/fallenportal)
"K" = (
/obj/structure/table/borosilicate,
/obj/item/melee/cultblade,
/turf/simulated/floor/tiled/asteroid_steel,
/area/submap/fallenportal)
"L" = (
/obj/structure/closet/crate/secure/loot,
/turf/simulated/floor/tiled/asteroid_steel,
/area/submap/fallenportal)
"M" = (
/obj/structure/closet/crate,
/obj/item/clothing/suit/space/cult,
/obj/item/clothing/head/helmet/space/cult,
/obj/item/clothing/shoes/cult,
/obj/item/storage/backpack/cultpack,
/obj/item/melee/cultblade,
/obj/item/archaeological_find,
/obj/item/archaeological_find,
/obj/item/archaeological_find,
/turf/simulated/floor/gorefloor,
/area/submap/fallenportal)
"O" = (
/turf/template_noop,
/area/template_noop)
"P" = (
/mob/living/simple_mob/humanoid/cultist/human/bloodjaunt/fireball,
/turf/simulated/floor/cult{
	oxygen = 20.7263;
	nitrogen = 93.7835
	},
/area/submap/fallenportal)
"R" = (
/obj/effect/landmark/loot_spawn,
/turf/template_noop,
/area/submap/fallenportal)
"S" = (
/mob/living/simple_mob/humanoid/cultist/lizard,
/turf/simulated/floor/tiled/asteroid_steel,
/area/submap/fallenportal)
"T" = (
/obj/structure/closet/crate,
/obj/item/soulstone,
/obj/item/soulstone,
/obj/item/soulstone,
/obj/item/material/knife/ritual,
/obj/item/material/knife/ritual,
/obj/item/storage/backpack/cultpack,
/obj/item/clothing/suit/space/cult,
/obj/item/clothing/shoes/cult,
/obj/item/clothing/head/helmet/space/cult,
/obj/item/storage/bagoplanets,
/obj/item/storage/pill_bottle/peridaxon,
/obj/item/shield/primitive,
/turf/simulated/floor/tiled/asteroid_steel,
/area/submap/fallenportal)
"U" = (
/mob/living/simple_mob/humanoid/cultist/castertesh,
/turf/simulated/floor/tiled/asteroid_steel,
/area/submap/fallenportal)
"V" = (
/mob/living/simple_mob/humanoid/cultist/tesh,
/turf/simulated/floor/tiled/asteroid_steel,
/area/submap/fallenportal)
"X" = (
/turf/simulated/floor/cult,
/area/submap/fallenportal)
"Z" = (
/mob/living/simple_mob/humanoid/cultist/noodle,
/turf/simulated/floor/tiled/asteroid_steel,
/area/submap/fallenportal)

(1,1,1) = {"
O
O
O
O
O
O
O
O
O
O
O
O
O
O
O
O
O
O
O
O
O
O
O
O
O
"}
(2,1,1) = {"
O
O
O
O
O
O
O
O
O
O
O
O
O
O
O
l
l
l
l
l
l
l
l
l
l
"}
(3,1,1) = {"
O
O
O
l
l
l
l
l
l
l
O
O
O
O
O
g
G
G
G
G
G
G
G
G
l
"}
(4,1,1) = {"
O
O
l
l
J
J
J
J
J
R
l
l
l
l
O
l
G
k
t
t
G
T
L
G
l
"}
(5,1,1) = {"
O
l
l
J
J
m
h
X
J
J
j
E
j
l
l
y
G
F
c
v
A
t
t
G
l
"}
(6,1,1) = {"
l
l
J
J
m
m
X
X
o
J
i
l
j
j
j
j
G
K
t
t
G
k
t
G
l
"}
(7,1,1) = {"
l
J
J
n
m
X
H
X
X
f
g
l
l
l
l
l
G
k
t
V
G
S
t
G
l
"}
(8,1,1) = {"
l
J
m
X
m
X
m
m
m
J
J
l
l
j
j
j
G
G
A
G
G
G
G
G
l
"}
(9,1,1) = {"
l
J
r
m
a
m
m
X
X
x
J
j
j
P
l
i
G
v
v
v
U
t
t
G
l
"}
(10,1,1) = {"
l
J
X
a
a
a
D
X
m
m
J
l
l
l
l
l
G
t
t
t
t
b
t
G
l
"}
(11,1,1) = {"
l
J
I
a
u
a
m
m
m
p
J
R
l
l
g
l
A
t
t
t
t
q
Z
G
l
"}
(12,1,1) = {"
l
J
X
a
a
a
X
X
m
r
J
g
l
l
l
l
G
t
t
t
t
w
t
G
l
"}
(13,1,1) = {"
l
J
m
m
a
m
m
D
X
x
J
j
j
P
l
l
G
v
v
v
U
t
t
G
l
"}
(14,1,1) = {"
l
J
m
X
m
X
m
m
m
J
J
l
l
j
j
j
G
G
A
G
G
G
G
G
l
"}
(15,1,1) = {"
l
J
J
M
m
X
X
X
X
f
l
l
l
l
l
i
G
k
t
V
G
C
t
G
l
"}
(16,1,1) = {"
l
l
J
J
m
m
X
X
o
J
l
g
j
j
j
j
G
K
t
t
G
k
t
G
l
"}
(17,1,1) = {"
O
l
l
J
J
m
x
H
J
J
j
y
j
l
l
E
G
e
c
v
A
t
t
G
l
"}
(18,1,1) = {"
O
O
l
l
J
J
J
J
J
R
l
l
l
l
O
l
G
k
t
t
G
z
L
G
l
"}
(19,1,1) = {"
O
O
O
l
l
l
l
l
l
l
O
O
O
O
O
l
G
G
G
G
G
G
G
G
l
"}
(20,1,1) = {"
O
O
O
O
O
O
O
O
O
O
O
O
O
O
O
l
l
l
l
l
l
l
l
l
l
"}
(21,1,1) = {"
O
O
O
O
O
O
O
O
O
O
O
O
O
O
O
O
O
O
O
O
O
O
O
O
O
"}
