//MAP CONVERTED BY dmm2tgm.py THIS HEADER COMMENT PREVENTS RECONVERSION, DO NOT REMOVE
"a" = (
/turf/simulated/mineral/floor/cave{
	nitrogen = 93.7835;
	oxygen = 20.7263;
	temperature = 243.15
	},
/area/submap/leppy)
"b" = (
/obj/structure/table/gold,
/obj/random/energy/highend,
/obj/random/meat,
/obj/random/meat,
/turf/simulated/mineral/floor/cave{
	nitrogen = 93.7835;
	oxygen = 20.7263;
	temperature = 243.15
	},
/area/submap/leppy)
"d" = (
/mob/living/simple_mob/vore/lamia/random,
/turf/simulated/mineral/floor/cave{
	nitrogen = 93.7835;
	oxygen = 20.7263;
	temperature = 243.15
	},
/area/submap/leppy)
"r" = (
/obj/structure/table/gold,
/obj/random/contraband,
/turf/simulated/mineral/floor/cave{
	nitrogen = 93.7835;
	oxygen = 20.7263;
	temperature = 243.15
	},
/area/submap/leppy)
"s" = (
/obj/machinery/portable_atmospherics/hydroponics/soil,
/obj/item/seeds/random,
/turf/simulated/mineral/floor/cave{
	nitrogen = 93.7835;
	oxygen = 20.7263;
	temperature = 243.15
	},
/area/submap/leppy)
"t" = (
/mob/living/simple_mob/vore/leopardmander/exotic,
/turf/simulated/floor/water/ocean{
	outdoors = 0
	},
/area/submap/leppy)
"z" = (
/turf/simulated/mineral/ignore_mapgen,
/area/submap/leppy)
"A" = (
/turf/template_noop,
/area/template_noop)
"D" = (
/obj/structure/table/gold,
/turf/simulated/mineral/floor/cave{
	nitrogen = 93.7835;
	oxygen = 20.7263;
	temperature = 243.15
	},
/area/submap/leppy)
"F" = (
/obj/structure/table/gold,
/obj/random/meat,
/obj/random/meat,
/obj/random/meat,
/turf/simulated/mineral/floor/cave{
	nitrogen = 93.7835;
	oxygen = 20.7263;
	temperature = 243.15
	},
/area/submap/leppy)
"J" = (
/obj/structure/table/gold,
/obj/random/maintenance/misc,
/turf/simulated/mineral/floor/cave{
	nitrogen = 93.7835;
	oxygen = 20.7263;
	temperature = 243.15
	},
/area/submap/leppy)
"K" = (
/turf/simulated/wall/sandstone,
/area/submap/leppy)
"L" = (
/turf/simulated/floor/water/ocean{
	outdoors = 0
	},
/area/submap/leppy)
"Z" = (
/obj/machinery/portable_atmospherics/hydroponics/soil,
/obj/item/seeds/ambrosiavulgarisseed,
/turf/simulated/mineral/floor/cave{
	nitrogen = 93.7835;
	oxygen = 20.7263;
	temperature = 243.15
	},
/area/submap/leppy)

(1,1,1) = {"
A
A
A
A
A
A
A
A
A
A
A
A
A
A
A
A
A
A
A
A
A
A
A
"}
(2,1,1) = {"
A
A
A
A
A
K
K
K
K
K
K
K
K
A
A
A
A
A
A
A
A
A
A
"}
(3,1,1) = {"
A
A
A
A
A
K
r
a
a
a
a
r
K
A
A
A
A
A
A
A
A
A
A
"}
(4,1,1) = {"
A
A
A
A
A
K
D
d
a
a
a
J
K
A
z
z
z
A
A
A
A
A
A
"}
(5,1,1) = {"
A
A
A
A
A
K
r
a
a
a
a
r
K
z
z
a
z
z
z
A
A
A
A
"}
(6,1,1) = {"
A
A
A
z
z
K
K
K
a
a
K
K
K
a
a
a
a
a
z
z
A
A
A
"}
(7,1,1) = {"
A
A
A
z
a
a
a
a
a
a
a
a
a
a
a
a
a
a
a
z
A
A
A
"}
(8,1,1) = {"
A
A
A
z
a
a
a
a
a
a
a
a
a
a
a
a
a
a
a
z
z
A
A
"}
(9,1,1) = {"
A
A
z
z
a
a
a
L
L
L
L
a
a
a
L
L
a
a
a
a
z
A
A
"}
(10,1,1) = {"
A
A
z
a
a
a
a
L
L
L
L
L
L
L
L
L
L
a
a
a
z
A
A
"}
(11,1,1) = {"
A
A
z
a
a
a
L
L
L
L
L
L
L
L
L
L
L
a
a
a
z
A
A
"}
(12,1,1) = {"
A
A
z
a
a
a
L
L
L
L
L
L
L
L
L
L
L
a
a
a
z
A
A
"}
(13,1,1) = {"
A
A
z
a
a
a
L
L
L
L
L
t
L
L
L
L
L
a
a
z
z
A
A
"}
(14,1,1) = {"
A
A
z
z
a
a
L
L
L
L
L
L
L
L
L
L
a
a
a
z
z
A
A
"}
(15,1,1) = {"
A
A
A
z
z
a
a
a
L
L
L
L
L
L
L
L
a
K
K
K
K
K
A
"}
(16,1,1) = {"
A
A
A
A
z
z
a
a
a
a
L
L
L
L
L
a
a
a
a
a
Z
K
A
"}
(17,1,1) = {"
A
A
A
K
K
K
a
a
K
a
a
L
L
L
a
a
a
a
a
a
a
K
A
"}
(18,1,1) = {"
A
A
A
K
F
a
a
a
K
a
a
a
a
a
a
a
a
K
s
a
Z
K
A
"}
(19,1,1) = {"
A
A
A
K
F
d
a
a
K
a
a
a
a
a
a
a
a
K
a
d
a
K
A
"}
(20,1,1) = {"
A
A
A
K
b
a
a
a
K
z
z
z
a
a
a
a
z
K
s
a
Z
K
A
"}
(21,1,1) = {"
A
A
A
K
K
K
K
K
K
A
A
z
z
z
z
z
z
K
K
K
K
K
A
"}
(22,1,1) = {"
A
A
A
A
A
A
A
A
A
A
A
A
A
A
A
A
A
A
A
A
A
A
A
"}
(23,1,1) = {"
A
A
A
A
A
A
A
A
A
A
A
A
A
A
A
A
A
A
A
A
A
A
A
"}
