//MAP CONVERTED BY dmm2tgm.py THIS HEADER COMMENT PREVENTS RECONVERSION, DO NOT REMOVE
"ao" = (
/turf/template_noop,
/area/template_noop)
"ay" = (
/obj/machinery/door/blast/shutters,
/obj/effect/floor_decal/industrial/warning{
	dir = 1
	},
/turf/simulated/floor/tiled/asteroid_steel,
/area/submap/mausarmy)
"cU" = (
/obj/machinery/door/blast/shutters,
/obj/effect/floor_decal/industrial/warning{
	dir = 10
	},
/turf/simulated/floor/tiled/asteroid_steel,
/area/submap/mausarmy)
"dd" = (
/obj/effect/floor_decal/corner_techfloor_gray/diagonal,
/obj/machinery/light/poi{
	dir = 4
	},
/turf/simulated/floor/tiled/asteroid_steel,
/area/submap/mausarmy)
"dW" = (
/obj/machinery/door/blast/shutters,
/turf/simulated/floor/tiled/asteroid_steel,
/area/submap/mausarmy)
"ed" = (
/obj/effect/floor_decal/corner_techfloor_gray/diagonal,
/obj/random/obstruction,
/obj/machinery/light/poi{
	dir = 1
	},
/turf/simulated/floor/tiled/asteroid_steel,
/area/submap/mausarmy)
"et" = (
/obj/random/trash_pile,
/turf/template_noop,
/area/template_noop)
"gf" = (
/obj/effect/floor_decal/corner_techfloor_gray/diagonal,
/mob/living/simple_mob/mechanical/mecha/mouse_tank/livewire,
/obj/structure/loot_pile/surface/bones,
/turf/simulated/floor/tiled/asteroid_steel,
/area/submap/mausarmy)
"ht" = (
/obj/random/trash_pile,
/turf/simulated/floor/outdoors/dirt/sif,
/area/submap/mausarmy)
"hR" = (
/obj/effect/floor_decal/corner_techfloor_gray/diagonal,
/obj/structure/closet/crate/secure/loot,
/turf/simulated/floor/tiled/asteroid_steel,
/area/submap/mausarmy)
"iL" = (
/obj/effect/floor_decal/corner/black/diagonal,
/obj/machinery/light/poi{
	dir = 8
	},
/turf/simulated/floor/tiled/asteroid_steel,
/area/submap/mausarmy)
"kT" = (
/obj/effect/floor_decal/corner_techfloor_gray/diagonal,
/obj/random/obstruction,
/obj/machinery/light/poi,
/turf/simulated/floor/tiled/asteroid_steel,
/area/submap/mausarmy)
"lI" = (
/obj/effect/floor_decal/corner/blue/diagonal,
/obj/item/slime_irradiator,
/turf/simulated/floor/tiled/asteroid_steel,
/area/submap/mausarmy)
"mJ" = (
/obj/effect/floor_decal/corner_techfloor_gray/diagonal,
/obj/random/crate,
/obj/random/maintenance/clean,
/obj/random/maintenance/engineering,
/obj/random/maintenance/medical,
/obj/random/contraband,
/turf/simulated/floor/tiled/asteroid_steel,
/area/submap/mausarmy)
"mQ" = (
/mob/living/simple_mob/mechanical/mecha/mouse_tank/livewire,
/turf/simulated/shuttle/floor/yellow,
/area/submap/mausarmy)
"oS" = (
/obj/effect/floor_decal/corner/blue/diagonal,
/obj/structure/closet/crate/secure/lootsafe/numberlock,
/turf/simulated/floor/tiled/asteroid_steel,
/area/submap/mausarmy)
"pB" = (
/obj/effect/floor_decal/industrial/warning{
	dir = 8
	},
/obj/effect/decal/cleanable/blood,
/turf/simulated/floor/tiled/asteroid_steel,
/area/submap/mausarmy)
"ra" = (
/obj/effect/floor_decal/corner_techfloor_gray/diagonal,
/obj/effect/decal/cleanable/blood,
/turf/simulated/floor/tiled/asteroid_steel,
/area/submap/mausarmy)
"rx" = (
/obj/effect/floor_decal/corner/blue/diagonal,
/obj/machinery/light/poi{
	dir = 1
	},
/turf/simulated/floor/tiled/asteroid_steel,
/area/submap/mausarmy)
"sg" = (
/obj/structure/cable{
	d2 = 4;
	icon_state = "0-4"
	},
/obj/machinery/power/apc,
/turf/simulated/floor/outdoors/dirt/sif,
/area/submap/mausarmy)
"tq" = (
/obj/machinery/door/blast/shutters,
/obj/effect/floor_decal/industrial/warning,
/turf/simulated/floor/tiled/asteroid_steel,
/area/submap/mausarmy)
"vj" = (
/obj/effect/floor_decal/corner_techfloor_gray/diagonal,
/obj/random/obstruction,
/turf/simulated/floor/tiled/asteroid_steel,
/area/submap/mausarmy)
"vn" = (
/obj/machinery/door/blast/shutters,
/obj/effect/floor_decal/industrial/warning{
	dir = 9
	},
/turf/simulated/floor/tiled/asteroid_steel,
/area/submap/mausarmy)
"vp" = (
/obj/effect/floor_decal/corner_techfloor_gray/diagonal,
/obj/structure/closet/crate/secure/loot,
/obj/machinery/light/poi{
	dir = 1
	},
/turf/simulated/floor/tiled/asteroid_steel,
/area/submap/mausarmy)
"vI" = (
/obj/effect/floor_decal/corner_techfloor_gray/diagonal,
/obj/random/crate,
/obj/random/maintenance/clean,
/obj/random/maintenance/medical,
/obj/random/maintenance/security,
/obj/random/contraband,
/turf/simulated/floor/tiled/asteroid_steel,
/area/submap/mausarmy)
"we" = (
/obj/effect/floor_decal/corner/black/diagonal,
/mob/living/simple_mob/mechanical/mecha/mouse_tank/livewire,
/turf/simulated/floor/tiled/asteroid_steel,
/area/submap/mausarmy)
"wi" = (
/obj/structure/table/gold,
/obj/item/reagent_containers/food/snacks/sliceable/cheesewheel,
/turf/simulated/shuttle/floor/yellow,
/area/submap/mausarmy)
"wP" = (
/obj/effect/floor_decal/corner_techfloor_gray/diagonal,
/mob/living/simple_mob/mechanical/mecha/mouse_tank/eraticator,
/turf/simulated/floor/tiled/asteroid_steel,
/area/submap/mausarmy)
"xm" = (
/obj/effect/floor_decal/corner_techfloor_gray/diagonal,
/obj/effect/landmark/loot_spawn/low,
/turf/simulated/floor/tiled/asteroid_steel,
/area/submap/mausarmy)
"zy" = (
/obj/effect/floor_decal/industrial/warning{
	dir = 4
	},
/turf/simulated/floor/tiled/asteroid_steel,
/area/submap/mausarmy)
"zz" = (
/obj/effect/floor_decal/corner_techfloor_gray/diagonal,
/obj/structure/loot_pile/surface/bones,
/turf/simulated/floor/tiled/asteroid_steel,
/area/submap/mausarmy)
"zN" = (
/obj/effect/floor_decal/corner/blue/diagonal,
/obj/structure/table/fancyblack,
/obj/random/cash,
/obj/random/cash,
/obj/random/cash,
/obj/item/stolenpackage,
/obj/item/card/emag/used,
/turf/simulated/floor/tiled/asteroid_steel,
/area/submap/mausarmy)
"zV" = (
/obj/structure/cable{
	d2 = 8;
	icon_state = "0-8"
	},
/obj/machinery/power/port_gen/pacman,
/turf/simulated/floor/outdoors/dirt/sif,
/area/submap/mausarmy)
"Ad" = (
/obj/machinery/atmospherics/unary/engine{
	dir = 1
	},
/turf/simulated/floor/tiled/asteroid_steel,
/area/submap/mausarmy)
"AG" = (
/obj/effect/floor_decal/corner/black/diagonal,
/obj/machinery/light/poi{
	dir = 1
	},
/turf/simulated/floor/tiled/asteroid_steel,
/area/submap/mausarmy)
"AV" = (
/obj/effect/floor_decal/corner/blue/diagonal,
/turf/simulated/floor/tiled/asteroid_steel,
/area/submap/mausarmy)
"AX" = (
/obj/structure/fence{
	dir = 8
	},
/turf/simulated/floor/outdoors/dirt/sif,
/area/submap/mausarmy)
"Bu" = (
/mob/living/simple_mob/mechanical/mecha/mouse_tank/eraticator,
/turf/simulated/floor/tiled/asteroid_steel,
/area/submap/mausarmy)
"BV" = (
/obj/effect/floor_decal/corner_techfloor_gray/diagonal,
/obj/machinery/light/poi,
/turf/simulated/floor/tiled/asteroid_steel,
/area/submap/mausarmy)
"CB" = (
/turf/simulated/floor/outdoors/dirt/sif,
/area/submap/mausarmy)
"Do" = (
/obj/effect/floor_decal/corner_techfloor_gray/diagonal,
/obj/effect/landmark/loot_spawn,
/obj/machinery/light/poi{
	dir = 4
	},
/turf/simulated/floor/tiled/asteroid_steel,
/area/submap/mausarmy)
"DU" = (
/obj/effect/floor_decal/corner_techfloor_gray/diagonal,
/obj/random/crate,
/obj/random/maintenance/clean,
/obj/random/maintenance/engineering,
/obj/random/maintenance/research,
/obj/random/contraband,
/obj/random/rigsuit/chancetofail,
/turf/simulated/floor/tiled/asteroid_steel,
/area/submap/mausarmy)
"Er" = (
/obj/machinery/door/airlock/maintenance,
/turf/simulated/floor/tiled/asteroid_steel,
/area/submap/mausarmy)
"Ev" = (
/obj/effect/floor_decal/corner_techfloor_gray/diagonal,
/turf/simulated/floor/tiled/asteroid_steel,
/area/submap/mausarmy)
"Fn" = (
/obj/machinery/door/blast/shutters,
/obj/effect/floor_decal/industrial/warning{
	dir = 8
	},
/turf/simulated/floor/tiled/asteroid_steel,
/area/submap/mausarmy)
"FJ" = (
/obj/effect/floor_decal/corner/blue/diagonal,
/obj/structure/table/fancyblack,
/obj/random/cash,
/obj/random/cash,
/obj/random/cash,
/turf/simulated/floor/tiled/asteroid_steel,
/area/submap/mausarmy)
"FO" = (
/turf/simulated/wall/gold,
/area/submap/mausarmy)
"Hj" = (
/obj/effect/floor_decal/corner/black/diagonal,
/turf/simulated/floor/tiled/asteroid_steel,
/area/submap/mausarmy)
"Hr" = (
/obj/effect/floor_decal/corner_techfloor_gray/diagonal,
/obj/random/crate,
/obj/item/stolenpackage,
/obj/random/maintenance/clean,
/obj/random/maintenance/medical,
/turf/simulated/floor/tiled/asteroid_steel,
/area/submap/mausarmy)
"JM" = (
/obj/machinery/door/airlock/maintenance,
/obj/machinery/door/blast/regular,
/turf/simulated/floor/tiled/asteroid_steel,
/area/submap/mausarmy)
"Lh" = (
/obj/machinery/door/blast/shutters,
/obj/effect/floor_decal/industrial/warning{
	dir = 6
	},
/turf/simulated/floor/tiled/asteroid_steel,
/area/submap/mausarmy)
"LI" = (
/obj/structure/fence,
/turf/simulated/floor/outdoors/dirt/sif,
/area/submap/mausarmy)
"MF" = (
/mob/living/simple_mob/mechanical/mecha/mouse_tank,
/turf/simulated/floor/tiled/asteroid_steel,
/area/submap/mausarmy)
"NM" = (
/obj/structure/cable{
	d1 = 4;
	d2 = 8;
	icon_state = "4-8"
	},
/turf/simulated/floor/outdoors/dirt/sif,
/area/submap/mausarmy)
"Oq" = (
/obj/machinery/door/airlock/gold,
/turf/simulated/shuttle/floor/yellow,
/area/submap/mausarmy)
"OJ" = (
/obj/effect/floor_decal/corner_techfloor_gray/diagonal,
/obj/random/crate,
/obj/item/stolenpackage,
/obj/random/maintenance/clean,
/obj/random/maintenance/engineering,
/obj/random/maintenance/research,
/turf/simulated/floor/tiled/asteroid_steel,
/area/submap/mausarmy)
"OO" = (
/obj/structure/shuttle/engine/heater,
/turf/simulated/wall/gold,
/area/submap/mausarmy)
"Pz" = (
/obj/effect/floor_decal/corner/blue/diagonal,
/obj/structure/table/fancyblack,
/obj/random/cash,
/obj/random/cash,
/obj/random/cash,
/obj/random/rigsuit,
/turf/simulated/floor/tiled/asteroid_steel,
/area/submap/mausarmy)
"Qd" = (
/obj/effect/floor_decal/corner_techfloor_gray/diagonal,
/obj/random/crate,
/obj/item/stolenpackage,
/obj/random/maintenance/clean,
/obj/random/maintenance/security,
/turf/simulated/floor/tiled/asteroid_steel,
/area/submap/mausarmy)
"Qj" = (
/obj/effect/floor_decal/corner_techfloor_gray/diagonal,
/obj/random/crate,
/obj/item/stolenpackage,
/obj/random/maintenance/clean,
/obj/random/maintenance/medical,
/obj/effect/decal/cleanable/blood,
/turf/simulated/floor/tiled/asteroid_steel,
/area/submap/mausarmy)
"Rp" = (
/obj/effect/floor_decal/corner_techfloor_gray/diagonal,
/obj/effect/landmark/loot_spawn,
/turf/simulated/floor/tiled/asteroid_steel,
/area/submap/mausarmy)
"Rx" = (
/turf/simulated/wall/r_wall,
/area/submap/mausarmy)
"RE" = (
/obj/effect/floor_decal/corner_techfloor_gray/diagonal,
/obj/random/crate,
/obj/random/maintenance/clean,
/obj/random/maintenance/engineering,
/obj/random/maintenance/security,
/obj/random/contraband,
/turf/simulated/floor/tiled/asteroid_steel,
/area/submap/mausarmy)
"RQ" = (
/obj/effect/floor_decal/industrial/warning{
	dir = 4
	},
/obj/effect/decal/cleanable/blood,
/turf/simulated/floor/tiled/asteroid_steel,
/area/submap/mausarmy)
"TL" = (
/obj/machinery/door/blast/shutters,
/obj/effect/floor_decal/industrial/warning{
	dir = 5
	},
/turf/simulated/floor/tiled/asteroid_steel,
/area/submap/mausarmy)
"VC" = (
/obj/effect/floor_decal/corner_techfloor_gray/diagonal,
/obj/random/crate,
/obj/item/stolenpackage,
/obj/random/maintenance/clean,
/obj/random/maintenance/research,
/obj/random/contraband,
/turf/simulated/floor/tiled/asteroid_steel,
/area/submap/mausarmy)
"VE" = (
/turf/simulated/floor/tiled/asteroid_steel,
/area/submap/mausarmy)
"WV" = (
/obj/machinery/door/blast/shutters,
/obj/effect/floor_decal/industrial/warning{
	dir = 4
	},
/turf/simulated/floor/tiled/asteroid_steel,
/area/submap/mausarmy)
"XT" = (
/obj/effect/floor_decal/corner_techfloor_gray/diagonal,
/obj/effect/decal/cleanable/blood,
/obj/structure/loot_pile/surface/bones,
/turf/simulated/floor/tiled/asteroid_steel,
/area/submap/mausarmy)
"XW" = (
/obj/effect/floor_decal/industrial/warning{
	dir = 8
	},
/turf/simulated/floor/tiled/asteroid_steel,
/area/submap/mausarmy)
"Yh" = (
/obj/effect/floor_decal/corner/blue/diagonal,
/mob/living/simple_mob/humanoid/merc/ranged{
	faction = "mouse_army"
	},
/turf/simulated/floor/tiled/asteroid_steel,
/area/submap/mausarmy)
"YT" = (
/obj/effect/floor_decal/corner/blue/diagonal,
/mob/living/simple_mob/humanoid/merc/ranged/deagle,
/turf/simulated/floor/tiled/asteroid_steel,
/area/submap/mausarmy)
"Ze" = (
/obj/effect/decal/cleanable/blood,
/turf/simulated/floor/tiled/asteroid_steel,
/area/submap/mausarmy)
"Zm" = (
/obj/structure/fence/cut/large{
	dir = 8;
	icon_state = "straight_cut3"
	},
/turf/simulated/floor/outdoors/dirt/sif,
/area/submap/mausarmy)
"ZK" = (
/obj/structure/fence/corner{
	dir = 4
	},
/turf/simulated/floor/outdoors/dirt/sif,
/area/submap/mausarmy)
"ZV" = (
/obj/effect/floor_decal/industrial/warning{
	dir = 8
	},
/obj/machinery/light/poi{
	dir = 8
	},
/turf/simulated/floor/tiled/asteroid_steel,
/area/submap/mausarmy)

(1,1,1) = {"
ao
ao
ao
ao
ao
ao
ao
ao
ao
ao
ao
ao
ao
ao
ao
ao
ao
ao
ao
ao
ao
ao
ao
ao
ao
"}
(2,1,1) = {"
ao
ao
ao
ao
ao
ao
ao
ao
ao
ao
ao
ao
ao
ao
ao
ao
ao
ao
ao
ao
ao
ao
ao
ao
ao
"}
(3,1,1) = {"
ao
ao
Rx
Rx
Rx
Rx
Rx
Rx
Rx
Rx
Rx
Rx
Rx
Rx
Rx
Rx
Rx
Rx
Rx
Rx
Rx
Rx
ao
ao
ao
"}
(4,1,1) = {"
ao
ao
vn
XW
XW
XW
Fn
XW
pB
ZV
XW
XW
XW
ZV
XW
XW
pB
Fn
XW
XW
XW
cU
ao
ao
ao
"}
(5,1,1) = {"
ao
ao
ay
VE
VE
VE
dW
VE
VE
FO
Oq
FO
Oq
OO
Ad
VE
VE
dW
VE
VE
VE
tq
ao
ao
ao
"}
(6,1,1) = {"
ao
ao
ay
VE
VE
VE
dW
VE
Bu
FO
mQ
wi
mQ
FO
VE
MF
VE
dW
VE
VE
VE
tq
ao
ao
ao
"}
(7,1,1) = {"
ao
ao
ay
VE
VE
VE
dW
VE
VE
FO
Oq
FO
Oq
OO
Ad
VE
Ze
dW
VE
VE
VE
tq
ao
ao
ao
"}
(8,1,1) = {"
ao
ao
TL
zy
zy
zy
WV
zy
RQ
zy
zy
zy
zy
zy
zy
zy
zy
WV
zy
zy
zy
Lh
ao
ao
ao
"}
(9,1,1) = {"
ao
ao
Rx
Rx
Rx
Rx
Rx
zz
Ev
Ev
Ev
Ev
vj
Ev
Ev
Rp
Rp
Rx
Rx
Rx
Rx
Rx
ao
ao
ao
"}
(10,1,1) = {"
ao
ao
CB
CB
AX
sg
Rx
VC
Ev
Ev
vj
OJ
vj
Ev
XT
Ev
vj
Rx
ht
CB
ht
CB
ao
ao
ao
"}
(11,1,1) = {"
ao
ao
CB
CB
Zm
NM
Rx
vp
Rp
Ev
Ev
vI
Ev
xm
Ev
Ev
BV
Rx
CB
CB
CB
CB
ao
ao
ao
"}
(12,1,1) = {"
ao
ao
ao
CB
AX
zV
Rx
Rp
Ev
Ev
Ev
vj
Ev
xm
Ev
Qj
RE
Rx
ht
CB
CB
CB
ao
ao
ao
"}
(13,1,1) = {"
ao
ao
ao
CB
AX
CB
Rx
ed
Ev
gf
Ev
Ev
vj
Ev
wP
Ev
kT
Rx
CB
CB
CB
ao
ao
ao
ao
"}
(14,1,1) = {"
ao
ao
ao
CB
ZK
LI
Rx
mJ
ra
Ev
Ev
Ev
DU
Hr
Ev
ra
Rp
Rx
ht
CB
CB
ao
ao
ao
ao
"}
(15,1,1) = {"
ao
ao
ao
ao
CB
CB
Rx
Qd
Ev
Rp
Do
Ev
vj
dd
Ev
Rp
hR
Rx
CB
CB
CB
ao
ao
ao
ao
"}
(16,1,1) = {"
ao
ao
ao
ao
CB
CB
Rx
Rx
JM
Rx
Rx
Rx
Rx
Rx
Er
Rx
Rx
Rx
CB
CB
ao
ao
ao
ao
ao
"}
(17,1,1) = {"
ao
ao
ao
ao
ao
CB
Rx
AV
AV
AV
AV
Rx
Hj
iL
Hj
iL
Hj
Rx
CB
CB
ao
ao
ao
ao
ao
"}
(18,1,1) = {"
ao
ao
ao
ao
ao
CB
Rx
rx
zN
AV
Yh
Rx
AG
Hj
Hj
Hj
Hj
Rx
CB
CB
ao
ao
ao
ao
ao
"}
(19,1,1) = {"
ao
ao
ao
ao
ao
CB
Rx
YT
FJ
lI
AV
JM
Hj
Hj
Hj
Hj
Hj
Rx
CB
ao
ao
ao
ao
ao
ao
"}
(20,1,1) = {"
ao
ao
ao
ao
ao
CB
Rx
rx
Pz
AV
AV
Rx
AG
we
Hj
Hj
Hj
Er
CB
ao
ao
ao
ao
ao
ao
"}
(21,1,1) = {"
ao
ao
ao
ao
ao
CB
Rx
oS
AV
AV
AV
Rx
Hj
Hj
Hj
Hj
Hj
Rx
CB
ao
ao
ao
ao
ao
ao
"}
(22,1,1) = {"
ao
ao
ao
ao
ao
CB
Rx
Rx
Rx
Rx
Rx
Rx
Rx
Rx
Rx
Rx
Rx
Rx
CB
ao
ao
ao
ao
ao
ao
"}
(23,1,1) = {"
ao
ao
ao
ao
ao
ao
ao
et
ao
ao
et
ao
ao
et
ao
ao
et
ao
ao
ao
ao
ao
ao
ao
ao
"}
(24,1,1) = {"
ao
ao
ao
ao
ao
ao
ao
ao
ao
ao
ao
ao
ao
ao
ao
ao
ao
ao
ao
ao
ao
ao
ao
ao
ao
"}
(25,1,1) = {"
ao
ao
ao
ao
ao
ao
ao
ao
ao
ao
ao
ao
ao
ao
ao
ao
ao
ao
ao
ao
ao
ao
ao
ao
ao
"}
