//MAP CONVERTED BY dmm2tgm.py THIS HEADER COMMENT PREVENTS RECONVERSION, DO NOT REMOVE
"a" = (
/turf/template_noop,
/area/template_noop)
"b" = (
/obj/machinery/atmospherics/unary/engine{
	dir = 1
	},
/turf/simulated/floor/tiled/dark,
/area/submap/mouseattack)
"c" = (
/turf/simulated/floor/tiled/yellow,
/area/submap/mouseattack)
"d" = (
/obj/machinery/door/blast/shutters,
/obj/effect/floor_decal/corner/grey/diagonal,
/turf/simulated/floor/tiled/dark,
/area/submap/mouseattack)
"i" = (
/obj/structure/table/rack,
/obj/item/archaeological_find,
/obj/item/archaeological_find,
/obj/item/archaeological_find,
/obj/random/rigsuit/chancetofail,
/obj/item/rig_module/mounted/phase,
/obj/random/maintenance/research,
/obj/random/maintenance/research,
/obj/random/maintenance/security,
/obj/random/maintenance/security,
/turf/simulated/floor/tiled/yellow,
/area/submap/mouseattack)
"j" = (
/turf/simulated/wall/gold,
/area/submap/mouseattack)
"l" = (
/mob/living/simple_mob/mechanical/mecha/mouse_tank/livewire/manned,
/obj/effect/floor_decal/corner/grey/diagonal,
/turf/simulated/floor/tiled/dark,
/area/submap/mouseattack)
"o" = (
/obj/structure/table/rack,
/obj/item/archaeological_find,
/obj/item/archaeological_find,
/obj/item/archaeological_find,
/obj/random/rigsuit/chancetofail,
/obj/item/rig_module/voice,
/obj/random/maintenance/research,
/obj/random/maintenance/research,
/obj/random/maintenance/security,
/obj/random/maintenance/security,
/turf/simulated/floor/tiled/yellow,
/area/submap/mouseattack)
"q" = (
/mob/living/simple_mob/mechanical/mecha/mouse_tank/eraticator/manned,
/obj/effect/floor_decal/corner/grey/diagonal,
/turf/simulated/floor/tiled/dark,
/area/submap/mouseattack)
"s" = (
/obj/effect/floor_decal/corner/grey/diagonal,
/turf/simulated/floor/tiled/dark,
/area/submap/mouseattack)
"t" = (
/obj/structure/shuttle/engine/heater,
/turf/simulated/wall/gold,
/area/submap/mouseattack)
"u" = (
/mob/living/simple_mob/animal/space/mouse_army/ammo,
/turf/simulated/floor/tiled/yellow,
/area/submap/mouseattack)
"v" = (
/obj/structure/table/rack,
/obj/item/archaeological_find,
/obj/item/archaeological_find,
/obj/item/archaeological_find,
/obj/item/rig_module/chem_dispenser/injector/advanced,
/obj/random/maintenance/research,
/obj/random/maintenance/research,
/obj/random/maintenance/security,
/obj/random/maintenance/security,
/turf/simulated/floor/tiled/yellow,
/area/submap/mouseattack)
"w" = (
/obj/structure/table/rack,
/obj/item/rig_module/device/defib,
/obj/item/archaeological_find,
/obj/item/archaeological_find,
/obj/item/archaeological_find,
/obj/random/maintenance/research,
/obj/random/maintenance/research,
/obj/random/maintenance/security,
/obj/random/maintenance/security,
/turf/simulated/floor/tiled/yellow,
/area/submap/mouseattack)
"y" = (
/turf/template_noop,
/area/submap/mouseattack)
"z" = (
/obj/machinery/door/blast/shutters,
/turf/simulated/floor/tiled/dark,
/area/submap/mouseattack)
"B" = (
/mob/living/simple_mob/animal/space/mouse_army/operative,
/turf/simulated/floor/tiled/yellow,
/area/submap/mouseattack)
"C" = (
/obj/structure/table/rack,
/obj/item/archaeological_find,
/obj/item/archaeological_find,
/obj/item/archaeological_find,
/obj/random/rigsuit/chancetofail,
/obj/item/rig_module/rad_shield,
/obj/random/maintenance/research,
/obj/random/maintenance/research,
/obj/random/maintenance/security,
/obj/random/maintenance/security,
/turf/simulated/floor/tiled/yellow,
/area/submap/mouseattack)
"J" = (
/mob/living/simple_mob/animal/space/mouse_army/pyro,
/turf/simulated/floor/tiled/yellow,
/area/submap/mouseattack)
"N" = (
/obj/structure/table/rack,
/obj/random/rigsuit/chancetofail,
/obj/item/rig_module/fabricator,
/obj/item/archaeological_find,
/obj/item/archaeological_find,
/obj/item/archaeological_find,
/obj/random/maintenance/research,
/obj/random/maintenance/research,
/obj/random/maintenance/security,
/obj/random/maintenance/security,
/turf/simulated/floor/tiled/yellow,
/area/submap/mouseattack)
"S" = (
/obj/machinery/door/airlock/gold,
/turf/simulated/floor/tiled/yellow,
/area/submap/mouseattack)
"X" = (
/turf/simulated/wall/r_wall,
/area/submap/mouseattack)
"Y" = (
/mob/living/simple_mob/mechanical/mecha/mouse_tank/manned,
/obj/effect/floor_decal/corner/grey/diagonal,
/turf/simulated/floor/tiled/dark,
/area/submap/mouseattack)

(1,1,1) = {"
a
a
a
a
a
a
a
a
a
a
a
a
a
a
a
a
a
a
a
a
"}
(2,1,1) = {"
a
a
X
X
X
X
X
X
X
X
X
X
X
X
X
X
X
X
X
a
"}
(3,1,1) = {"
a
a
d
s
s
s
s
s
s
s
s
s
s
s
s
s
s
s
X
a
"}
(4,1,1) = {"
a
a
d
s
Y
s
s
j
j
S
j
j
S
j
t
b
s
s
X
a
"}
(5,1,1) = {"
a
a
d
s
s
s
s
j
c
c
B
B
c
c
t
b
s
s
X
a
"}
(6,1,1) = {"
a
a
d
s
s
s
s
j
c
c
N
w
c
c
t
b
s
s
X
a
"}
(7,1,1) = {"
a
a
d
s
s
s
s
j
c
c
B
B
c
c
t
b
s
s
X
a
"}
(8,1,1) = {"
a
a
d
s
Y
s
s
j
j
S
j
j
S
j
t
b
s
s
X
a
"}
(9,1,1) = {"
a
a
d
s
s
s
s
s
s
s
s
s
s
s
s
s
s
s
X
a
"}
(10,1,1) = {"
a
a
X
X
X
X
X
X
X
X
X
X
X
X
X
X
X
X
X
a
"}
(11,1,1) = {"
a
a
y
y
y
y
y
y
y
y
y
y
y
y
y
y
y
y
y
a
"}
(12,1,1) = {"
a
a
X
X
X
X
X
X
X
X
X
X
X
X
X
X
X
X
X
a
"}
(13,1,1) = {"
a
a
z
s
s
s
s
s
s
s
s
s
s
s
s
s
s
s
X
a
"}
(14,1,1) = {"
a
a
z
s
l
s
s
j
j
S
j
j
S
j
t
b
s
s
X
a
"}
(15,1,1) = {"
a
a
z
s
s
s
s
j
c
c
J
J
c
c
t
b
s
s
X
a
"}
(16,1,1) = {"
a
a
z
s
s
s
s
j
c
c
v
o
c
c
t
b
s
s
X
a
"}
(17,1,1) = {"
a
a
z
s
s
s
s
j
c
c
J
J
c
c
t
b
s
s
X
a
"}
(18,1,1) = {"
a
a
z
s
l
s
s
j
j
S
j
j
S
j
t
b
s
s
X
a
"}
(19,1,1) = {"
a
a
z
s
s
s
s
s
s
s
s
s
s
s
s
s
s
s
X
a
"}
(20,1,1) = {"
a
a
X
X
X
X
X
X
X
X
X
X
X
X
X
X
X
X
X
a
"}
(21,1,1) = {"
a
a
y
y
y
y
y
y
y
y
y
y
y
y
y
y
y
y
y
a
"}
(22,1,1) = {"
a
a
X
X
X
X
X
X
X
X
X
X
X
X
X
X
X
X
X
a
"}
(23,1,1) = {"
a
a
z
s
s
s
s
s
s
s
s
s
s
s
s
s
s
s
X
a
"}
(24,1,1) = {"
a
a
z
s
q
s
s
j
j
S
j
j
S
j
t
b
s
s
X
a
"}
(25,1,1) = {"
a
a
z
s
s
s
s
j
c
c
u
u
c
c
t
b
s
s
X
a
"}
(26,1,1) = {"
a
a
z
s
s
s
s
j
c
c
i
C
c
c
t
b
s
s
X
a
"}
(27,1,1) = {"
a
a
z
s
s
s
s
j
c
c
u
u
c
c
t
b
s
s
X
a
"}
(28,1,1) = {"
a
a
z
s
q
s
s
j
j
S
j
j
S
j
t
b
s
s
X
a
"}
(29,1,1) = {"
a
a
z
s
s
s
s
s
s
s
s
s
s
s
s
s
s
s
X
a
"}
(30,1,1) = {"
a
a
X
X
X
X
X
X
X
X
X
X
X
X
X
X
X
X
X
a
"}
(31,1,1) = {"
a
a
a
a
a
a
a
a
a
a
a
a
a
a
a
a
a
a
a
a
"}
