//MAP CONVERTED BY dmm2tgm.py THIS HEADER COMMENT PREVENTS RECONVERSION, DO NOT REMOVE
"a" = (
/obj/structure/table/alien/blue,
/obj/random/material/refined,
/turf/simulated/floor/bmarble,
/area/submap/mousehq)
"b" = (
/mob/living/simple_mob/mechanical/mecha/mouse_tank/manned,
/turf/simulated/floor/bmarble,
/area/submap/mousehq)
"c" = (
/turf/simulated/wall/uranium,
/area/submap/mousehq)
"d" = (
/obj/structure/table/alien/blue,
/obj/random/material/refined,
/obj/item/stack/material/phoron,
/turf/simulated/floor/bmarble,
/area/submap/mousehq)
"e" = (
/obj/structure/loot_pile/surface/alien/engineering,
/turf/simulated/floor/wmarble,
/area/submap/mousehq)
"f" = (
/mob/living/simple_mob/animal/space/mouse_army/ammo,
/turf/simulated/floor/bmarble,
/area/submap/mousehq)
"g" = (
/obj/structure/table/alien/blue,
/obj/item/prop/alien/junk,
/turf/simulated/floor/bmarble,
/area/submap/mousehq)
"h" = (
/obj/structure/table/alien/blue,
/obj/item/clothing/under/punpun,
/turf/simulated/floor/bmarble,
/area/submap/mousehq)
"i" = (
/obj/structure/table/alien/blue,
/turf/simulated/floor/wmarble,
/area/submap/mousehq)
"j" = (
/obj/structure/loot_pile/surface/alien/medical,
/turf/simulated/floor/wmarble,
/area/submap/mousehq)
"k" = (
/obj/structure/table/alien/blue,
/obj/item/clothing/under/psysuit,
/turf/simulated/floor/bmarble,
/area/submap/mousehq)
"l" = (
/obj/machinery/door/airlock/sandstone,
/obj/machinery/door/blast/puzzle{
	checkrange_mult = 3;
	dir = 4;
	layer = 3.3;
	name = "Blast Door";
	open_layer = 3.3
	},
/turf/simulated/floor/bmarble,
/area/submap/mousehq)
"m" = (
/mob/living/simple_mob/animal/space/mouse_army/pyro,
/turf/simulated/floor/bmarble,
/area/submap/mousehq)
"n" = (
/obj/structure/loot_pile/surface/alien/engineering,
/turf/simulated/floor/bmarble,
/area/submap/mousehq)
"o" = (
/obj/machinery/door/airlock/sandstone,
/turf/simulated/floor/wmarble,
/area/submap/mousehq)
"p" = (
/turf/simulated/floor/wmarble,
/area/submap/mousehq)
"q" = (
/mob/living/simple_mob/animal/space/mouse_army/ammo,
/turf/simulated/floor/wmarble,
/area/submap/mousehq)
"r" = (
/obj/structure/prop/lock/projectile{
	pixel_y = 6
	},
/obj/effect/floor_decal/industrial/warning/full,
/turf/simulated/floor/wmarble,
/area/submap/mousehq)
"s" = (
/obj/item/reagent_containers/food/snacks/sliceable/cheesewheel,
/obj/item/cell/device/weapon/recharge/alien/omni,
/obj/structure/table/alien/blue,
/turf/simulated/floor/wmarble,
/area/submap/mousehq)
"t" = (
/obj/machinery/power/emitter{
	anchored = 1;
	dir = 1;
	state = 1
	},
/obj/structure/cable/green{
	d2 = 8;
	icon_state = "0-8"
	},
/turf/simulated/floor/plating,
/area/submap/mousehq)
"u" = (
/obj/structure/table/alien/blue,
/obj/random/material/refined,
/turf/simulated/floor/wmarble,
/area/submap/mousehq)
"v" = (
/turf/simulated/shuttle/wall/alien,
/area/submap/mousehq)
"w" = (
/mob/living/simple_mob/animal/space/mouse_army/operative,
/turf/simulated/floor/bmarble,
/area/submap/mousehq)
"x" = (
/obj/structure/closet/alien,
/obj/item/prop/alien/junk,
/turf/simulated/floor/wmarble,
/area/submap/mousehq)
"y" = (
/turf/simulated/floor/bmarble,
/area/submap/mousehq)
"z" = (
/obj/structure/loot_pile/surface/alien/security,
/turf/simulated/floor/wmarble,
/area/submap/mousehq)
"A" = (
/obj/item/reagent_containers/food/snacks/sliceable/cheesewheel,
/obj/structure/table/alien/blue,
/obj/item/multitool/alien,
/turf/simulated/floor/wmarble,
/area/submap/mousehq)
"B" = (
/turf/simulated/floor/plating,
/area/submap/mousehq)
"D" = (
/mob/living/simple_mob/mechanical/mecha/mouse_tank/livewire/manned,
/turf/simulated/floor/wmarble,
/area/submap/mousehq)
"E" = (
/mob/living/simple_mob/mechanical/mecha/mouse_tank/livewire/manned,
/turf/simulated/floor/bmarble,
/area/submap/mousehq)
"F" = (
/obj/item/reagent_containers/food/snacks/sliceable/cheesewheel,
/obj/structure/table/alien/blue,
/obj/item/clothing/suit/armor/alien,
/turf/simulated/floor/wmarble,
/area/submap/mousehq)
"G" = (
/obj/structure/table/alien/blue,
/obj/item/prop/alien/junk,
/turf/simulated/floor/wmarble,
/area/submap/mousehq)
"H" = (
/mob/living/simple_mob/animal/space/mouse_army/operative,
/turf/simulated/floor/wmarble,
/area/submap/mousehq)
"J" = (
/mob/living/simple_mob/mechanical/mecha/mouse_tank/eraticator/manned,
/obj/random/material/refined,
/turf/simulated/floor/bmarble,
/area/submap/mousehq)
"K" = (
/turf/simulated/mineral/floor/ignore_mapgen/sif,
/area/submap/mousehq)
"M" = (
/mob/living/simple_mob/mechanical/mecha/mouse_tank/eraticator/manned,
/turf/simulated/floor/bmarble,
/area/submap/mousehq)
"N" = (
/mob/living/simple_mob/mechanical/mecha/mouse_tank/eraticator/manned,
/turf/simulated/floor/wmarble,
/area/submap/mousehq)
"O" = (
/turf/simulated/wall/sandstone,
/area/submap/mousehq)
"P" = (
/obj/machinery/power/port_gen/pacman,
/turf/simulated/mineral/floor/ignore_mapgen/sif,
/area/submap/mousehq)
"Q" = (
/obj/structure/cable/green{
	d2 = 4;
	icon_state = "0-4"
	},
/turf/simulated/floor/plating,
/area/submap/mousehq)
"R" = (
/obj/structure/table/alien/blue,
/obj/item/clothing/under/psysuit,
/turf/simulated/floor/wmarble,
/area/submap/mousehq)
"S" = (
/obj/structure/table/alien/blue,
/obj/random/material/refined,
/obj/item/stack/material/phoron,
/turf/simulated/floor/wmarble,
/area/submap/mousehq)
"T" = (
/obj/machinery/door/airlock/sandstone,
/turf/simulated/floor/bmarble,
/area/submap/mousehq)
"U" = (
/obj/structure/loot_pile/surface/alien/security,
/turf/simulated/floor/bmarble,
/area/submap/mousehq)
"V" = (
/turf/template_noop,
/area/template_noop)
"W" = (
/obj/structure/table/alien/blue,
/obj/item/cell/device/weapon/recharge/alien/hybrid,
/turf/simulated/floor/wmarble,
/area/submap/mousehq)
"X" = (
/mob/living/simple_mob/mechanical/mecha/mouse_tank/manned,
/turf/simulated/floor/wmarble,
/area/submap/mousehq)
"Y" = (
/obj/structure/table/alien/blue,
/obj/item/prop/alien/junk,
/obj/item/stack/material/phoron,
/turf/simulated/floor/wmarble,
/area/submap/mousehq)
"Z" = (
/obj/structure/closet/alien,
/obj/item/prop/alien/junk,
/turf/simulated/floor/bmarble,
/area/submap/mousehq)

(1,1,1) = {"
V
V
V
V
V
V
V
V
V
V
V
V
V
V
V
V
V
V
V
V
V
V
V
V
V
V
V
V
V
V
V
"}
(2,1,1) = {"
V
V
V
V
V
V
V
V
V
V
V
V
O
O
O
O
O
O
O
V
V
V
V
V
V
V
V
V
V
V
V
"}
(3,1,1) = {"
V
V
V
V
V
V
V
V
V
V
V
O
O
Y
g
W
g
G
O
O
V
V
V
V
V
V
V
V
V
V
V
"}
(4,1,1) = {"
V
V
V
V
V
V
V
V
V
V
O
O
j
f
p
y
p
f
z
O
O
V
V
V
V
V
V
V
V
V
V
"}
(5,1,1) = {"
V
V
V
V
V
V
V
V
V
O
O
z
y
p
y
H
y
p
y
j
O
O
V
V
V
V
V
V
V
V
V
"}
(6,1,1) = {"
V
V
V
V
V
V
V
V
O
O
x
y
X
y
p
y
p
y
X
y
x
O
O
V
V
V
V
V
V
V
V
"}
(7,1,1) = {"
V
V
V
V
V
V
V
O
O
O
Z
N
y
H
y
D
y
H
y
N
Z
O
O
O
V
V
V
V
V
V
V
"}
(8,1,1) = {"
V
V
V
V
V
V
O
O
D
O
x
y
p
y
p
y
p
y
p
y
x
O
p
O
O
V
V
V
V
V
V
"}
(9,1,1) = {"
V
V
V
V
V
O
O
p
y
O
O
O
O
O
T
o
O
O
O
O
O
O
O
O
O
O
V
V
V
V
V
"}
(10,1,1) = {"
V
V
V
V
O
O
p
y
p
T
p
y
p
y
p
y
p
y
p
y
D
O
S
y
p
O
O
V
V
V
V
"}
(11,1,1) = {"
V
V
V
O
O
p
y
p
y
O
y
p
y
p
y
p
y
p
y
p
y
O
Z
p
b
p
O
O
V
V
V
"}
(12,1,1) = {"
V
V
O
O
p
y
p
y
i
O
p
M
p
y
p
E
p
y
p
M
p
O
x
b
p
y
p
O
O
V
V
"}
(13,1,1) = {"
V
O
O
p
y
N
y
q
h
O
f
p
y
p
y
q
y
p
y
p
y
O
a
p
y
p
y
H
O
O
V
"}
(14,1,1) = {"
V
O
e
y
p
y
p
y
i
O
O
O
O
v
v
v
v
v
O
O
o
O
O
O
O
T
O
O
O
O
V
"}
(15,1,1) = {"
V
O
k
p
m
p
m
p
y
O
y
p
f
v
y
F
c
v
b
p
y
p
y
q
y
p
y
p
a
O
V
"}
(16,1,1) = {"
V
O
R
y
p
y
p
y
p
T
p
y
p
l
p
m
s
v
D
y
p
y
H
y
p
y
D
f
W
O
V
"}
(17,1,1) = {"
V
O
n
p
y
p
y
p
y
O
y
p
f
v
y
A
c
v
b
p
y
p
y
q
y
p
y
p
a
O
V
"}
(18,1,1) = {"
V
O
O
O
o
T
o
O
O
O
O
O
O
v
v
v
v
v
O
O
o
T
O
O
O
T
O
O
O
O
V
"}
(19,1,1) = {"
V
V
K
K
K
K
K
K
K
K
K
K
P
O
y
p
y
Q
O
p
y
p
O
u
y
p
M
H
O
O
V
"}
(20,1,1) = {"
V
V
V
K
K
K
K
K
K
K
K
K
K
O
r
y
N
t
O
y
p
y
O
Z
p
y
p
O
O
V
V
"}
(21,1,1) = {"
V
V
V
V
K
K
K
K
K
K
K
K
K
O
y
p
y
B
O
p
y
p
O
x
J
p
O
O
V
V
V
"}
(22,1,1) = {"
V
V
V
V
V
K
K
K
K
K
K
K
K
O
O
T
o
O
O
y
p
y
O
d
p
O
O
V
V
V
V
"}
(23,1,1) = {"
V
V
V
V
V
V
K
K
K
K
K
K
K
O
y
H
y
p
y
q
f
q
O
O
O
O
V
V
V
V
V
"}
(24,1,1) = {"
V
V
V
V
V
V
V
K
K
K
K
K
K
O
p
w
p
y
p
y
p
y
O
O
O
V
V
V
V
V
V
"}
(25,1,1) = {"
V
V
V
V
V
V
V
V
K
K
K
K
K
O
O
o
T
O
O
O
O
O
O
O
V
V
V
V
V
V
V
"}
(26,1,1) = {"
V
V
V
V
V
V
V
V
V
K
K
K
K
O
p
E
D
y
p
M
x
O
O
V
V
V
V
V
V
V
V
"}
(27,1,1) = {"
V
V
V
V
V
V
V
V
V
V
K
K
K
O
y
p
y
p
y
x
O
O
V
V
V
V
V
V
V
V
V
"}
(28,1,1) = {"
V
V
V
V
V
V
V
V
V
V
V
K
K
O
p
w
H
M
x
O
O
V
V
V
V
V
V
V
V
V
V
"}
(29,1,1) = {"
V
V
V
V
V
V
V
V
V
V
V
V
K
O
n
j
U
e
O
O
V
V
V
V
V
V
V
V
V
V
V
"}
(30,1,1) = {"
V
V
V
V
V
V
V
V
V
V
V
V
V
O
O
O
O
O
O
V
V
V
V
V
V
V
V
V
V
V
V
"}
(31,1,1) = {"
V
V
V
V
V
V
V
V
V
V
V
V
V
V
V
V
V
V
V
V
V
V
V
V
V
V
V
V
V
V
V
"}
