//MAP CONVERTED BY dmm2tgm.py THIS HEADER COMMENT PREVENTS RECONVERSION, DO NOT REMOVE
"a" = (
/obj/item/stack/material/phoron{
	amount = 10
	},
/turf/simulated/floor/outdoors/rocks/caves,
/area/submap/phorondragon)
"c" = (
/turf/simulated/floor/water,
/area/submap/phorondragon)
"d" = (
/obj/item/cell/hyper,
/turf/simulated/floor/outdoors/rocks/caves,
/area/submap/phorondragon)
"i" = (
/mob/living/simple_mob/vore/aggressive/dragon/virgo3b,
/turf/simulated/floor/outdoors/rocks/caves,
/area/submap/phorondragon)
"j" = (
/turf/simulated/floor/outdoors/rocks/caves,
/area/submap/phorondragon)
"k" = (
/turf/simulated/floor/water/deep,
/area/submap/phorondragon)
"n" = (
/obj/item/slime_extract/purple,
/turf/simulated/floor/outdoors/rocks/caves,
/area/submap/phorondragon)
"s" = (
/obj/structure/outcrop/phoron,
/turf/simulated/floor/outdoors/rocks/caves,
/area/submap/phorondragon)
"u" = (
/obj/item/toy/plushie/carp/nebula,
/turf/simulated/floor/outdoors/rocks/caves,
/area/submap/phorondragon)
"x" = (
/turf/template_noop,
/area/template_noop)
"A" = (
/obj/item/slime_extract/dark_purple,
/turf/simulated/floor/outdoors/rocks/caves,
/area/submap/phorondragon)
"E" = (
/obj/item/mecha_parts/mecha_equipment/weapon/phoron_bore,
/turf/simulated/floor/outdoors/rocks/caves,
/area/submap/phorondragon)
"H" = (
/turf/simulated/wall/phoron,
/area/submap/phorondragon)
"J" = (
/turf/simulated/mineral,
/area/submap/phorondragon)
"P" = (
/obj/item/gun/magnetic/matfed/phoronbore,
/turf/simulated/floor/outdoors/rocks/caves,
/area/submap/phorondragon)
"S" = (
/obj/effect/landmark/loot_spawn,
/turf/simulated/floor/outdoors/rocks/caves,
/area/submap/phorondragon)
"U" = (
/obj/structure/prop/statue/phoron,
/turf/simulated/floor/water/deep,
/area/submap/phorondragon)
"W" = (
/obj/effect/landmark/loot_spawn/low,
/turf/simulated/floor/outdoors/rocks/caves,
/area/submap/phorondragon)

(1,1,1) = {"
x
x
x
x
x
x
x
x
x
x
x
x
x
x
x
x
x
x
x
x
x
x
x
x
x
x
x
"}
(2,1,1) = {"
x
x
x
x
x
x
x
x
x
x
x
x
x
x
c
c
c
c
c
c
x
x
x
x
x
x
x
"}
(3,1,1) = {"
x
x
x
x
x
x
x
x
x
x
x
x
x
c
c
c
c
c
c
c
c
x
x
x
x
x
x
"}
(4,1,1) = {"
x
x
x
x
x
x
x
x
x
x
x
x
c
c
c
c
c
c
c
c
c
c
c
x
x
x
x
"}
(5,1,1) = {"
x
x
x
x
x
x
x
x
x
x
J
c
c
c
c
k
k
k
k
U
c
c
c
c
c
x
x
"}
(6,1,1) = {"
x
x
x
x
x
x
x
x
x
J
J
c
c
c
k
k
k
k
k
k
k
c
c
c
c
c
x
"}
(7,1,1) = {"
x
x
x
x
x
x
x
J
J
j
j
c
c
c
U
k
k
k
k
k
k
k
c
c
c
c
x
"}
(8,1,1) = {"
x
x
x
x
x
J
J
S
j
j
j
c
c
c
k
k
k
k
k
k
k
k
k
c
c
c
x
"}
(9,1,1) = {"
x
x
x
x
J
J
j
j
j
j
j
c
c
c
k
k
k
k
k
k
k
k
k
k
c
c
x
"}
(10,1,1) = {"
x
x
x
J
J
s
j
j
j
j
j
j
c
c
k
k
k
k
k
k
k
k
k
U
c
c
x
"}
(11,1,1) = {"
x
x
J
J
j
j
a
j
s
W
j
j
c
c
k
k
k
k
k
k
k
k
k
c
c
c
x
"}
(12,1,1) = {"
x
x
J
S
j
j
j
j
j
j
j
j
c
c
c
k
k
k
k
k
k
k
k
c
c
c
x
"}
(13,1,1) = {"
x
x
J
j
j
j
i
j
j
j
j
j
c
c
c
k
k
k
k
k
k
k
c
c
c
x
x
"}
(14,1,1) = {"
x
J
J
j
n
j
j
j
a
j
j
j
c
c
c
c
k
U
k
k
k
c
c
c
c
x
x
"}
(15,1,1) = {"
x
J
j
s
j
j
j
j
j
j
j
j
s
c
c
c
c
c
c
c
c
c
c
c
c
x
x
"}
(16,1,1) = {"
x
J
j
W
j
j
W
s
j
j
j
j
j
j
c
c
c
c
c
c
c
c
c
c
x
x
x
"}
(17,1,1) = {"
x
J
j
j
a
j
j
j
j
j
j
W
j
j
j
j
j
c
c
c
c
c
c
c
x
x
x
"}
(18,1,1) = {"
x
J
j
j
H
j
j
j
j
j
j
s
j
j
a
j
j
j
j
j
j
j
s
J
x
x
x
"}
(19,1,1) = {"
x
J
s
H
j
a
j
j
i
j
j
A
j
j
j
j
j
j
j
j
j
J
J
J
x
x
x
"}
(20,1,1) = {"
x
J
J
E
j
s
d
j
j
j
j
j
j
j
j
j
W
s
j
j
j
J
x
x
x
x
x
"}
(21,1,1) = {"
x
x
J
j
j
P
j
j
j
j
j
a
j
j
i
j
j
j
j
j
J
J
x
x
x
x
x
"}
(22,1,1) = {"
x
x
J
J
u
a
H
j
j
s
W
j
j
j
j
j
a
j
j
J
x
x
x
x
x
x
x
"}
(23,1,1) = {"
x
x
x
J
J
H
a
j
j
j
j
j
j
j
s
j
j
S
J
J
x
x
x
x
x
x
x
"}
(24,1,1) = {"
x
x
x
x
J
s
j
j
j
j
j
a
j
j
j
j
J
J
x
x
x
x
x
x
x
x
x
"}
(25,1,1) = {"
x
x
x
x
J
J
J
j
j
j
j
j
j
j
S
J
J
x
x
x
x
x
x
x
x
x
x
"}
(26,1,1) = {"
x
x
x
x
x
x
J
J
J
S
J
J
J
J
J
J
x
x
x
x
x
x
x
x
x
x
x
"}
(27,1,1) = {"
x
x
x
x
x
x
x
x
J
J
J
x
x
x
x
x
x
x
x
x
x
x
x
x
x
x
x
"}
