//MAP CONVERTED BY dmm2tgm.py THIS HEADER COMMENT PREVENTS RECONVERSION, DO NOT REMOVE
"aj" = (
/obj/machinery/door/airlock/diamond,
/turf/simulated/shuttle/floor/yellow,
/area/submap/piratevessel)
"bh" = (
/obj/effect/floor_decal/corner/paleblue/border{
	dir = 1
	},
/turf/simulated/shuttle/floor/yellow,
/area/submap/piratevessel)
"bT" = (
/obj/effect/floor_decal/corner/blue/border,
/turf/simulated/shuttle/floor/yellow,
/area/submap/piratevessel)
"cd" = (
/obj/effect/floor_decal/corner/yellow/border{
	dir = 8
	},
/turf/simulated/shuttle/floor/yellow,
/area/submap/piratevessel)
"cn" = (
/obj/structure/table/gold,
/obj/effect/floor_decal/corner/yellow/diagonal,
/obj/random/medical/pillbottle,
/obj/machinery/recharger,
/turf/simulated/shuttle/floor/yellow,
/area/submap/piratevessel)
"cG" = (
/obj/machinery/portable_atmospherics/canister/empty,
/turf/simulated/shuttle/floor/black,
/area/submap/piratevessel)
"dt" = (
/turf/template_noop,
/area/template_noop)
"dx" = (
/obj/machinery/portable_atmospherics/hydroponics,
/obj/effect/floor_decal/corner/green/diagonal,
/obj/item/seeds/goldappleseed,
/turf/simulated/shuttle/floor/yellow,
/area/submap/piratevessel)
"dN" = (
/obj/machinery/door/airlock/external,
/turf/simulated/shuttle/floor/yellow,
/area/submap/piratevessel)
"dO" = (
/obj/structure/table/marble,
/obj/effect/floor_decal/corner/green/diagonal,
/obj/item/storage/pill_bottle/nutriment,
/obj/item/reagent_containers/glass/bottle/mutagen,
/obj/machinery/light/poi,
/turf/simulated/shuttle/floor/yellow,
/area/submap/piratevessel)
"eO" = (
/obj/structure/railing{
	dir = 4
	},
/obj/structure/railing,
/turf/simulated/shuttle/floor/black,
/area/submap/piratevessel)
"fJ" = (
/obj/structure/table/marble,
/obj/effect/floor_decal/corner/green/diagonal,
/obj/item/reagent_containers/glass/bottle/left4zed,
/turf/simulated/shuttle/floor/yellow,
/area/submap/piratevessel)
"fX" = (
/mob/living/simple_mob/humanoid/pirate/ranged,
/obj/effect/floor_decal/corner/purple/diagonal,
/turf/simulated/shuttle/floor/yellow,
/area/submap/piratevessel)
"gd" = (
/mob/living/simple_mob/humanoid/pirate/shield/machete/armored,
/obj/effect/floor_decal/corner/red/diagonal,
/turf/simulated/shuttle/floor/yellow,
/area/submap/piratevessel)
"gA" = (
/obj/effect/floor_decal/corner/yellow/bordercorner{
	dir = 8
	},
/turf/simulated/shuttle/floor/yellow,
/area/submap/piratevessel)
"gO" = (
/obj/effect/floor_decal/corner/blue/border{
	dir = 1
	},
/turf/simulated/shuttle/floor/yellow,
/area/submap/piratevessel)
"hc" = (
/obj/structure/closet/crate/medical,
/obj/effect/floor_decal/corner/purple/diagonal,
/obj/random/contraband,
/obj/random/contraband,
/obj/random/maintenance/morestuff,
/turf/simulated/shuttle/floor/yellow,
/area/submap/piratevessel)
"he" = (
/mob/living/simple_mob/humanoid/pirate/las,
/obj/effect/floor_decal/corner/blue/bordercorner{
	dir = 8
	},
/turf/simulated/shuttle/floor/yellow,
/area/submap/piratevessel)
"hO" = (
/obj/effect/floor_decal/corner/red/diagonal,
/obj/structure/table/steel,
/obj/item/clothing/suit/space/pirate,
/obj/item/clothing/head/helmet/space/pirate,
/turf/simulated/shuttle/floor/yellow,
/area/submap/piratevessel)
"hR" = (
/obj/structure/table/gold,
/obj/effect/floor_decal/corner/yellow/diagonal,
/obj/item/card/emag,
/turf/simulated/shuttle/floor/yellow,
/area/submap/piratevessel)
"ib" = (
/obj/random/contraband/nofail,
/obj/random/contraband/nofail,
/obj/random/contraband,
/obj/random/contraband,
/obj/random/maintenance/cargo,
/obj/random/maintenance/cargo,
/obj/random/maintenance/medical,
/obj/random/maintenance/medical,
/obj/random/maintenance/research,
/obj/random/maintenance/research,
/obj/random/maintenance/security,
/obj/random/maintenance/security,
/obj/structure/closet/crate,
/obj/effect/floor_decal/corner/purple/diagonal,
/obj/machinery/light/poi,
/obj/random/contraband,
/obj/random/contraband,
/obj/random/maintenance/morestuff,
/turf/simulated/shuttle/floor/yellow,
/area/submap/piratevessel)
"iP" = (
/obj/effect/floor_decal/corner/yellow/diagonal,
/obj/random/contraband,
/turf/simulated/shuttle/floor/yellow,
/area/submap/piratevessel)
"ka" = (
/obj/effect/floor_decal/corner/purple/diagonal,
/obj/machinery/light/poi,
/turf/simulated/shuttle/floor/yellow,
/area/submap/piratevessel)
"ky" = (
/obj/machinery/portable_atmospherics/canister/phoron,
/obj/effect/floor_decal/corner/yellow/border{
	dir = 5
	},
/turf/simulated/shuttle/floor/yellow,
/area/submap/piratevessel)
"lo" = (
/obj/effect/floor_decal/corner/blue/border{
	dir = 4
	},
/obj/structure/bed/chair/bar_stool,
/turf/simulated/shuttle/floor/yellow,
/area/submap/piratevessel)
"lC" = (
/obj/effect/floor_decal/corner/purple/diagonal,
/obj/machinery/light/poi{
	dir = 4
	},
/turf/simulated/shuttle/floor/yellow,
/area/submap/piratevessel)
"lN" = (
/obj/effect/floor_decal/corner/paleblue/border{
	dir = 4
	},
/obj/machinery/light/poi{
	dir = 4
	},
/turf/simulated/shuttle/floor/yellow,
/area/submap/piratevessel)
"lZ" = (
/obj/structure/table/marble,
/obj/effect/floor_decal/corner/green/diagonal,
/obj/item/reagent_containers/glass/bottle/robustharvest,
/turf/simulated/shuttle/floor/yellow,
/area/submap/piratevessel)
"mq" = (
/turf/simulated/wall/rplastihull,
/area/submap/piratevessel)
"mw" = (
/obj/effect/floor_decal/corner/green/diagonal,
/mob/living/bot/farmbot{
	faction = "pirate"
	},
/turf/simulated/shuttle/floor/yellow,
/area/submap/piratevessel)
"pu" = (
/obj/structure/railing{
	dir = 1
	},
/obj/machinery/power/port_gen/pacman,
/obj/machinery/light/poi{
	dir = 8
	},
/turf/simulated/shuttle/floor/black,
/area/submap/piratevessel)
"pQ" = (
/turf/simulated/wall/golddiamond,
/area/submap/piratevessel)
"pR" = (
/obj/structure/table/marble,
/obj/effect/floor_decal/corner/green/diagonal,
/obj/item/reagent_containers/glass/bottle/eznutrient,
/obj/item/reagent_containers/glass/bottle/eznutrient,
/turf/simulated/shuttle/floor/yellow,
/area/submap/piratevessel)
"qd" = (
/mob/living/simple_mob/humanoid/pirate/ranged/handcannon,
/obj/effect/floor_decal/corner/purple/diagonal,
/turf/simulated/shuttle/floor/yellow,
/area/submap/piratevessel)
"qB" = (
/obj/effect/floor_decal/corner/yellow/border{
	dir = 1
	},
/turf/simulated/shuttle/floor/yellow,
/area/submap/piratevessel)
"qL" = (
/obj/machinery/door/airlock/gold,
/turf/simulated/shuttle/floor/yellow,
/area/submap/piratevessel)
"qP" = (
/obj/effect/floor_decal/corner/yellow/diagonal,
/obj/machinery/light/poi{
	dir = 8
	},
/turf/simulated/shuttle/floor/yellow,
/area/submap/piratevessel)
"qW" = (
/obj/effect/floor_decal/corner/paleblue/border,
/obj/machinery/light/poi,
/turf/simulated/shuttle/floor/yellow,
/area/submap/piratevessel)
"rp" = (
/obj/effect/floor_decal/corner/blue/border{
	dir = 8
	},
/turf/simulated/shuttle/floor/yellow,
/area/submap/piratevessel)
"rw" = (
/obj/structure/table/gold,
/obj/effect/floor_decal/corner/yellow/diagonal,
/obj/item/rig_module/fabricator/energy_net,
/obj/item/rig/pmc/security/grey/equipped,
/turf/simulated/shuttle/floor/yellow,
/area/submap/piratevessel)
"st" = (
/obj/effect/floor_decal/corner/yellow/border{
	dir = 9
	},
/turf/simulated/shuttle/floor/yellow,
/area/submap/piratevessel)
"sP" = (
/obj/structure/railing{
	dir = 4
	},
/obj/structure/railing{
	dir = 1
	},
/turf/simulated/shuttle/floor/black,
/area/submap/piratevessel)
"sX" = (
/obj/effect/floor_decal/corner/purple/diagonal,
/obj/machinery/light/poi{
	dir = 8
	},
/turf/simulated/shuttle/floor/yellow,
/area/submap/piratevessel)
"ta" = (
/obj/effect/floor_decal/corner/yellow/border{
	dir = 10
	},
/turf/simulated/shuttle/floor/yellow,
/area/submap/piratevessel)
"tI" = (
/obj/structure/closet/crate/hydroponics/exotic,
/obj/effect/floor_decal/corner/purple/diagonal,
/obj/random/contraband,
/obj/random/contraband,
/obj/random/maintenance/morestuff,
/turf/simulated/shuttle/floor/yellow,
/area/submap/piratevessel)
"tX" = (
/obj/structure/table/marble,
/obj/random/material/precious,
/obj/effect/floor_decal/corner/purple/diagonal,
/turf/simulated/shuttle/floor/yellow,
/area/submap/piratevessel)
"ur" = (
/obj/machinery/portable_atmospherics/hydroponics,
/obj/effect/floor_decal/corner/green/diagonal,
/obj/item/seeds/goldappleseed,
/obj/structure/sink/kitchen{
	pixel_y = 28
	},
/turf/simulated/shuttle/floor/yellow,
/area/submap/piratevessel)
"uL" = (
/obj/effect/floor_decal/corner/purple/diagonal,
/obj/structure/closet/jcloset,
/obj/item/reagent_containers/spray/cleaner,
/obj/item/grenade/chem_grenade/cleaner,
/turf/simulated/shuttle/floor/yellow,
/area/submap/piratevessel)
"vY" = (
/obj/effect/floor_decal/corner/paleblue/border{
	dir = 4
	},
/turf/simulated/shuttle/floor/yellow,
/area/submap/piratevessel)
"wz" = (
/obj/effect/floor_decal/corner/green/diagonal,
/obj/machinery/light/poi{
	dir = 8
	},
/turf/simulated/shuttle/floor/yellow,
/area/submap/piratevessel)
"xr" = (
/obj/effect/floor_decal/corner/purple/diagonal,
/obj/machinery/light/poi{
	dir = 1
	},
/turf/simulated/shuttle/floor/yellow,
/area/submap/piratevessel)
"AD" = (
/obj/machinery/computer/ship{
	dir = 8
	},
/obj/effect/floor_decal/corner/yellow/diagonal,
/obj/machinery/light/poi{
	dir = 4
	},
/turf/simulated/shuttle/floor/yellow,
/area/submap/piratevessel)
"Bx" = (
/obj/structure/closet/crate/mimic,
/obj/effect/floor_decal/corner/purple/diagonal,
/obj/random/contraband,
/obj/random/contraband,
/obj/random/maintenance/morestuff,
/turf/simulated/shuttle/floor/yellow,
/area/submap/piratevessel)
"BG" = (
/obj/effect/floor_decal/corner/yellow/diagonal,
/obj/structure/table/rack/shelf/steel,
/obj/random/gun/random,
/obj/random/gun/random,
/obj/machinery/light/poi{
	dir = 1
	},
/obj/random/contraband,
/turf/simulated/shuttle/floor/yellow,
/area/submap/piratevessel)
"BJ" = (
/obj/effect/floor_decal/corner/yellow/diagonal,
/turf/simulated/shuttle/floor/yellow,
/area/submap/piratevessel)
"CN" = (
/mob/living/simple_mob/humanoid/pirate/ranged/shotgun,
/obj/effect/floor_decal/corner/blue/bordercorner,
/turf/simulated/shuttle/floor/yellow,
/area/submap/piratevessel)
"Dr" = (
/obj/effect/floor_decal/corner/yellow/diagonal,
/obj/structure/table/rack/shelf/steel,
/obj/random/contraband,
/obj/item/gun/energy/lasershotgun,
/turf/simulated/shuttle/floor/yellow,
/area/submap/piratevessel)
"Dy" = (
/obj/effect/floor_decal/corner/green/diagonal,
/obj/machinery/light/poi{
	dir = 4
	},
/turf/simulated/shuttle/floor/yellow,
/area/submap/piratevessel)
"DY" = (
/obj/structure/closet/crate/secure/loot,
/obj/effect/floor_decal/corner/purple/diagonal,
/obj/random/contraband,
/obj/random/contraband,
/obj/random/maintenance/morestuff,
/turf/simulated/shuttle/floor/yellow,
/area/submap/piratevessel)
"Ev" = (
/obj/effect/floor_decal/corner/green/diagonal,
/turf/simulated/shuttle/floor/yellow,
/area/submap/piratevessel)
"EC" = (
/obj/effect/floor_decal/corner/paleblue/border{
	dir = 10
	},
/turf/simulated/shuttle/floor/yellow,
/area/submap/piratevessel)
"EP" = (
/mob/living/simple_mob/humanoid/pirate,
/turf/simulated/shuttle/floor/yellow,
/area/submap/piratevessel)
"Fc" = (
/obj/structure/table/marble,
/obj/effect/floor_decal/corner/green/diagonal,
/obj/item/reagent_containers/glass/bucket,
/obj/item/reagent_containers/glass/bucket,
/obj/machinery/light/poi,
/turf/simulated/shuttle/floor/yellow,
/area/submap/piratevessel)
"Fg" = (
/obj/effect/floor_decal/corner/yellow/diagonal,
/obj/machinery/porta_turret/alien{
	faction = "pirate"
	},
/turf/simulated/shuttle/floor/yellow,
/area/submap/piratevessel)
"Fh" = (
/obj/random/contraband/nofail,
/obj/random/contraband/nofail,
/obj/random/contraband,
/obj/random/contraband,
/obj/random/maintenance/cargo,
/obj/random/maintenance/cargo,
/obj/random/maintenance/medical,
/obj/random/maintenance/medical,
/obj/random/maintenance/research,
/obj/random/maintenance/research,
/obj/random/maintenance/security,
/obj/random/maintenance/security,
/obj/structure/closet/crate,
/obj/effect/floor_decal/corner/purple/diagonal,
/obj/item/rig_module/mounted/egun,
/obj/machinery/light/poi,
/obj/random/contraband,
/obj/random/contraband,
/obj/random/maintenance/morestuff,
/turf/simulated/shuttle/floor/yellow,
/area/submap/piratevessel)
"Fw" = (
/obj/effect/floor_decal/corner/yellow/diagonal,
/obj/structure/table/rack/shelf/steel,
/obj/random/contraband,
/obj/item/gun/energy/lasercannon,
/turf/simulated/shuttle/floor/yellow,
/area/submap/piratevessel)
"Gl" = (
/obj/random/contraband/nofail,
/obj/random/contraband/nofail,
/obj/random/contraband,
/obj/random/contraband,
/obj/random/maintenance/cargo,
/obj/random/maintenance/cargo,
/obj/random/maintenance/medical,
/obj/random/maintenance/medical,
/obj/random/maintenance/research,
/obj/random/maintenance/research,
/obj/random/maintenance/security,
/obj/random/maintenance/security,
/obj/structure/closet/crate,
/obj/effect/floor_decal/corner/purple/diagonal,
/obj/random/contraband,
/obj/random/contraband,
/obj/random/maintenance/morestuff,
/turf/simulated/shuttle/floor/yellow,
/area/submap/piratevessel)
"Gw" = (
/obj/structure/table/marble,
/obj/effect/floor_decal/corner/green/diagonal,
/obj/item/storage/pill_bottle/nutriment,
/obj/item/reagent_containers/glass/bottle/biomass,
/turf/simulated/shuttle/floor/yellow,
/area/submap/piratevessel)
"Hf" = (
/obj/effect/floor_decal/corner/paleblue/border{
	dir = 1
	},
/obj/machinery/light/poi{
	dir = 1
	},
/turf/simulated/shuttle/floor/yellow,
/area/submap/piratevessel)
"Hs" = (
/obj/machinery/portable_atmospherics/canister/phoron,
/obj/effect/floor_decal/corner/yellow/border{
	dir = 4
	},
/obj/machinery/light/poi{
	dir = 4
	},
/turf/simulated/shuttle/floor/yellow,
/area/submap/piratevessel)
"HP" = (
/obj/effect/floor_decal/corner/yellow/diagonal,
/obj/structure/table/rack/shelf/steel,
/obj/random/firstaid,
/obj/machinery/light/poi{
	dir = 1
	},
/obj/random/contraband,
/turf/simulated/shuttle/floor/yellow,
/area/submap/piratevessel)
"Jd" = (
/obj/structure/closet/crate/freezer/nanotrasen,
/obj/effect/floor_decal/corner/purple/diagonal,
/obj/random/contraband,
/obj/random/contraband,
/obj/random/maintenance/morestuff,
/turf/simulated/shuttle/floor/yellow,
/area/submap/piratevessel)
"Jn" = (
/obj/machinery/portable_atmospherics/canister/nitrous_oxide,
/obj/effect/floor_decal/corner/yellow/border{
	dir = 4
	},
/turf/simulated/shuttle/floor/yellow,
/area/submap/piratevessel)
"Jv" = (
/obj/effect/floor_decal/corner/paleblue/border{
	dir = 8
	},
/obj/machinery/light/poi{
	dir = 8
	},
/turf/simulated/shuttle/floor/yellow,
/area/submap/piratevessel)
"JU" = (
/obj/structure/table/marble,
/obj/effect/floor_decal/corner/green/diagonal,
/obj/item/reagent_containers/glass/bottle/eznutrient,
/obj/item/reagent_containers/glass/bottle/eznutrient,
/obj/machinery/light/poi{
	dir = 1
	},
/turf/simulated/shuttle/floor/yellow,
/area/submap/piratevessel)
"Lc" = (
/obj/effect/floor_decal/corner/paleblue/border{
	dir = 9
	},
/turf/simulated/shuttle/floor/yellow,
/area/submap/piratevessel)
"Lh" = (
/turf/simulated/shuttle/floor/yellow,
/area/submap/piratevessel)
"LK" = (
/obj/effect/floor_decal/corner/paleblue/border{
	dir = 6
	},
/turf/simulated/shuttle/floor/yellow,
/area/submap/piratevessel)
"LZ" = (
/obj/effect/floor_decal/corner/yellow/diagonal,
/obj/structure/table/rack/shelf/steel,
/obj/random/toolbox,
/obj/random/contraband,
/turf/simulated/shuttle/floor/yellow,
/area/submap/piratevessel)
"Mb" = (
/obj/structure/shuttle/engine/heater{
	dir = 8
	},
/turf/simulated/wall/rplastihull,
/area/submap/piratevessel)
"ML" = (
/obj/effect/floor_decal/corner/red/diagonal,
/obj/machinery/light/poi,
/turf/simulated/shuttle/floor/yellow,
/area/submap/piratevessel)
"MZ" = (
/obj/machinery/door/airlock,
/turf/simulated/shuttle/floor/yellow,
/area/submap/piratevessel)
"Nb" = (
/obj/effect/floor_decal/corner/paleblue/border{
	dir = 8
	},
/turf/simulated/shuttle/floor/yellow,
/area/submap/piratevessel)
"Nu" = (
/obj/effect/floor_decal/corner/paleblue/border,
/turf/simulated/shuttle/floor/yellow,
/area/submap/piratevessel)
"Nz" = (
/mob/living/simple_mob/humanoid/pirate/ranged/handcannon,
/obj/effect/floor_decal/corner/green/diagonal,
/turf/simulated/shuttle/floor/yellow,
/area/submap/piratevessel)
"NC" = (
/obj/structure/railing{
	dir = 4
	},
/turf/simulated/shuttle/floor/black,
/area/submap/piratevessel)
"NO" = (
/obj/structure/table/marble,
/obj/effect/floor_decal/corner/green/diagonal,
/obj/item/material/minihoe,
/obj/item/material/knife/machete/hatchet,
/turf/simulated/shuttle/floor/yellow,
/area/submap/piratevessel)
"NZ" = (
/obj/machinery/computer/ship{
	dir = 8
	},
/obj/effect/floor_decal/corner/yellow/diagonal,
/turf/simulated/shuttle/floor/yellow,
/area/submap/piratevessel)
"Oj" = (
/obj/structure/railing,
/obj/machinery/power/port_gen/pacman,
/obj/machinery/light/poi{
	dir = 8
	},
/turf/simulated/shuttle/floor/black,
/area/submap/piratevessel)
"Pd" = (
/obj/effect/floor_decal/corner/yellow/diagonal,
/obj/structure/table/rack/shelf/steel,
/obj/random/gun/random,
/obj/random/gun/random,
/obj/machinery/light/poi,
/obj/random/contraband,
/turf/simulated/shuttle/floor/yellow,
/area/submap/piratevessel)
"PL" = (
/obj/effect/floor_decal/corner/yellow/diagonal,
/obj/structure/table/rack/shelf/steel,
/obj/random/firstaid,
/obj/machinery/light/poi,
/obj/random/contraband,
/turf/simulated/shuttle/floor/yellow,
/area/submap/piratevessel)
"PT" = (
/obj/effect/floor_decal/corner/red/diagonal,
/obj/structure/table/steel,
/obj/item/clothing/head/helmet/space/pirate,
/obj/item/clothing/suit/space/pirate,
/turf/simulated/shuttle/floor/yellow,
/area/submap/piratevessel)
"Qt" = (
/obj/effect/floor_decal/corner/purple/diagonal,
/obj/structure/janitorialcart,
/turf/simulated/shuttle/floor/yellow,
/area/submap/piratevessel)
"RF" = (
/obj/effect/floor_decal/corner/blue/border{
	dir = 8
	},
/obj/structure/bed/chair/bar_stool,
/turf/simulated/shuttle/floor/yellow,
/area/submap/piratevessel)
"RN" = (
/obj/structure/closet/crate/carp,
/obj/effect/floor_decal/corner/purple/diagonal,
/obj/random/contraband,
/obj/random/contraband,
/obj/random/maintenance/morestuff,
/turf/simulated/shuttle/floor/yellow,
/area/submap/piratevessel)
"Sb" = (
/obj/effect/floor_decal/corner/yellow/border,
/turf/simulated/shuttle/floor/yellow,
/area/submap/piratevessel)
"Sp" = (
/obj/structure/table/marble,
/obj/structure/table/marble,
/obj/random/material/precious,
/obj/effect/floor_decal/corner/purple/diagonal,
/turf/simulated/shuttle/floor/yellow,
/area/submap/piratevessel)
"Tg" = (
/obj/effect/floor_decal/corner/red/diagonal,
/obj/machinery/light/poi{
	dir = 1
	},
/turf/simulated/shuttle/floor/yellow,
/area/submap/piratevessel)
"TI" = (
/obj/structure/closet/crate/secure/large/reinforced,
/obj/effect/floor_decal/corner/purple/diagonal,
/obj/random/contraband/nofail,
/obj/random/contraband/nofail,
/obj/random/contraband/nofail,
/obj/random/contraband,
/obj/random/contraband,
/obj/random/maintenance/morestuff,
/turf/simulated/shuttle/floor/yellow,
/area/submap/piratevessel)
"Uc" = (
/obj/structure/closet/crate/medical/blood,
/obj/effect/floor_decal/corner/purple/diagonal,
/obj/random/contraband,
/obj/random/contraband,
/obj/random/maintenance/morestuff,
/turf/simulated/shuttle/floor/yellow,
/area/submap/piratevessel)
"Un" = (
/obj/structure/table/marble,
/obj/random/maintenance/foodstuff,
/obj/random/maintenance/foodstuff,
/obj/random/maintenance/foodstuff,
/turf/simulated/shuttle/floor/yellow,
/area/submap/piratevessel)
"Vb" = (
/obj/effect/floor_decal/corner/purple/diagonal,
/obj/structure/mopbucket,
/obj/item/mop/advanced,
/obj/item/reagent_containers/glass/bucket,
/turf/simulated/shuttle/floor/yellow,
/area/submap/piratevessel)
"VB" = (
/obj/effect/floor_decal/corner/yellow/bordercorner{
	dir = 1
	},
/turf/simulated/shuttle/floor/yellow,
/area/submap/piratevessel)
"VY" = (
/obj/structure/shuttle/engine/propulsion{
	dir = 8
	},
/turf/simulated/wall/rplastihull,
/area/submap/piratevessel)
"Wd" = (
/obj/effect/floor_decal/corner/purple/diagonal,
/turf/simulated/shuttle/floor/yellow,
/area/submap/piratevessel)
"Wy" = (
/obj/effect/floor_decal/corner/red/diagonal,
/turf/simulated/shuttle/floor/yellow,
/area/submap/piratevessel)
"WG" = (
/mob/living/simple_mob/humanoid/pirate/ranged/shotgun,
/obj/effect/floor_decal/corner/blue/bordercorner{
	dir = 4
	},
/turf/simulated/shuttle/floor/yellow,
/area/submap/piratevessel)
"WX" = (
/mob/living/simple_mob/humanoid/pirate/ranged,
/obj/effect/floor_decal/corner/green/diagonal,
/turf/simulated/shuttle/floor/yellow,
/area/submap/piratevessel)
"Yl" = (
/mob/living/simple_mob/mechanical/mecha/ripley/pirate,
/obj/effect/floor_decal/corner/red/diagonal,
/turf/simulated/shuttle/floor/yellow,
/area/submap/piratevessel)
"YF" = (
/mob/living/simple_mob/humanoid/pirate/las,
/obj/effect/floor_decal/corner/blue/bordercorner{
	dir = 1
	},
/turf/simulated/shuttle/floor/yellow,
/area/submap/piratevessel)
"YG" = (
/mob/living/simple_mob/humanoid/pirate/captain,
/obj/effect/floor_decal/corner/yellow/diagonal,
/turf/simulated/shuttle/floor/yellow,
/area/submap/piratevessel)
"YU" = (
/obj/effect/floor_decal/corner/blue/border{
	dir = 4
	},
/turf/simulated/shuttle/floor/yellow,
/area/submap/piratevessel)
"ZA" = (
/obj/effect/floor_decal/corner/paleblue/border{
	dir = 5
	},
/turf/simulated/shuttle/floor/yellow,
/area/submap/piratevessel)
"ZK" = (
/obj/machinery/portable_atmospherics/canister/oxygen,
/obj/effect/floor_decal/corner/yellow/border{
	dir = 4
	},
/turf/simulated/shuttle/floor/yellow,
/area/submap/piratevessel)
"ZO" = (
/obj/machinery/portable_atmospherics/canister/phoron,
/obj/effect/floor_decal/corner/yellow/border{
	dir = 6
	},
/turf/simulated/shuttle/floor/yellow,
/area/submap/piratevessel)

(1,1,1) = {"
dt
dt
dt
dt
dt
dt
dt
dt
dt
dt
dt
dt
dt
dt
dt
dt
dt
dt
dt
dt
dt
dt
dt
dt
dt
dt
dt
dt
"}
(2,1,1) = {"
dt
dt
dt
dt
dt
dt
dt
dt
dt
dt
dt
dt
dt
dt
dt
dt
dt
dt
dt
dt
dt
dt
dt
dt
dt
dt
dt
dt
"}
(3,1,1) = {"
dt
dt
dt
dt
dt
dt
dt
dt
dt
mq
mq
mq
mq
dN
dN
mq
mq
mq
mq
dt
dt
dt
dt
dt
dt
dt
dt
dt
"}
(4,1,1) = {"
dt
dt
dt
mq
VY
VY
VY
VY
VY
mq
cG
Oj
st
cd
cd
ta
pu
cG
mq
VY
VY
VY
VY
VY
mq
dt
dt
dt
"}
(5,1,1) = {"
dt
dt
dt
mq
Mb
Mb
Mb
Mb
Mb
mq
NC
eO
qB
EP
EP
Sb
sP
NC
mq
Mb
Mb
Mb
Mb
Mb
mq
dt
dt
dt
"}
(6,1,1) = {"
dt
dt
dt
mq
dx
wz
Ev
wz
Ev
MZ
st
cd
VB
Lh
Lh
gA
cd
ta
MZ
Wd
sX
Wd
sX
hc
mq
dt
dt
dt
"}
(7,1,1) = {"
dt
dt
dt
mq
dx
Ev
Ev
Ev
Ev
mq
ky
Hs
Jn
ZK
ZK
Jn
Hs
ZO
mq
Wd
Wd
Wd
Wd
RN
mq
dt
dt
dt
"}
(8,1,1) = {"
dt
dt
dt
mq
dx
WX
Ev
Ev
NO
mq
mq
mq
mq
mq
mq
mq
mq
mq
mq
Wd
Wd
tX
fX
TI
mq
dt
dt
dt
"}
(9,1,1) = {"
dt
dt
dt
mq
JU
mw
Ev
Ev
Fc
mq
Lc
Nb
Jv
Nb
Nb
Jv
Nb
EC
mq
xr
Wd
tX
Wd
Fh
mq
dt
dt
dt
"}
(10,1,1) = {"
dt
dt
dt
mq
pR
Ev
Ev
Ev
NO
mq
Hf
CN
lo
YU
YU
lo
WG
qW
mq
Wd
Wd
tX
Wd
tI
mq
dt
dt
dt
"}
(11,1,1) = {"
dt
dt
dt
mq
ur
Ev
Ev
Ev
Ev
mq
bh
bT
Un
Un
Un
Un
gO
Nu
mq
Wd
Wd
Wd
Wd
DY
mq
dt
dt
dt
"}
(12,1,1) = {"
dt
dt
dt
mq
ur
Ev
Ev
Ev
Ev
MZ
bh
bT
Un
Un
Un
Un
gO
Nu
MZ
Wd
Wd
Wd
Wd
Gl
mq
dt
dt
dt
"}
(13,1,1) = {"
dt
dt
dt
mq
pR
Ev
Ev
Ev
Ev
mq
Hf
he
RF
rp
rp
RF
YF
qW
mq
Wd
Wd
tX
Wd
Jd
mq
dt
dt
dt
"}
(14,1,1) = {"
dt
dt
dt
mq
JU
Nz
Ev
Ev
dO
mq
ZA
vY
lN
vY
vY
lN
vY
LK
mq
xr
Wd
Sp
qd
ib
mq
dt
dt
dt
"}
(15,1,1) = {"
dt
dt
dt
mq
dx
Ev
Ev
Ev
lZ
mq
mq
mq
mq
aj
aj
mq
mq
mq
mq
Wd
Wd
tX
Wd
DY
mq
dt
dt
dt
"}
(16,1,1) = {"
dt
dt
dt
mq
dx
Ev
Ev
Ev
fJ
mq
pQ
Fg
qP
BJ
BJ
qP
Fg
pQ
mq
Wd
Wd
Wd
Wd
Bx
mq
dt
dt
dt
"}
(17,1,1) = {"
dt
dt
dt
mq
dx
Dy
Ev
Ev
Gw
mq
BG
BJ
BJ
BJ
BJ
BJ
BJ
Pd
mq
Wd
Wd
Wd
lC
Uc
mq
dt
dt
dt
"}
(18,1,1) = {"
dt
dt
dt
mq
mq
mq
mq
MZ
mq
mq
Dr
BJ
BJ
BJ
BJ
BJ
BJ
Fw
mq
mq
MZ
mq
mq
mq
mq
dt
dt
dt
"}
(19,1,1) = {"
dt
dt
dt
dt
dt
mq
PT
Wy
PT
mq
LZ
BJ
cn
rw
hR
cn
BJ
LZ
mq
PT
Wy
PT
mq
dt
dt
dt
dt
dt
"}
(20,1,1) = {"
dt
dt
dt
dt
dt
mq
hO
Wy
hO
mq
HP
BJ
BJ
YG
BJ
BJ
iP
PL
mq
hO
Wy
hO
mq
dt
dt
dt
dt
dt
"}
(21,1,1) = {"
dt
dt
dt
dt
dt
mq
Tg
Wy
ML
mq
pQ
NZ
AD
NZ
NZ
AD
NZ
pQ
mq
Tg
Wy
ML
mq
dt
dt
dt
dt
dt
"}
(22,1,1) = {"
dt
dt
dt
dt
dt
mq
Wy
Wy
Wy
mq
mq
mq
mq
mq
mq
mq
mq
mq
mq
Wy
Wy
Wy
mq
dt
dt
dt
dt
dt
"}
(23,1,1) = {"
dt
dt
dt
dt
dt
mq
Wy
gd
Wy
mq
dt
dt
dt
dt
dt
dt
dt
dt
mq
Wy
gd
Wy
mq
dt
dt
dt
dt
dt
"}
(24,1,1) = {"
dt
dt
dt
dt
dt
mq
Wy
Wy
Yl
dN
dt
dt
dt
dt
dt
dt
dt
dt
dN
Yl
Wy
Wy
mq
dt
dt
dt
dt
dt
"}
(25,1,1) = {"
dt
dt
dt
dt
dt
mq
Tg
Wy
ML
mq
dt
dt
dt
dt
dt
dt
dt
dt
mq
Tg
Wy
ML
mq
dt
dt
dt
dt
dt
"}
(26,1,1) = {"
dt
dt
dt
dt
dt
mq
Wy
Wy
Wy
mq
dt
dt
dt
dt
dt
dt
dt
dt
mq
Wy
Wy
Wy
mq
dt
dt
dt
dt
dt
"}
(27,1,1) = {"
dt
dt
dt
dt
dt
mq
mq
mq
qL
mq
dt
dt
dt
dt
dt
dt
dt
dt
mq
qL
mq
mq
mq
dt
dt
dt
dt
dt
"}
(28,1,1) = {"
dt
dt
dt
dt
dt
dt
mq
Qt
Wd
mq
dt
dt
dt
dt
dt
dt
dt
dt
mq
Wd
Qt
mq
dt
dt
dt
dt
dt
dt
"}
(29,1,1) = {"
dt
dt
dt
dt
dt
dt
mq
Vb
ka
mq
dt
dt
dt
dt
dt
dt
dt
dt
mq
xr
Vb
mq
dt
dt
dt
dt
dt
dt
"}
(30,1,1) = {"
dt
dt
dt
dt
dt
dt
mq
uL
Wd
mq
dt
dt
dt
dt
dt
dt
dt
dt
mq
Wd
uL
mq
dt
dt
dt
dt
dt
dt
"}
(31,1,1) = {"
dt
dt
dt
dt
dt
dt
mq
mq
mq
mq
dt
dt
dt
dt
dt
dt
dt
dt
mq
mq
mq
mq
dt
dt
dt
dt
dt
dt
"}
(32,1,1) = {"
dt
dt
dt
dt
dt
dt
dt
dt
dt
dt
dt
dt
dt
dt
dt
dt
dt
dt
dt
dt
dt
dt
dt
dt
dt
dt
dt
dt
"}
(33,1,1) = {"
dt
dt
dt
dt
dt
dt
dt
dt
dt
dt
dt
dt
dt
dt
dt
dt
dt
dt
dt
dt
dt
dt
dt
dt
dt
dt
dt
dt
"}
