//MAP CONVERTED BY dmm2tgm.py THIS HEADER COMMENT PREVENTS RECONVERSION, DO NOT REMOVE
"cD" = (
/obj/structure/table/rack/shelf/steel,
/obj/random/gun/random,
/obj/machinery/light/poi{
	dir = 1
	},
/obj/item/rig/baymed,
/turf/simulated/floor/tiled/white,
/area/submap/piratevox)
"cH" = (
/obj/machinery/light/poi{
	dir = 8
	},
/obj/effect/landmark/corpse/syndicatesoldier,
/turf/simulated/floor/tiled/white,
/area/submap/piratevox)
"dy" = (
/obj/machinery/computer/ship{
	dir = 1
	},
/turf/simulated/floor/tiled/white,
/area/submap/piratevox)
"dz" = (
/obj/structure/cable/green{
	icon_state = "2-8"
	},
/turf/simulated/floor/tiled/white,
/area/submap/piratevox)
"fA" = (
/obj/effect/decal/cleanable/blood/splatter,
/obj/effect/landmark/corpse/syndicatesoldier,
/turf/simulated/floor/tiled/white,
/area/submap/piratevox)
"fD" = (
/obj/machinery/door/airlock/external,
/turf/simulated/floor/tiled/white,
/area/submap/piratevox)
"fL" = (
/obj/structure/table/standard,
/obj/item/flame/lighter/zippo/rainbow,
/turf/simulated/floor/tiled/white,
/area/submap/piratevox)
"fV" = (
/obj/structure/table/standard,
/obj/random/maintenance/medical,
/turf/simulated/floor/tiled/white,
/area/submap/piratevox)
"gp" = (
/obj/structure/cable/green{
	icon_state = "1-2"
	},
/obj/machinery/door/airlock/external,
/turf/simulated/floor/tiled/white,
/area/submap/piratevox)
"hj" = (
/obj/structure/table/rack/shelf/steel,
/obj/random/gun/random,
/obj/machinery/light/poi,
/obj/item/rig/baymed,
/turf/simulated/floor/tiled/white,
/area/submap/piratevox)
"hB" = (
/obj/machinery/light/poi{
	dir = 8
	},
/turf/simulated/floor/tiled/white,
/area/submap/piratevox)
"it" = (
/obj/machinery/power/port_gen/pacman/mrs,
/obj/structure/cable/green{
	icon_state = "0-2"
	},
/turf/simulated/floor/tiled/white,
/area/submap/piratevox)
"iJ" = (
/obj/machinery/power/terminal{
	dir = 1;
	icon_state = "term"
	},
/obj/structure/cable/green{
	icon_state = "0-4"
	},
/turf/simulated/floor/tiled/white,
/area/submap/piratevox)
"iN" = (
/mob/living/simple_mob/humanoid/merc/voxpirate/ranged/captain,
/turf/simulated/floor/tiled/white,
/area/submap/piratevox)
"iU" = (
/obj/structure/cable/green{
	icon_state = "1-8"
	},
/turf/simulated/floor/tiled/white,
/area/submap/piratevox)
"ki" = (
/obj/machinery/light/poi{
	dir = 4
	},
/turf/simulated/floor/tiled/white,
/area/submap/piratevox)
"mE" = (
/obj/structure/table/standard,
/obj/random/maintenance/engineering,
/obj/random/maintenance/security,
/turf/simulated/floor/tiled/white,
/area/submap/piratevox)
"op" = (
/obj/effect/decal/cleanable/blood/splatter,
/turf/simulated/floor/tiled/red,
/area/submap/piratevox)
"pD" = (
/obj/structure/cable/green{
	icon_state = "4-8"
	},
/turf/simulated/floor/tiled/white,
/area/submap/piratevox)
"pJ" = (
/obj/structure/table/standard,
/obj/random/toolbox,
/turf/simulated/floor/tiled/white,
/area/submap/piratevox)
"pK" = (
/obj/structure/table/standard,
/turf/simulated/floor/tiled/white,
/area/submap/piratevox)
"pV" = (
/obj/structure/table/standard,
/obj/item/card/emag/used,
/turf/simulated/floor/tiled/white,
/area/submap/piratevox)
"rp" = (
/mob/living/simple_mob/humanoid/merc/voxpirate/ranged/suppressor,
/turf/simulated/floor/tiled/white,
/area/submap/piratevox)
"rS" = (
/mob/living/simple_mob/humanoid/merc/voxpirate/pirate,
/obj/effect/decal/cleanable/blood/splatter,
/turf/simulated/floor/tiled/white,
/area/submap/piratevox)
"to" = (
/obj/structure/table/rack/shelf/steel,
/obj/random/gun/random,
/obj/random/gun/random,
/obj/item/rig/bayeng,
/turf/simulated/floor/tiled/white,
/area/submap/piratevox)
"tX" = (
/obj/structure/table/standard,
/obj/item/grenade/chem_grenade/cleaner,
/obj/item/grenade/chem_grenade/cleaner,
/obj/item/rig_module/mounted/mop,
/obj/item/reagent_containers/glass/bucket,
/obj/machinery/light/poi{
	dir = 4
	},
/turf/simulated/floor/tiled/white,
/area/submap/piratevox)
"uQ" = (
/obj/machinery/porta_turret/stationary/syndie{
	faction = "voxpirate"
	},
/turf/simulated/shuttle/plating,
/area/submap/piratevox)
"vn" = (
/obj/structure/cable/green{
	icon_state = "1-4"
	},
/turf/simulated/floor/tiled/white,
/area/submap/piratevox)
"xr" = (
/turf/simulated/wall/rpshull,
/area/submap/piratevox)
"ye" = (
/turf/template_noop,
/area/submap/piratevox)
"zq" = (
/turf/simulated/wall/thull,
/area/submap/piratevox)
"An" = (
/obj/structure/table/standard,
/obj/random/medical/pillbottle,
/turf/simulated/floor/tiled/white,
/area/submap/piratevox)
"Ap" = (
/mob/living/simple_mob/humanoid/merc/voxpirate/pirate,
/obj/structure/cable/green{
	icon_state = "1-2"
	},
/turf/simulated/floor/tiled/white,
/area/submap/piratevox)
"AV" = (
/mob/living/simple_mob/humanoid/merc/voxpirate/technician,
/turf/simulated/floor/tiled/white,
/area/submap/piratevox)
"Bl" = (
/obj/structure/shuttle/engine/heater{
	dir = 8
	},
/turf/simulated/wall/rplastitanium,
/area/submap/piratevox)
"Cm" = (
/turf/template_noop,
/area/template_noop)
"Dg" = (
/obj/structure/table/rack/shelf/steel,
/obj/random/gun/random,
/obj/item/rig/bayeng,
/turf/simulated/floor/tiled/white,
/area/submap/piratevox)
"Dt" = (
/obj/machinery/power/smes/buildable/point_of_interest,
/turf/simulated/floor/tiled/white,
/area/submap/piratevox)
"DI" = (
/obj/structure/bed/chair/office{
	dir = 4
	},
/obj/effect/landmark/corpse/syndicatecommando,
/turf/simulated/floor/tiled/white,
/area/submap/piratevox)
"FN" = (
/obj/machinery/light/poi{
	dir = 4
	},
/obj/effect/landmark/corpse/syndicatesoldier,
/turf/simulated/floor/tiled/white,
/area/submap/piratevox)
"Iu" = (
/mob/living/simple_mob/humanoid/merc/voxpirate/pirate,
/obj/machinery/light/poi{
	dir = 8
	},
/turf/simulated/floor/tiled/white,
/area/submap/piratevox)
"LG" = (
/obj/structure/cable/green{
	icon_state = "1-2"
	},
/obj/effect/landmark/corpse/syndicatesoldier,
/turf/simulated/floor/tiled/white,
/area/submap/piratevox)
"LP" = (
/obj/effect/decal/cleanable/blood/splatter,
/turf/simulated/floor/tiled/white,
/area/submap/piratevox)
"NE" = (
/obj/structure/cable/green{
	icon_state = "1-2"
	},
/turf/simulated/floor/tiled/white,
/area/submap/piratevox)
"NI" = (
/obj/structure/closet/crate/secure/loot,
/obj/item/stolenpackage,
/obj/item/stolenpackage,
/obj/item/stolenpackage,
/turf/simulated/floor/tiled/white,
/area/submap/piratevox)
"Op" = (
/obj/effect/landmark/corpse/syndicatesoldier,
/turf/simulated/floor/tiled/white,
/area/submap/piratevox)
"Os" = (
/turf/simulated/floor/tiled/white,
/area/submap/piratevox)
"OH" = (
/obj/effect/landmark/mobcorpse/vox/boarder_m,
/turf/simulated/floor/tiled/white,
/area/submap/piratevox)
"Rr" = (
/obj/structure/shuttle/engine/propulsion{
	dir = 8
	},
/turf/simulated/shuttle/wall,
/area/submap/piratevox)
"SL" = (
/turf/simulated/wall/rplastitanium,
/area/submap/piratevox)
"Tk" = (
/mob/living/simple_mob/humanoid/merc/voxpirate/boarder,
/obj/structure/bed/chair/office,
/turf/simulated/floor/tiled/white,
/area/submap/piratevox)
"Tl" = (
/mob/living/simple_mob/humanoid/merc/voxpirate/pirate,
/turf/simulated/floor/tiled/white,
/area/submap/piratevox)
"Un" = (
/obj/machinery/power/apc{
	dir = 8;
	pixel_x = -24
	},
/obj/structure/cable/green{
	icon_state = "0-4"
	},
/turf/simulated/floor/tiled/white,
/area/submap/piratevox)
"UL" = (
/obj/structure/grille/rustic{
	health = 25;
	name = "reinforced grille"
	},
/obj/structure/window/plastitanium/full,
/turf/simulated/shuttle/plating,
/area/submap/piratevox)
"Vh" = (
/turf/simulated/floor/tiled/red,
/area/submap/piratevox)
"VO" = (
/obj/structure/cable/green{
	icon_state = "1-2"
	},
/obj/structure/cable/green{
	icon_state = "2-8"
	},
/obj/structure/cable/green{
	icon_state = "1-8"
	},
/obj/machinery/light/poi{
	dir = 4
	},
/turf/simulated/floor/tiled/white,
/area/submap/piratevox)
"VU" = (
/obj/structure/bed/chair/bay/shuttle,
/turf/simulated/floor/tiled/red,
/area/submap/piratevox)
"WN" = (
/obj/structure/table/standard,
/obj/item/reagent_containers/spray/cleaner,
/obj/item/reagent_containers/spray/cleaner,
/obj/item/rig_module/cleaner_launcher,
/obj/item/mop/advanced,
/turf/simulated/floor/tiled/white,
/area/submap/piratevox)
"Xl" = (
/obj/effect/decal/cleanable/blood/splatter,
/obj/effect/landmark/mobcorpse/vox/boarder_m,
/turf/simulated/floor/tiled/white,
/area/submap/piratevox)
"YQ" = (
/obj/effect/decal/cleanable/blood/splatter,
/obj/machinery/light/poi{
	dir = 4
	},
/turf/simulated/floor/tiled/white,
/area/submap/piratevox)
"Za" = (
/obj/structure/bed/chair/office,
/mob/living/simple_mob/humanoid/merc/voxpirate/boarder,
/turf/simulated/floor/tiled/white,
/area/submap/piratevox)
"ZP" = (
/obj/structure/bed/chair/office{
	dir = 1
	},
/obj/effect/landmark/mobcorpse/vox/boarder_m,
/turf/simulated/floor/tiled/white,
/area/submap/piratevox)
"ZU" = (
/obj/machinery/computer/ship,
/turf/simulated/floor/tiled/white,
/area/submap/piratevox)

(1,1,1) = {"
Cm
Cm
Cm
Cm
Cm
Cm
Cm
Cm
Cm
Cm
Cm
Cm
Cm
Cm
Cm
Cm
Cm
Cm
Cm
Cm
Cm
Cm
Cm
Cm
Cm
Cm
Cm
Cm
Cm
"}
(2,1,1) = {"
Cm
Cm
Cm
Cm
Rr
Rr
Rr
Rr
Rr
Cm
Cm
Cm
Cm
Cm
Cm
Cm
Cm
Cm
Cm
Cm
Rr
Rr
Rr
Rr
Rr
Cm
Cm
Cm
Cm
"}
(3,1,1) = {"
Cm
Cm
Cm
Cm
Bl
Bl
Bl
Bl
Bl
Cm
Cm
Cm
Cm
Cm
Cm
Cm
Cm
Cm
Cm
Cm
Bl
Bl
Bl
Bl
Bl
Cm
Cm
Cm
Cm
"}
(4,1,1) = {"
Cm
Cm
Cm
Cm
SL
NI
hB
Os
SL
Cm
Cm
SL
SL
SL
SL
SL
SL
SL
Cm
Cm
SL
Os
hB
NI
SL
Cm
Cm
Cm
Cm
"}
(5,1,1) = {"
Cm
Cm
Cm
Cm
SL
mE
Op
Tl
SL
Cm
Cm
SL
LP
hB
DI
hB
Os
SL
Cm
Cm
SL
Xl
Op
mE
SL
Cm
Cm
Cm
Cm
"}
(6,1,1) = {"
Cm
Cm
Cm
Cm
SL
mE
ZP
Os
SL
SL
SL
SL
rp
An
fL
pV
rp
SL
SL
SL
SL
Os
Za
mE
SL
Cm
Cm
Cm
Cm
"}
(7,1,1) = {"
Cm
Cm
Cm
Cm
SL
mE
LP
Os
SL
Os
WN
SL
Os
Os
Os
Os
Os
SL
Dt
iJ
SL
Os
Os
mE
SL
Cm
Cm
Cm
Cm
"}
(8,1,1) = {"
Cm
Cm
Cm
Cm
SL
cD
Os
Os
fD
Os
tX
SL
Os
Os
iN
Os
LP
SL
it
VO
gp
vn
LP
hj
SL
Cm
Cm
Cm
Cm
"}
(9,1,1) = {"
Cm
Cm
Cm
Cm
SL
Dg
AV
Os
SL
SL
SL
SL
SL
SL
fD
SL
SL
SL
SL
SL
SL
pD
OH
to
SL
Cm
Cm
Cm
Cm
"}
(10,1,1) = {"
Cm
Cm
Cm
Cm
SL
An
Op
Os
SL
Os
Os
LP
Os
Iu
Os
Iu
Un
Os
LP
Os
SL
pD
Op
An
SL
Cm
Cm
Cm
Cm
"}
(11,1,1) = {"
Cm
Cm
Cm
Cm
SL
pK
ZP
Os
fD
Tl
Op
Os
Os
Os
Xl
Os
dz
NE
LG
Ap
gp
iU
Tk
pK
SL
Cm
Cm
Cm
Cm
"}
(12,1,1) = {"
Cm
Cm
Cm
Cm
SL
pK
ki
LP
SL
Os
ki
Os
Os
OH
Os
OH
Os
Os
ki
Os
SL
Os
YQ
An
SL
Cm
Cm
Cm
Cm
"}
(13,1,1) = {"
Cm
Cm
Cm
Cm
SL
SL
SL
SL
SL
SL
SL
SL
SL
Os
Os
Os
SL
SL
SL
SL
SL
SL
SL
SL
SL
Cm
Cm
Cm
Cm
"}
(14,1,1) = {"
Cm
Cm
Cm
Cm
Cm
Cm
Cm
Cm
Cm
Cm
xr
xr
xr
Os
fA
Os
xr
xr
xr
Cm
Cm
Cm
Cm
Cm
Cm
Cm
Cm
Cm
Cm
"}
(15,1,1) = {"
Cm
Cm
Cm
Cm
Cm
Cm
Cm
Cm
Cm
Cm
xr
VU
VU
VU
OH
VU
VU
VU
xr
Cm
Cm
Cm
Cm
Cm
Cm
Cm
Cm
Cm
Cm
"}
(16,1,1) = {"
Cm
Cm
Cm
Cm
Cm
Cm
Cm
Cm
Cm
Cm
xr
Vh
op
Vh
Os
Vh
Vh
Vh
xr
Cm
Cm
Cm
Cm
Cm
Cm
Cm
Cm
Cm
Cm
"}
(17,1,1) = {"
Cm
Cm
Cm
Cm
Cm
Cm
Cm
Cm
Cm
Cm
xr
VU
VU
VU
Os
VU
VU
VU
xr
Cm
Cm
Cm
Cm
Cm
Cm
Cm
Cm
Cm
Cm
"}
(18,1,1) = {"
Cm
Cm
Cm
Cm
Cm
Cm
Cm
Cm
Cm
Cm
xr
xr
xr
ki
Op
YQ
xr
xr
xr
Cm
Cm
Cm
Cm
Cm
Cm
Cm
Cm
Cm
Cm
"}
(19,1,1) = {"
Cm
Cm
Cm
Cm
Cm
Cm
Cm
Cm
Cm
ye
ye
UL
SL
SL
fD
SL
SL
UL
ye
ye
Cm
Cm
Cm
Cm
Cm
Cm
Cm
Cm
Cm
"}
(20,1,1) = {"
Cm
Cm
Cm
Cm
Cm
Cm
Cm
Cm
Cm
uQ
UL
UL
pK
hB
Os
hB
pK
UL
UL
uQ
Cm
Cm
Cm
Cm
Cm
Cm
Cm
Cm
Cm
"}
(21,1,1) = {"
Cm
Cm
Cm
Cm
Cm
Cm
Cm
Cm
ye
UL
UL
fV
LP
Os
Tl
Os
Os
fV
UL
UL
ye
Cm
Cm
Cm
Cm
Cm
Cm
Cm
Cm
"}
(22,1,1) = {"
Cm
Cm
Cm
Cm
Cm
Cm
Cm
Cm
UL
UL
pK
rp
Os
Os
Os
Os
Os
OH
An
UL
UL
Cm
Cm
Cm
Cm
Cm
Cm
Cm
Cm
"}
(23,1,1) = {"
Cm
Cm
Cm
Cm
Cm
Cm
Cm
ye
SL
pK
Os
Os
Os
Os
FN
Os
Os
Os
LP
fV
SL
ye
Cm
Cm
Cm
Cm
Cm
Cm
Cm
"}
(24,1,1) = {"
Cm
Cm
Cm
Cm
Cm
Cm
ye
SL
SL
Os
Os
Os
Os
dy
zq
ZU
Os
Os
Os
Os
SL
SL
ye
Cm
Cm
Cm
Cm
Cm
Cm
"}
(25,1,1) = {"
Cm
Cm
Cm
Cm
Cm
Cm
ye
fD
Os
Os
rS
Op
dy
zq
zq
zq
ZU
Op
Tl
Os
Os
fD
ye
Cm
Cm
Cm
Cm
Cm
Cm
"}
(26,1,1) = {"
Cm
Cm
Cm
Cm
Cm
Cm
ye
SL
SL
Os
Os
Os
Os
dy
zq
ZU
Os
Os
LP
Os
SL
SL
ye
Cm
Cm
Cm
Cm
Cm
Cm
"}
(27,1,1) = {"
Cm
Cm
Cm
Cm
Cm
Cm
Cm
ye
SL
pK
Os
Os
Os
Os
cH
LP
Os
Os
Os
pK
SL
ye
Cm
Cm
Cm
Cm
Cm
Cm
Cm
"}
(28,1,1) = {"
Cm
Cm
Cm
Cm
Cm
Cm
Cm
Cm
UL
UL
An
OH
Os
Os
Os
Os
Os
rp
pK
UL
UL
Cm
Cm
Cm
Cm
Cm
Cm
Cm
Cm
"}
(29,1,1) = {"
Cm
Cm
Cm
Cm
Cm
Cm
Cm
Cm
Cm
UL
UL
pK
LP
Os
OH
LP
Os
fV
UL
UL
Cm
Cm
Cm
Cm
Cm
Cm
Cm
Cm
Cm
"}
(30,1,1) = {"
Cm
Cm
Cm
Cm
Cm
Cm
Cm
Cm
Cm
uQ
UL
UL
fV
pJ
pK
pJ
An
UL
UL
uQ
Cm
Cm
Cm
Cm
Cm
Cm
Cm
Cm
Cm
"}
(31,1,1) = {"
Cm
Cm
Cm
Cm
Cm
Cm
Cm
Cm
Cm
Cm
ye
UL
SL
SL
SL
SL
SL
UL
ye
Cm
Cm
Cm
Cm
Cm
Cm
Cm
Cm
Cm
Cm
"}
(32,1,1) = {"
Cm
Cm
Cm
Cm
Cm
Cm
Cm
Cm
Cm
Cm
Cm
Cm
Cm
Cm
Cm
Cm
Cm
Cm
Cm
Cm
Cm
Cm
Cm
Cm
Cm
Cm
Cm
Cm
Cm
"}
(33,1,1) = {"
Cm
Cm
Cm
Cm
Cm
Cm
Cm
Cm
Cm
Cm
Cm
Cm
Cm
Cm
Cm
Cm
Cm
Cm
Cm
Cm
Cm
Cm
Cm
Cm
Cm
Cm
Cm
Cm
Cm
"}
