//MAP CONVERTED BY dmm2tgm.py THIS HEADER COMMENT PREVENTS RECONVERSION, DO NOT REMOVE
"aG" = (
/obj/structure/cable{
	d1 = 2;
	d2 = 8;
	icon_state = "2-8"
	},
/turf/simulated/floor/plating,
/area/submap/plontden)
"bB" = (
/obj/structure/bed/padded,
/obj/item/bedsheet/cosmos,
/obj/item/toy/plushie/red_fox,
/turf/simulated/floor/tiled/yellow,
/area/submap/plontden)
"cN" = (
/obj/structure/table/sifwoodentable,
/obj/item/gun/energy/xray/xenoarch,
/turf/simulated/floor/tiled/yellow,
/area/submap/plontden)
"dT" = (
/obj/structure/sink/kitchen{
	pixel_y = 28
	},
/obj/item/reagent_containers/glass/bucket,
/obj/item/reagent_containers/glass/bucket,
/turf/simulated/floor/tiled/white,
/area/submap/plontden)
"eF" = (
/obj/structure/grille,
/obj/structure/window/basic,
/obj/structure/window/basic{
	dir = 4
	},
/obj/structure/window/basic{
	dir = 1
	},
/turf/simulated/floor/plating,
/area/submap/plontden)
"fg" = (
/obj/structure/grille,
/obj/structure/window/basic,
/obj/structure/window/basic{
	dir = 8
	},
/obj/structure/window/basic{
	dir = 1
	},
/obj/structure/window/basic{
	dir = 4
	},
/turf/simulated/floor/plating,
/area/submap/plontden)
"gA" = (
/obj/machinery/light,
/obj/structure/cable{
	d1 = 4;
	d2 = 8;
	icon_state = "4-8"
	},
/turf/simulated/floor/tiled/white,
/area/submap/plontden)
"gD" = (
/turf/simulated/floor/tiled/yellow,
/area/submap/plontden)
"gH" = (
/obj/structure/grille,
/obj/structure/window/basic,
/obj/structure/window/basic{
	dir = 8
	},
/obj/structure/window/basic{
	dir = 1
	},
/turf/simulated/floor/plating,
/area/submap/plontden)
"hS" = (
/obj/machinery/seed_extractor,
/turf/simulated/floor/tiled/white,
/area/submap/plontden)
"im" = (
/obj/structure/grille,
/obj/structure/window/basic,
/obj/structure/window/basic{
	dir = 8
	},
/obj/structure/window/basic{
	dir = 4
	},
/obj/structure/window/basic{
	dir = 1
	},
/turf/simulated/floor/plating,
/area/submap/plontden)
"iS" = (
/obj/structure/cable{
	d1 = 2;
	d2 = 8;
	icon_state = "2-8"
	},
/turf/simulated/floor/tiled/white,
/area/submap/plontden)
"iU" = (
/turf/simulated/wall/r_wall,
/area/submap/plontden)
"jf" = (
/obj/machinery/smartfridge/drying_rack,
/turf/simulated/floor/tiled/white,
/area/submap/plontden)
"jt" = (
/obj/machinery/light,
/turf/simulated/floor/tiled/hydro,
/area/submap/plontden)
"kp" = (
/obj/structure/cable{
	d1 = 4;
	d2 = 8;
	icon_state = "4-8"
	},
/turf/simulated/floor/tiled/white,
/area/submap/plontden)
"ln" = (
/obj/effect/floor_decal/borderfloorwhite,
/obj/effect/floor_decal/corner/green/border,
/obj/structure/cable{
	d1 = 1;
	d2 = 2;
	icon_state = "1-2"
	},
/turf/simulated/floor/tiled/white,
/area/submap/plontden)
"lL" = (
/obj/structure/closet/crate/hydroponics/exotic,
/turf/simulated/floor/tiled/white,
/area/submap/plontden)
"mt" = (
/obj/machinery/portable_atmospherics/hydroponics,
/obj/machinery/light{
	dir = 1
	},
/obj/effect/floor_decal/industrial/hatch,
/turf/simulated/floor/tiled/white,
/area/submap/plontden)
"mw" = (
/obj/machinery/chemical_dispenser/xenoflora,
/turf/simulated/floor/tiled/white,
/area/submap/plontden)
"mH" = (
/turf/simulated/floor/tiled/white,
/area/submap/plontden)
"mO" = (
/obj/machinery/botany/editor,
/turf/simulated/floor/tiled/white,
/area/submap/plontden)
"od" = (
/turf/simulated/floor/tiled/hydro,
/area/submap/plontden)
"oI" = (
/obj/effect/floor_decal/steeldecal/steel_decals4,
/obj/effect/floor_decal/steeldecal/steel_decals4{
	dir = 10
	},
/obj/structure/cable{
	d1 = 4;
	d2 = 8;
	icon_state = "4-8"
	},
/turf/simulated/floor/tiled/hydro,
/area/submap/plontden)
"oO" = (
/turf/simulated/floor/plating,
/area/submap/plontden)
"pA" = (
/obj/effect/floor_decal/corner/green/border{
	dir = 8
	},
/obj/effect/floor_decal/borderfloorwhite{
	dir = 8
	},
/obj/effect/floor_decal/corner/green/border{
	dir = 8
	},
/turf/simulated/floor/tiled/white,
/area/submap/plontden)
"rH" = (
/turf/simulated/floor/water/indoors,
/area/submap/plontden)
"ur" = (
/turf/template_noop,
/area/template_noop)
"vg" = (
/obj/structure/table/sifwoodentable,
/obj/item/flame/candle/everburn,
/turf/simulated/floor/tiled/yellow,
/area/submap/plontden)
"vj" = (
/obj/structure/cable{
	d1 = 1;
	d2 = 4;
	icon_state = "1-4"
	},
/turf/simulated/floor/plating,
/area/submap/plontden)
"vl" = (
/obj/structure/cable{
	d1 = 2;
	d2 = 4;
	icon_state = "2-4"
	},
/turf/simulated/floor/tiled/white,
/area/submap/plontden)
"vy" = (
/obj/structure/closet/crate/hydroponics/prespawned,
/obj/effect/floor_decal/borderfloorwhite{
	dir = 8
	},
/obj/effect/floor_decal/corner/green/border{
	dir = 8
	},
/turf/simulated/floor/tiled/white,
/area/submap/plontden)
"wG" = (
/obj/effect/floor_decal/industrial/hatch,
/obj/machinery/portable_atmospherics/hydroponics,
/turf/simulated/floor/tiled/white,
/area/submap/plontden)
"xh" = (
/obj/machinery/light{
	dir = 4;
	icon_state = "tube1";
	pixel_x = 0
	},
/turf/simulated/floor/tiled/hydro,
/area/submap/plontden)
"Aj" = (
/obj/machinery/power/port_gen/pacman,
/obj/structure/cable/cyan{
	d2 = 2;
	icon_state = "0-2"
	},
/turf/simulated/floor/plating,
/area/submap/plontden)
"BG" = (
/obj/machinery/power/apc{
	name = "south bump";
	pixel_y = -24
	},
/obj/effect/floor_decal/borderfloorwhite{
	dir = 4
	},
/obj/effect/floor_decal/corner/green/border{
	dir = 4
	},
/obj/machinery/light_switch{
	pixel_x = 11;
	pixel_y = -24
	},
/obj/machinery/chem_master,
/obj/structure/cable,
/turf/simulated/floor/tiled/white,
/area/submap/plontden)
"Cc" = (
/obj/machinery/power/smes/buildable/point_of_interest,
/turf/simulated/floor/plating,
/area/submap/plontden)
"Cd" = (
/obj/machinery/seed_storage/xenobotany{
	dir = 1
	},
/obj/machinery/camera/network/research{
	c_tag = "SCI - Xenoflora Starboard";
	dir = 1
	},
/turf/simulated/floor/tiled/white,
/area/submap/plontden)
"Cp" = (
/obj/effect/floor_decal/borderfloorwhite,
/obj/effect/floor_decal/corner/green/border,
/turf/simulated/floor/tiled/white,
/area/submap/plontden)
"CQ" = (
/obj/machinery/light{
	dir = 1
	},
/obj/effect/floor_decal/industrial/outline/yellow,
/obj/structure/table/marble,
/obj/machinery/reagentgrinder,
/turf/simulated/floor/tiled/white,
/area/submap/plontden)
"Dp" = (
/obj/structure/cable{
	d1 = 1;
	d2 = 2;
	icon_state = "1-2"
	},
/turf/simulated/floor/tiled/hydro,
/area/submap/plontden)
"Er" = (
/obj/machinery/light{
	dir = 8;
	icon_state = "tube1"
	},
/turf/simulated/floor/tiled/hydro,
/area/submap/plontden)
"HB" = (
/obj/structure/closet/cabinet,
/obj/random/contraband/nofail,
/obj/random/contraband/nofail,
/obj/random/contraband/nofail,
/turf/simulated/floor/tiled/yellow,
/area/submap/plontden)
"HD" = (
/mob/living/carbon/human/ai_controlled/replicant,
/turf/simulated/floor/tiled/white,
/area/submap/plontden)
"JI" = (
/obj/structure/table/sifwoodentable,
/obj/random/medical,
/turf/simulated/floor/tiled/yellow,
/area/submap/plontden)
"Ke" = (
/obj/effect/floor_decal/borderfloorwhite,
/obj/effect/floor_decal/corner/green/border,
/obj/machinery/light{
	dir = 8;
	icon_state = "tube1"
	},
/turf/simulated/floor/tiled/white,
/area/submap/plontden)
"KI" = (
/obj/machinery/door/airlock/glass_research{
	req_one_access = null
	},
/turf/simulated/floor/tiled/steel_grid,
/area/submap/plontden)
"Li" = (
/obj/effect/floor_decal/borderfloorwhite{
	dir = 1
	},
/obj/effect/floor_decal/corner/green/border{
	dir = 1
	},
/turf/simulated/floor/tiled/white,
/area/submap/plontden)
"LV" = (
/obj/effect/floor_decal/borderfloorwhite,
/obj/effect/floor_decal/corner/green/border,
/obj/machinery/light{
	dir = 4;
	icon_state = "tube1";
	pixel_x = 0
	},
/turf/simulated/floor/tiled/white,
/area/submap/plontden)
"Mo" = (
/obj/structure/cable{
	d1 = 4;
	d2 = 8;
	icon_state = "4-8"
	},
/turf/simulated/floor/tiled/hydro,
/area/submap/plontden)
"On" = (
/obj/structure/table/sifwoodentable,
/obj/random/medical/pillbottle,
/turf/simulated/floor/tiled/yellow,
/area/submap/plontden)
"OR" = (
/obj/structure/table/glass,
/obj/item/material/minihoe,
/obj/item/material/minihoe,
/obj/item/material/knife/machete/hatchet,
/obj/item/material/knife/machete/hatchet,
/obj/item/analyzer/plant_analyzer,
/turf/simulated/floor/tiled/white,
/area/submap/plontden)
"Pd" = (
/obj/machinery/atmospherics/pipe/simple/hidden/yellow{
	dir = 4
	},
/obj/structure/cable/green{
	d1 = 4;
	d2 = 8;
	icon_state = "4-8"
	},
/obj/structure/cable{
	d1 = 4;
	d2 = 8;
	icon_state = "4-8"
	},
/obj/machinery/door/airlock/glass_research{
	req_one_access = null
	},
/turf/simulated/floor/tiled/steel_grid,
/area/submap/plontden)
"Ps" = (
/obj/structure/grille,
/obj/structure/window/basic{
	dir = 8
	},
/obj/structure/window/basic,
/obj/structure/window/basic{
	dir = 1
	},
/turf/simulated/floor/plating,
/area/submap/plontden)
"Qm" = (
/obj/machinery/power/terminal,
/obj/structure/cable{
	d2 = 8;
	icon_state = "0-8"
	},
/obj/structure/cable/cyan,
/turf/simulated/floor/plating,
/area/submap/plontden)
"Rs" = (
/obj/structure/cable{
	d1 = 2;
	d2 = 4;
	dir = 4;
	icon_state = "2-4"
	},
/turf/simulated/floor/tiled/hydro,
/area/submap/plontden)
"Rw" = (
/obj/machinery/light,
/obj/effect/floor_decal/industrial/hatch,
/obj/machinery/portable_atmospherics/hydroponics,
/turf/simulated/floor/tiled/white,
/area/submap/plontden)
"RD" = (
/obj/effect/floor_decal/steeldecal/steel_decals4{
	dir = 8
	},
/obj/effect/floor_decal/steeldecal/steel_decals4{
	dir = 5
	},
/turf/simulated/floor/tiled/hydro,
/area/submap/plontden)
"RJ" = (
/obj/structure/cable{
	d1 = 1;
	d2 = 2;
	icon_state = "1-2"
	},
/obj/effect/floor_decal/corner/green/border{
	dir = 4
	},
/obj/effect/floor_decal/borderfloorwhite{
	dir = 4
	},
/obj/effect/floor_decal/corner/green/border{
	dir = 4
	},
/turf/simulated/floor/tiled/white,
/area/submap/plontden)
"Sq" = (
/obj/machinery/vending/hydronutrients{
	categories = 3;
	dir = 1
	},
/turf/simulated/floor/tiled/white,
/area/submap/plontden)
"SH" = (
/obj/machinery/botany/extractor,
/turf/simulated/floor/tiled/white,
/area/submap/plontden)
"Te" = (
/obj/machinery/light{
	dir = 1
	},
/turf/simulated/floor/tiled/hydro,
/area/submap/plontden)
"UL" = (
/obj/structure/grille,
/obj/structure/window/basic,
/obj/structure/window/basic{
	dir = 1
	},
/turf/simulated/floor/plating,
/area/submap/plontden)
"VY" = (
/obj/machinery/portable_atmospherics/hydroponics,
/obj/effect/floor_decal/industrial/hatch,
/turf/simulated/floor/tiled/white,
/area/submap/plontden)
"Wb" = (
/obj/structure/cable{
	d1 = 1;
	d2 = 2;
	icon_state = "1-2"
	},
/obj/effect/floor_decal/borderfloorwhite{
	dir = 5
	},
/obj/effect/floor_decal/corner/green/border{
	dir = 5
	},
/turf/simulated/floor/tiled/white,
/area/submap/plontden)
"WF" = (
/obj/effect/floor_decal/steeldecal/steel_decals4{
	dir = 1
	},
/obj/effect/floor_decal/steeldecal/steel_decals4{
	dir = 6
	},
/turf/simulated/floor/tiled/hydro,
/area/submap/plontden)
"Xb" = (
/obj/machinery/light,
/obj/machinery/biogenerator,
/turf/simulated/floor/tiled/white,
/area/submap/plontden)
"Zb" = (
/obj/effect/floor_decal/borderfloorwhite{
	dir = 9
	},
/obj/effect/floor_decal/corner/green/border{
	dir = 9
	},
/turf/simulated/floor/tiled/white,
/area/submap/plontden)

(1,1,1) = {"
ur
ur
ur
ur
ur
ur
ur
ur
ur
ur
ur
ur
ur
ur
ur
ur
ur
ur
"}
(2,1,1) = {"
ur
ur
ur
ur
ur
ur
iU
iU
iU
iU
iU
iU
ur
ur
ur
ur
ur
ur
"}
(3,1,1) = {"
ur
ur
ur
ur
ur
ur
iU
cN
gD
gD
HB
iU
ur
ur
ur
ur
ur
ur
"}
(4,1,1) = {"
ur
ur
ur
ur
ur
ur
iU
JI
gD
gD
vg
iU
ur
ur
ur
ur
ur
ur
"}
(5,1,1) = {"
ur
ur
ur
ur
ur
ur
iU
On
gD
gD
bB
iU
ur
ur
ur
ur
ur
ur
"}
(6,1,1) = {"
ur
ur
ur
ur
ur
iU
iU
im
KI
im
iU
iU
iU
ur
ur
ur
ur
ur
"}
(7,1,1) = {"
ur
ur
ur
ur
iU
iU
lL
Cp
WF
od
Li
mO
iU
iU
ur
ur
ur
ur
"}
(8,1,1) = {"
ur
ur
ur
ur
gH
jf
mH
Cp
od
od
Li
mH
SH
gH
ur
ur
ur
ur
"}
(9,1,1) = {"
ur
ur
ur
ur
UL
mt
mH
Cp
od
od
Li
mH
Xb
UL
ur
ur
ur
ur
"}
(10,1,1) = {"
ur
ur
ur
ur
eF
VY
HD
Cp
od
od
Li
HD
hS
eF
ur
ur
ur
ur
"}
(11,1,1) = {"
ur
ur
ur
ur
iU
VY
mH
Cp
od
od
Li
mH
mw
iU
ur
ur
ur
ur
"}
(12,1,1) = {"
ur
ur
ur
iU
iU
VY
vl
ln
Dp
Dp
Wb
RJ
BG
iU
iU
ur
ur
ur
"}
(13,1,1) = {"
ur
ur
ur
gH
VY
mH
kp
LV
rH
rH
xh
RD
od
od
KI
ur
ur
ur
"}
(14,1,1) = {"
ur
ur
ur
UL
CQ
HD
gA
iU
rH
rH
iU
Te
od
jt
fg
ur
ur
ur
"}
(15,1,1) = {"
ur
ur
ur
eF
VY
mH
kp
Ke
rH
rH
Er
RD
od
od
KI
ur
ur
ur
"}
(16,1,1) = {"
ur
ur
ur
iU
iU
VY
iS
ln
Rs
od
Zb
pA
vy
iU
iU
ur
ur
ur
"}
(17,1,1) = {"
ur
ur
ur
ur
iU
VY
mH
Cp
Mo
od
Li
mH
Sq
iU
ur
ur
ur
ur
"}
(18,1,1) = {"
ur
ur
ur
ur
gH
VY
HD
Cp
Mo
od
Li
HD
Cd
Ps
ur
ur
ur
ur
"}
(19,1,1) = {"
ur
ur
ur
ur
UL
mt
mH
Cp
Mo
od
Li
mH
Rw
UL
ur
ur
ur
ur
"}
(20,1,1) = {"
ur
ur
ur
ur
eF
OR
mH
Cp
Mo
od
Li
mH
wG
eF
ur
ur
ur
ur
"}
(21,1,1) = {"
ur
ur
ur
ur
iU
iU
dT
Cp
oI
od
Li
wG
iU
iU
ur
ur
ur
ur
"}
(22,1,1) = {"
ur
ur
ur
ur
ur
iU
iU
iU
Pd
im
iU
iU
iU
ur
ur
ur
ur
ur
"}
(23,1,1) = {"
ur
ur
ur
ur
ur
ur
ur
iU
aG
vj
oO
iU
ur
ur
ur
ur
ur
ur
"}
(24,1,1) = {"
ur
ur
ur
ur
ur
ur
ur
iU
Aj
Qm
Cc
iU
ur
ur
ur
ur
ur
ur
"}
(25,1,1) = {"
ur
ur
ur
ur
ur
ur
ur
iU
iU
iU
iU
iU
ur
ur
ur
ur
ur
ur
"}
(26,1,1) = {"
ur
ur
ur
ur
ur
ur
ur
ur
ur
ur
ur
ur
ur
ur
ur
ur
ur
ur
"}
