//MAP CONVERTED BY dmm2tgm.py THIS HEADER COMMENT PREVENTS RECONVERSION, DO NOT REMOVE
"a" = (
/turf/simulated/floor/outdoors/ice{
	oxygen = 21.8366;
	nitrogen = 82.1472;
	temperature = 293.15
	},
/area/submap/puzzledungeon)
"d" = (
/obj/structure/table/darkglass,
/obj/item/clothing/suit/armor/pcarrier/laserproof/full,
/obj/item/archaeological_find,
/obj/item/archaeological_find,
/obj/item/archaeological_find,
/turf/simulated/floor/dungeon,
/area/submap/puzzledungeon)
"g" = (
/obj/structure/simple_door/cult,
/turf/simulated/floor/dungeon,
/area/submap/puzzledungeon)
"h" = (
/turf/simulated/floor/lava,
/area/submap/puzzledungeon)
"j" = (
/turf/simulated/floor/lava/harmless,
/area/submap/puzzledungeon)
"k" = (
/obj/machinery/crystal/ice,
/turf/simulated/floor/outdoors/ice{
	oxygen = 21.8366;
	nitrogen = 82.1472;
	temperature = 293.15
	},
/area/submap/puzzledungeon)
"l" = (
/obj/structure/table/darkglass,
/obj/item/clothing/suit/armor/pcarrier/bulletproof/full,
/obj/item/archaeological_find,
/obj/item/archaeological_find,
/obj/item/archaeological_find,
/turf/simulated/floor/dungeon,
/area/submap/puzzledungeon)
"s" = (
/turf/simulated/mineral/floor/ignore_mapgen/sif,
/area/submap/puzzledungeon)
"t" = (
/turf/template_noop,
/area/template_noop)
"v" = (
/turf/simulated/floor/cult,
/area/submap/puzzledungeon)
"w" = (
/obj/structure/table/darkglass,
/obj/item/archaeological_find,
/obj/item/archaeological_find,
/obj/item/archaeological_find,
/turf/simulated/floor/dungeon,
/area/submap/puzzledungeon)
"z" = (
/turf/simulated/wall/dungeon,
/area/submap/puzzledungeon)
"F" = (
/obj/random/landmine,
/turf/simulated/floor/dungeon,
/area/submap/puzzledungeon)
"S" = (
/turf/simulated/floor/dungeon,
/area/submap/puzzledungeon)

(1,1,1) = {"
t
t
t
t
t
t
t
t
t
t
t
t
t
t
t
t
t
t
t
t
t
t
t
t
t
t
t
t
t
t
"}
(2,1,1) = {"
t
t
t
t
t
t
t
t
t
t
t
t
t
t
t
t
t
t
t
t
t
t
t
t
t
t
t
t
t
t
"}
(3,1,1) = {"
t
t
t
t
t
t
t
t
t
t
t
t
t
t
t
t
t
t
t
t
t
t
t
t
t
t
t
t
t
t
"}
(4,1,1) = {"
t
t
t
z
z
z
z
z
z
z
z
z
z
z
z
z
z
z
z
z
z
z
t
t
t
t
t
t
t
t
"}
(5,1,1) = {"
t
t
t
z
a
a
a
k
a
a
a
z
S
S
S
j
j
S
S
S
z
s
t
t
t
t
t
t
t
t
"}
(6,1,1) = {"
t
t
t
z
a
a
a
a
a
a
S
z
v
v
v
h
h
v
v
v
z
s
s
t
t
t
t
t
t
t
"}
(7,1,1) = {"
t
t
t
z
k
a
a
a
a
S
S
S
S
S
S
j
j
S
S
S
g
s
s
t
t
t
t
t
t
t
"}
(8,1,1) = {"
t
t
t
z
a
a
a
a
a
S
S
S
S
S
S
j
j
S
S
S
g
s
s
t
t
t
t
t
t
t
"}
(9,1,1) = {"
t
t
t
z
a
a
k
a
a
a
S
z
v
v
v
h
h
v
v
v
z
s
s
t
t
t
t
t
t
t
"}
(10,1,1) = {"
t
t
t
z
a
a
a
a
a
a
a
z
S
S
S
j
j
S
S
S
z
s
t
t
t
t
t
t
t
t
"}
(11,1,1) = {"
t
t
t
z
k
a
a
a
a
k
a
z
z
z
z
z
z
z
z
z
z
z
z
z
z
z
t
t
t
t
"}
(12,1,1) = {"
t
t
t
z
a
a
a
a
a
a
a
z
S
d
w
S
z
a
a
k
a
a
a
a
a
z
t
t
t
t
"}
(13,1,1) = {"
t
t
t
z
a
a
a
a
a
a
k
z
S
S
S
S
z
k
a
a
a
a
a
a
k
z
t
t
t
t
"}
(14,1,1) = {"
t
t
t
z
a
k
a
a
a
k
S
z
z
F
F
z
z
S
k
a
a
k
a
a
a
z
t
t
t
t
"}
(15,1,1) = {"
t
t
t
z
a
a
a
a
k
S
S
S
S
F
F
S
S
S
S
a
a
a
a
a
a
z
t
t
t
t
"}
(16,1,1) = {"
t
t
t
z
a
a
k
a
a
S
S
S
S
F
F
S
S
S
S
a
a
a
a
k
a
z
t
t
t
t
"}
(17,1,1) = {"
t
t
t
z
a
a
a
a
a
k
S
z
z
F
F
z
z
S
k
a
a
a
a
a
a
z
t
t
t
t
"}
(18,1,1) = {"
t
t
t
z
a
k
a
a
a
a
k
z
S
S
S
S
z
k
a
a
a
a
k
a
a
z
t
t
t
t
"}
(19,1,1) = {"
t
t
t
z
a
a
a
k
a
a
a
z
S
w
l
S
z
a
a
a
a
a
a
a
a
z
t
t
t
t
"}
(20,1,1) = {"
t
t
t
z
z
z
z
z
z
z
z
z
z
z
z
z
z
a
a
a
k
a
a
a
a
z
t
t
t
t
"}
(21,1,1) = {"
t
t
t
t
t
t
s
z
v
v
v
h
h
v
v
v
z
a
k
a
a
a
a
a
a
z
t
t
t
t
"}
(22,1,1) = {"
t
t
t
t
t
t
s
z
S
S
S
j
j
S
S
S
z
S
a
a
a
a
a
a
k
z
t
t
t
t
"}
(23,1,1) = {"
t
t
t
t
t
s
s
g
v
v
v
h
h
v
v
v
S
S
S
a
a
a
a
a
a
z
t
t
t
t
"}
(24,1,1) = {"
t
t
t
t
t
s
s
g
S
S
S
j
j
S
S
S
S
S
S
a
a
a
a
k
a
z
t
t
t
t
"}
(25,1,1) = {"
t
t
t
t
t
t
s
z
v
v
v
h
h
v
v
v
z
S
a
a
a
a
a
a
a
z
t
t
t
t
"}
(26,1,1) = {"
t
t
t
t
t
t
s
z
S
S
S
j
j
S
S
S
z
a
a
a
k
a
a
a
a
z
t
t
t
t
"}
(27,1,1) = {"
t
t
t
t
t
t
z
z
z
z
z
z
z
z
z
z
z
z
z
z
z
z
z
z
z
z
t
t
t
t
"}
(28,1,1) = {"
t
t
t
t
t
t
t
t
t
t
t
t
t
t
t
t
t
t
t
t
t
t
t
t
t
t
t
t
t
t
"}
(29,1,1) = {"
t
t
t
t
t
t
t
t
t
t
t
t
t
t
t
t
t
t
t
t
t
t
t
t
t
t
t
t
t
t
"}
(30,1,1) = {"
t
t
t
t
t
t
t
t
t
t
t
t
t
t
t
t
t
t
t
t
t
t
t
t
t
t
t
t
t
t
"}
