//MAP CONVERTED BY dmm2tgm.py THIS HEADER COMMENT PREVENTS RECONVERSION, DO NOT REMOVE
"ay" = (
/obj/structure/simple_door/wood,
/turf/simulated/floor/carpet/blue2,
/area/submap/settlement)
"aT" = (
/obj/effect/floor_decal/corner/lime/bordercorner{
	dir = 8
	},
/turf/simulated/floor/tiled/white,
/area/submap/settlement)
"bh" = (
/obj/structure/table/standard,
/obj/random/medical/pillbottle,
/turf/simulated/floor/tiled/white,
/area/submap/settlement)
"bn" = (
/obj/effect/floor_decal/corner/lime/border{
	dir = 8
	},
/turf/simulated/floor/tiled/white,
/area/submap/settlement)
"bp" = (
/obj/random/multiple/corp_crate,
/turf/simulated/floor/lino,
/area/submap/settlement)
"bI" = (
/obj/effect/floor_decal/corner/red/diagonal,
/mob/living/simple_mob/construct/artificer/caster,
/turf/simulated/floor/tiled/red,
/area/submap/settlement)
"cD" = (
/obj/effect/floor_decal/corner/lime/bordercorner{
	dir = 1
	},
/turf/simulated/floor/tiled/white,
/area/submap/settlement)
"cI" = (
/obj/structure/closet/cabinet,
/obj/random/maintenance/morestuff,
/turf/simulated/floor/carpet/blue2,
/area/submap/settlement)
"cY" = (
/obj/structure/closet/secure_closet/freezer/fridge,
/obj/item/storage/fancy/egg_box,
/obj/item/storage/fancy/egg_box,
/obj/item/reagent_containers/food/drinks/bottle/milk,
/obj/item/reagent_containers/food/drinks/bottle/milk,
/obj/item/reagent_containers/food/drinks/bottle/milk,
/obj/item/reagent_containers/food/drinks/bottle/cream,
/obj/item/reagent_containers/food/drinks/bottle/cream,
/obj/item/reagent_containers/food/drinks/bottle/cream,
/obj/item/reagent_containers/food/drinks/bottle/cream,
/obj/item/reagent_containers/food/condiment/carton/sugar,
/obj/effect/floor_decal/corner/lime/border{
	dir = 1
	},
/obj/item/reagent_containers/chem_disp_cartridge/spaceup,
/obj/item/reagent_containers/chem_disp_cartridge/goldschlager,
/turf/simulated/floor/tiled/white,
/area/submap/settlement)
"dE" = (
/turf/simulated/floor/tiled/freezer,
/area/submap/settlement)
"en" = (
/obj/effect/floor_decal/corner/lime/border{
	dir = 4
	},
/turf/simulated/floor/tiled/white,
/area/submap/settlement)
"eB" = (
/mob/living/simple_mob/construct/artificer/caster,
/turf/simulated/floor/outdoors/mud,
/area/submap/settlement)
"eI" = (
/mob/living/simple_mob/construct/shade,
/turf/simulated/floor/outdoors/dirt,
/area/submap/settlement)
"eJ" = (
/obj/structure/closet/crate/freezer,
/obj/random/meat,
/obj/random/meat,
/obj/random/meat,
/obj/random/meat,
/obj/random/meat,
/obj/random/meat,
/obj/random/meat,
/turf/simulated/floor/tiled/freezer,
/area/submap/settlement)
"eK" = (
/obj/structure/simple_door/wood,
/turf/simulated/floor/tiled/white,
/area/submap/settlement)
"fl" = (
/obj/structure/table/standard,
/obj/effect/floor_decal/corner/lime/border{
	dir = 1
	},
/turf/simulated/floor/tiled/white,
/area/submap/settlement)
"ft" = (
/obj/structure/table/standard,
/obj/item/material/knife/butch,
/obj/effect/floor_decal/corner/lime/border,
/turf/simulated/floor/tiled/white,
/area/submap/settlement)
"fU" = (
/obj/structure/table/standard,
/obj/random/maintenance/foodstuff,
/obj/effect/floor_decal/corner/orange/diagonal,
/obj/random/multiple/gun/projectile,
/turf/simulated/floor/tiled/white,
/area/submap/settlement)
"gf" = (
/obj/effect/floor_decal/corner/lime/border{
	dir = 8
	},
/obj/effect/floor_decal/corner/lime/border{
	dir = 8
	},
/turf/simulated/floor/tiled/white,
/area/submap/settlement)
"gl" = (
/obj/effect/floor_decal/corner/red/diagonal,
/obj/structure/table/rack,
/obj/random/cash,
/obj/random/cash,
/turf/simulated/floor/tiled/red,
/area/submap/settlement)
"gz" = (
/mob/living/simple_mob/construct/juggernaut,
/turf/simulated/floor/cult,
/area/submap/settlement)
"gC" = (
/obj/structure/fence,
/turf/simulated/floor/outdoors/mud,
/area/submap/settlement)
"hh" = (
/obj/machinery/light{
	dir = 1
	},
/obj/effect/floor_decal/corner/white/diagonal,
/turf/simulated/floor/tiled/white,
/area/submap/settlement)
"ht" = (
/obj/structure/fence{
	dir = 8
	},
/turf/simulated/floor/outdoors/mud,
/area/submap/settlement)
"hy" = (
/obj/effect/floor_decal/corner/red/diagonal,
/obj/structure/table/rack,
/obj/random/cash,
/turf/simulated/floor/tiled/red,
/area/submap/settlement)
"hV" = (
/obj/structure/closet/grave,
/turf/simulated/floor/outdoors/mud,
/area/submap/settlement)
"il" = (
/obj/machinery/light{
	layer = 3
	},
/obj/random/multiple/large_corp_crate,
/turf/simulated/floor/lino,
/area/submap/settlement)
"im" = (
/obj/structure/table/woodentable,
/obj/random/energy/sec,
/turf/simulated/floor/lino,
/area/submap/settlement)
"it" = (
/obj/structure/cult/pylon,
/turf/simulated/floor/cult,
/area/submap/settlement)
"iV" = (
/obj/machinery/light{
	layer = 3
	},
/obj/effect/floor_decal/corner/orange/diagonal,
/turf/simulated/floor/tiled/white,
/area/submap/settlement)
"jb" = (
/obj/machinery/gibber,
/obj/machinery/light/small{
	dir = 1
	},
/turf/simulated/floor/tiled/freezer,
/area/submap/settlement)
"jo" = (
/obj/structure/bed/chair/office/light,
/mob/living/simple_mob/construct/wraith,
/turf/simulated/floor/lino,
/area/submap/settlement)
"jx" = (
/obj/structure/windoor_assembly{
	dir = 8
	},
/obj/effect/floor_decal/corner/red/diagonal,
/turf/simulated/floor/tiled/red,
/area/submap/settlement)
"jZ" = (
/obj/item/stool/padded,
/obj/effect/floor_decal/corner/orange/diagonal,
/turf/simulated/floor/tiled/white,
/area/submap/settlement)
"kg" = (
/mob/living/simple_mob/humanoid/cultist/magus{
	loot_list = list(/obj/item/gun/energy/imperial = 40)
	},
/turf/simulated/floor/cult,
/area/submap/settlement)
"km" = (
/obj/structure/table/standard,
/obj/machinery/microwave,
/obj/effect/floor_decal/corner/lime/border{
	dir = 10
	},
/turf/simulated/floor/tiled/white,
/area/submap/settlement)
"kM" = (
/turf/simulated/floor/cult,
/area/submap/settlement)
"kT" = (
/obj/structure/fence/corner{
	dir = 9
	},
/turf/simulated/floor/outdoors/mud,
/area/submap/settlement)
"le" = (
/mob/living/simple_mob/construct/juggernaut,
/turf/simulated/floor/carpet/blue2,
/area/submap/settlement)
"ls" = (
/obj/structure/largecrate/animal/teppi,
/obj/effect/floor_decal/corner/white/diagonal,
/turf/simulated/floor/tiled/white,
/area/submap/settlement)
"lt" = (
/obj/effect/floor_decal/corner/orange/diagonal,
/turf/simulated/floor/tiled/white,
/area/submap/settlement)
"lz" = (
/obj/structure/table/standard,
/obj/item/material/knife/butch,
/obj/effect/floor_decal/corner/lime/border{
	dir = 9
	},
/turf/simulated/floor/tiled/white,
/area/submap/settlement)
"lO" = (
/turf/simulated/floor/wood{
	nitrogen = 93.7835;
	oxygen = 20.7263;
	temperature = 243.15
	},
/area/submap/settlement)
"lX" = (
/obj/structure/simple_door/wood,
/obj/effect/floor_decal/corner/paleblue/diagonal,
/turf/simulated/floor/tiled/white,
/area/submap/settlement)
"nN" = (
/turf/simulated/floor/lino,
/area/submap/settlement)
"oa" = (
/obj/effect/floor_decal/corner/red/diagonal,
/obj/structure/table/rack,
/obj/random/rigsuit/chancetofail,
/obj/random/cash,
/obj/random/cash,
/turf/simulated/floor/tiled/red,
/area/submap/settlement)
"oq" = (
/obj/effect/floor_decal/corner/white/diagonal,
/turf/simulated/floor/tiled/white,
/area/submap/settlement)
"oS" = (
/obj/structure/largecrate/animal/cow,
/obj/effect/floor_decal/corner/white/diagonal,
/turf/simulated/floor/tiled/white,
/area/submap/settlement)
"pn" = (
/obj/structure/simple_door/cult,
/turf/simulated/floor/cult,
/area/submap/settlement)
"pR" = (
/turf/simulated/floor/outdoors/mud,
/area/submap/settlement)
"pV" = (
/turf/simulated/floor/outdoors/grass/sif/forest/planetuse,
/area/template_noop)
"qa" = (
/obj/structure/table/standard,
/obj/item/material/kitchen/rollingpin,
/obj/effect/floor_decal/corner/lime/border{
	dir = 6
	},
/turf/simulated/floor/tiled/white,
/area/submap/settlement)
"qv" = (
/obj/structure/table/fancyblack,
/obj/item/soulstone,
/obj/random/material/precious,
/turf/simulated/floor/cult,
/area/submap/settlement)
"rh" = (
/obj/structure/window/reinforced/full,
/turf/simulated/floor/tiled/white,
/area/submap/settlement)
"rs" = (
/obj/structure/kitchenspike,
/obj/effect/floor_decal/corner/white/diagonal,
/turf/simulated/floor/tiled/white,
/area/submap/settlement)
"rA" = (
/obj/machinery/light{
	dir = 4
	},
/obj/effect/floor_decal/corner/lime/border{
	dir = 4
	},
/turf/simulated/floor/tiled/white,
/area/submap/settlement)
"rW" = (
/turf/simulated/wall/cult,
/area/submap/settlement)
"sb" = (
/obj/structure/table/standard,
/obj/machinery/light{
	dir = 1
	},
/obj/effect/floor_decal/corner/orange/diagonal,
/turf/simulated/floor/tiled/white,
/area/submap/settlement)
"sn" = (
/obj/structure/closet/crate/freezer,
/obj/item/reagent_containers/food/condiment/carton/flour,
/obj/item/reagent_containers/food/condiment/carton/flour,
/obj/item/reagent_containers/food/condiment/carton/flour,
/obj/item/reagent_containers/food/condiment/carton/flour,
/obj/item/reagent_containers/food/condiment/carton/flour,
/obj/item/reagent_containers/food/condiment/carton/flour,
/obj/item/reagent_containers/food/condiment/carton/flour,
/turf/simulated/floor/tiled/freezer,
/area/submap/settlement)
"st" = (
/obj/effect/floor_decal/corner/lime/border{
	dir = 1
	},
/turf/simulated/floor/tiled/white,
/area/submap/settlement)
"sK" = (
/obj/structure/fence/cut/large,
/turf/simulated/floor/outdoors/mud,
/area/submap/settlement)
"sS" = (
/obj/effect/floor_decal/corner/lime/bordercorner,
/turf/simulated/floor/tiled/white,
/area/submap/settlement)
"te" = (
/obj/structure/constructshell/cult,
/turf/simulated/floor/cult,
/area/submap/settlement)
"uc" = (
/obj/structure/table/standard,
/obj/item/book/manual/chef_recipes,
/obj/effect/floor_decal/corner/lime/border,
/turf/simulated/floor/tiled/white,
/area/submap/settlement)
"vc" = (
/obj/structure/table/standard,
/obj/machinery/microwave,
/obj/effect/floor_decal/corner/orange/diagonal,
/turf/simulated/floor/tiled/white,
/area/submap/settlement)
"vG" = (
/obj/structure/simple_door/wood,
/turf/simulated/floor/tiled/red,
/area/submap/settlement)
"vY" = (
/obj/random/multiple/large_corp_crate,
/turf/simulated/floor/lino,
/area/submap/settlement)
"wF" = (
/obj/structure/constructshell,
/turf/simulated/floor/cult,
/area/submap/settlement)
"wV" = (
/obj/structure/table/woodentable,
/turf/simulated/floor/lino,
/area/submap/settlement)
"xq" = (
/mob/living/simple_mob/creature/cult/strong,
/obj/effect/floor_decal/corner/lime/border{
	dir = 1
	},
/turf/simulated/floor/tiled/white,
/area/submap/settlement)
"xs" = (
/obj/random/multiple/corp_crate,
/obj/effect/floor_decal/corner/white/diagonal,
/turf/simulated/floor/tiled/white,
/area/submap/settlement)
"xv" = (
/mob/living/simple_mob/construct/shade,
/turf/simulated/floor/outdoors/mud,
/area/submap/settlement)
"xz" = (
/obj/structure/sink{
	dir = 1
	},
/obj/machinery/light{
	layer = 3
	},
/obj/effect/floor_decal/corner/paleblue/diagonal,
/turf/simulated/floor/tiled/white,
/area/submap/settlement)
"xH" = (
/obj/machinery/porta_turret/ai_defense{
	req_one_access = null
	},
/obj/effect/floor_decal/corner/red/diagonal,
/turf/simulated/floor/tiled/red,
/area/submap/settlement)
"xQ" = (
/obj/structure/table/standard,
/obj/random/maintenance/foodstuff,
/obj/effect/floor_decal/corner/orange/diagonal,
/turf/simulated/floor/tiled/white,
/area/submap/settlement)
"xS" = (
/obj/structure/table/standard,
/obj/effect/floor_decal/corner/lime/border{
	dir = 8
	},
/turf/simulated/floor/tiled/white,
/area/submap/settlement)
"xY" = (
/obj/structure/closet/crate/freezer,
/obj/item/reagent_containers/food/snacks/crabmeat,
/obj/item/reagent_containers/food/snacks/crabmeat,
/obj/item/reagent_containers/food/snacks/crabmeat,
/turf/simulated/floor/tiled/freezer,
/area/submap/settlement)
"xZ" = (
/obj/effect/floor_decal/corner/lime/bordercorner{
	dir = 4
	},
/turf/simulated/floor/tiled/white,
/area/submap/settlement)
"ya" = (
/mob/living/simple_mob/construct/harvester,
/obj/effect/floor_decal/corner/white/diagonal,
/turf/simulated/floor/tiled/white,
/area/submap/settlement)
"yb" = (
/mob/living/simple_mob/construct/proteon,
/turf/simulated/floor/cult,
/area/submap/settlement)
"yf" = (
/obj/machinery/light/small{
	dir = 4
	},
/turf/simulated/floor/tiled/freezer,
/area/submap/settlement)
"yi" = (
/obj/structure/railing{
	dir = 8
	},
/turf/simulated/floor/outdoors/grass/sif/forest/planetuse,
/area/submap/settlement)
"yR" = (
/obj/machinery/appliance/cooker/grill,
/obj/effect/floor_decal/corner/orange/diagonal,
/turf/simulated/floor/tiled/white,
/area/submap/settlement)
"zh" = (
/obj/effect/floor_decal/corner/red/diagonal,
/turf/simulated/floor/tiled/red,
/area/submap/settlement)
"zz" = (
/obj/structure/table/standard,
/obj/random/maintenance/foodstuff,
/turf/simulated/floor/wood{
	nitrogen = 93.7835;
	oxygen = 20.7263;
	temperature = 243.15
	},
/area/submap/settlement)
"zT" = (
/mob/living/simple_mob/creature/cult/strong,
/turf/simulated/floor/tiled/freezer,
/area/submap/settlement)
"AY" = (
/obj/machinery/light{
	dir = 8;
	layer = 3
	},
/obj/effect/floor_decal/corner/white/diagonal,
/turf/simulated/floor/tiled/white,
/area/submap/settlement)
"Bv" = (
/turf/simulated/floor/outdoors/dirt,
/area/submap/settlement)
"BK" = (
/obj/effect/floor_decal/corner/paleblue/diagonal,
/turf/simulated/floor/tiled/white,
/area/submap/settlement)
"BT" = (
/obj/structure/table/wooden_reinforced,
/obj/random/contraband,
/turf/simulated/floor/carpet/blue2,
/area/submap/settlement)
"Cd" = (
/obj/item/stool,
/turf/simulated/floor/wood{
	nitrogen = 93.7835;
	oxygen = 20.7263;
	temperature = 243.15
	},
/area/submap/settlement)
"Do" = (
/obj/structure/table/borosilicate,
/obj/effect/floor_decal/corner/red/diagonal,
/turf/simulated/floor/tiled/red,
/area/submap/settlement)
"DD" = (
/obj/effect/floor_decal/corner/lime/border,
/turf/simulated/floor/tiled/white,
/area/submap/settlement)
"Ev" = (
/obj/structure/sink{
	dir = 1
	},
/obj/effect/floor_decal/corner/paleblue/diagonal,
/turf/simulated/floor/tiled/white,
/area/submap/settlement)
"Ey" = (
/turf/simulated/floor/outdoors/dirt,
/area/template_noop)
"Fi" = (
/turf/simulated/wall/wood,
/area/submap/settlement)
"Fn" = (
/obj/structure/kitchenspike,
/turf/simulated/floor/tiled/freezer,
/area/submap/settlement)
"Fv" = (
/obj/structure/table/standard,
/turf/simulated/floor/tiled/white,
/area/submap/settlement)
"FA" = (
/mob/living/simple_mob/construct/harvester/greater,
/turf/simulated/floor/cult,
/area/submap/settlement)
"FR" = (
/obj/structure/railing{
	dir = 1
	},
/turf/simulated/floor/outdoors/grass/sif/forest/planetuse,
/area/submap/settlement)
"GS" = (
/obj/structure/toilet,
/obj/effect/floor_decal/corner/paleblue/diagonal,
/turf/simulated/floor/tiled/white,
/area/submap/settlement)
"GU" = (
/obj/machinery/appliance/cooker/fryer,
/obj/effect/floor_decal/corner/orange/diagonal,
/turf/simulated/floor/tiled/white,
/area/submap/settlement)
"HF" = (
/obj/machinery/appliance/mixer/cereal,
/obj/machinery/light,
/obj/effect/floor_decal/corner/lime/border,
/turf/simulated/floor/tiled/white,
/area/submap/settlement)
"HK" = (
/obj/structure/table/fancyblack,
/obj/item/storage/belt/soulstone/full,
/turf/simulated/floor/cult,
/area/submap/settlement)
"HR" = (
/obj/structure/table/woodentable,
/obj/item/flashlight/lamp,
/turf/simulated/floor/lino,
/area/submap/settlement)
"HV" = (
/mob/living/simple_mob/animal/space/bats/cult/strong,
/turf/simulated/floor/outdoors/grass/sif/forest/planetuse,
/area/submap/settlement)
"Il" = (
/obj/item/bedsheet,
/obj/structure/bed,
/turf/simulated/floor/carpet/blue2,
/area/submap/settlement)
"Iu" = (
/obj/structure/table/standard,
/obj/random/maintenance/foodstuff,
/obj/effect/floor_decal/corner/orange/diagonal,
/obj/random/medical/pillbottle,
/turf/simulated/floor/tiled/white,
/area/submap/settlement)
"ID" = (
/obj/machinery/door/airlock/vault/bolted,
/turf/simulated/floor/tiled/red,
/area/submap/settlement)
"Ja" = (
/obj/structure/table/wooden_reinforced,
/turf/simulated/floor/carpet/blue2,
/area/submap/settlement)
"Kw" = (
/obj/item/stool/padded,
/mob/living/simple_mob/construct/harvester/greater,
/obj/effect/floor_decal/corner/orange/diagonal,
/turf/simulated/floor/tiled/white,
/area/submap/settlement)
"KK" = (
/obj/structure/windoor_assembly{
	dir = 4
	},
/obj/effect/floor_decal/corner/orange/diagonal,
/turf/simulated/floor/tiled/white,
/area/submap/settlement)
"KZ" = (
/obj/structure/table/standard,
/obj/item/material/knife/butch,
/turf/simulated/floor/tiled/white,
/area/submap/settlement)
"Lj" = (
/obj/structure/table/woodentable,
/obj/random/mug,
/turf/simulated/floor/lino,
/area/submap/settlement)
"Lw" = (
/obj/machinery/light{
	dir = 4;
	layer = 3
	},
/obj/effect/floor_decal/corner/white/diagonal,
/turf/simulated/floor/tiled/white,
/area/submap/settlement)
"LI" = (
/obj/structure/bed/chair/sofa/left/orange,
/turf/simulated/floor/carpet/blue2,
/area/submap/settlement)
"LM" = (
/obj/structure/cult/forge,
/turf/simulated/floor/cult,
/area/submap/settlement)
"LV" = (
/obj/structure/bed/chair/sofa/right/orange,
/turf/simulated/floor/carpet/blue2,
/area/submap/settlement)
"Mm" = (
/obj/structure/table/standard,
/obj/item/reagent_containers/food/condiment/enzyme,
/obj/item/reagent_containers/glass/beaker,
/obj/effect/floor_decal/corner/lime/border,
/turf/simulated/floor/tiled/white,
/area/submap/settlement)
"Mw" = (
/obj/machinery/light{
	dir = 1
	},
/obj/random/multiple/corp_crate,
/obj/effect/floor_decal/corner/white/diagonal,
/turf/simulated/floor/tiled/white,
/area/submap/settlement)
"MI" = (
/obj/structure/railing,
/turf/simulated/floor/outdoors/grass/sif/forest/planetuse,
/area/submap/settlement)
"MN" = (
/obj/effect/floor_decal/corner/red/diagonal,
/obj/structure/table/rack,
/obj/random/rigsuit,
/obj/random/cash,
/obj/random/cash,
/turf/simulated/floor/tiled/red,
/area/submap/settlement)
"MS" = (
/mob/living/simple_mob/animal/space/bats/cult/strong,
/turf/simulated/floor/outdoors/dirt,
/area/submap/settlement)
"Of" = (
/obj/machinery/light{
	dir = 8
	},
/obj/effect/floor_decal/corner/lime/border{
	dir = 8
	},
/turf/simulated/floor/tiled/white,
/area/submap/settlement)
"Oj" = (
/obj/structure/fence/corner,
/turf/simulated/floor/outdoors/mud,
/area/submap/settlement)
"OI" = (
/turf/simulated/wall/concrete,
/area/submap/settlement)
"OS" = (
/obj/machinery/light,
/obj/effect/floor_decal/corner/white/diagonal,
/turf/simulated/floor/tiled/white,
/area/submap/settlement)
"Po" = (
/obj/structure/table/standard,
/obj/item/flashlight/lamp,
/obj/machinery/light,
/obj/effect/floor_decal/corner/lime/border,
/turf/simulated/floor/tiled/white,
/area/submap/settlement)
"PG" = (
/turf/simulated/floor/outdoors/grass/sif/forest/planetuse,
/area/submap/settlement)
"PP" = (
/turf/simulated/floor/carpet/blue2,
/area/submap/settlement)
"Qe" = (
/obj/machinery/light{
	dir = 1
	},
/obj/structure/table/standard,
/obj/item/material/knife/butch,
/obj/effect/floor_decal/corner/lime/border{
	dir = 1
	},
/turf/simulated/floor/tiled/white,
/area/submap/settlement)
"Qf" = (
/obj/machinery/light/small{
	dir = 8
	},
/turf/simulated/floor/tiled/freezer,
/area/submap/settlement)
"Qg" = (
/obj/structure/bed/chair/comfy/teal{
	dir = 1
	},
/mob/living/simple_mob/construct/wraith,
/turf/simulated/floor/carpet/blue2,
/area/submap/settlement)
"Re" = (
/obj/structure/closet/secure_closet/freezer/fridge,
/obj/item/storage/fancy/egg_box,
/obj/item/storage/fancy/egg_box,
/obj/item/reagent_containers/food/drinks/bottle/milk,
/obj/item/reagent_containers/food/drinks/bottle/milk,
/obj/item/reagent_containers/food/drinks/bottle/milk,
/obj/item/reagent_containers/food/drinks/bottle/cream,
/obj/item/reagent_containers/food/drinks/bottle/cream,
/obj/item/reagent_containers/food/drinks/bottle/cream,
/obj/item/reagent_containers/food/drinks/bottle/cream,
/obj/item/reagent_containers/food/condiment/carton/sugar,
/obj/effect/floor_decal/corner/lime/border{
	dir = 5
	},
/obj/item/reagent_containers/chem_disp_cartridge/tequila,
/obj/item/reagent_containers/chem_disp_cartridge/doctorsdelight,
/turf/simulated/floor/tiled/white,
/area/submap/settlement)
"RL" = (
/obj/structure/table/standard,
/obj/machinery/chemical_dispenser/bar_coffee,
/obj/effect/floor_decal/corner/orange/diagonal,
/turf/simulated/floor/tiled/white,
/area/submap/settlement)
"Sr" = (
/obj/item/chainsaw,
/mob/living/simple_mob/creature/cult/strong,
/obj/effect/floor_decal/corner/white/diagonal,
/turf/simulated/floor/tiled/white,
/area/submap/settlement)
"Ts" = (
/turf/simulated/wall/cult{
	can_open = 1
	},
/area/submap/settlement)
"TJ" = (
/obj/structure/table/standard,
/obj/effect/floor_decal/corner/orange/diagonal,
/turf/simulated/floor/tiled/white,
/area/submap/settlement)
"TU" = (
/turf/simulated/wall/r_wall,
/area/submap/settlement)
"UZ" = (
/obj/structure/table/standard,
/obj/machinery/light{
	dir = 4;
	layer = 3
	},
/obj/random/maintenance/foodstuff,
/obj/effect/floor_decal/corner/orange/diagonal,
/turf/simulated/floor/tiled/white,
/area/submap/settlement)
"Vn" = (
/obj/structure/cult/talisman,
/turf/simulated/floor/cult,
/area/submap/settlement)
"Vp" = (
/obj/item/stool/padded,
/mob/living/simple_mob/creature/cult/strong,
/obj/effect/floor_decal/corner/orange/diagonal,
/obj/item/soulstone,
/turf/simulated/floor/tiled/white,
/area/submap/settlement)
"Vu" = (
/obj/structure/cult/tome,
/turf/simulated/floor/cult,
/area/submap/settlement)
"WO" = (
/obj/structure/fence/corner{
	dir = 1
	},
/turf/simulated/floor/outdoors/mud,
/area/submap/settlement)
"Xm" = (
/mob/living/simple_mob/construct/juggernaut,
/obj/effect/floor_decal/corner/red/diagonal,
/turf/simulated/floor/tiled/red,
/area/submap/settlement)
"YH" = (
/obj/machinery/light{
	dir = 1
	},
/obj/machinery/vending/foodmeat,
/obj/effect/floor_decal/corner/lime/border{
	dir = 1
	},
/turf/simulated/floor/tiled/white,
/area/submap/settlement)
"YI" = (
/mob/living/simple_mob/construct/harvester,
/obj/effect/floor_decal/corner/lime/border,
/turf/simulated/floor/tiled/white,
/area/submap/settlement)
"ZR" = (
/obj/structure/table/wooden_reinforced,
/obj/item/flame/candle,
/turf/simulated/floor/carpet/blue2,
/area/submap/settlement)

(1,1,1) = {"
pV
pV
pV
pV
pV
pV
pV
pV
pV
pV
pV
pV
pV
pV
pV
pV
pV
pV
pV
pV
pV
pV
pV
pV
pV
Ey
Ey
Ey
pV
pV
pV
pV
pV
pV
pV
pV
pV
pV
pV
pV
"}
(2,1,1) = {"
pV
OI
OI
OI
OI
OI
OI
OI
OI
OI
OI
OI
OI
OI
OI
OI
OI
OI
OI
OI
OI
OI
OI
pV
pV
Ey
Ey
Ey
pV
pV
pV
pV
pV
pV
pV
pV
pV
pV
pV
pV
"}
(3,1,1) = {"
pV
OI
xY
sn
Qf
dE
Fn
OI
lz
xS
gf
Of
km
OI
RL
lt
xQ
jZ
lt
lt
lt
iV
OI
PG
PG
Bv
Bv
Bv
PG
Fi
Fi
Fi
Fi
Fi
Fi
Fi
Fi
Fi
Fi
pV
"}
(4,1,1) = {"
pV
OI
jb
dE
dE
zT
dE
eK
st
sS
en
xZ
Po
OI
sb
lt
fU
Vp
lt
lt
jZ
jZ
rh
PG
HV
Bv
Bv
Bv
PG
Fi
cI
PP
Fi
PP
PP
Fi
PP
cI
Fi
pV
"}
(5,1,1) = {"
pV
OI
eJ
eJ
yf
dE
Fn
OI
Qe
DD
bh
xq
Mm
OI
yR
lt
TJ
jZ
lt
lt
Iu
xQ
rh
PG
PG
Bv
Bv
Bv
PG
Fi
ZR
PP
ay
PP
PP
ay
PP
ZR
Fi
pV
"}
(6,1,1) = {"
pV
OI
OI
OI
OI
OI
OI
OI
fl
YI
Fv
st
ft
OI
GU
lt
TJ
jZ
lt
lt
Kw
jZ
rh
PG
PG
Bv
Bv
Bv
PG
Fi
Il
PP
Fi
le
PP
Fi
PP
Il
Fi
pV
"}
(7,1,1) = {"
pV
OI
ls
rs
rs
rs
oS
OI
YH
DD
KZ
st
uc
OI
sb
lt
Iu
jZ
lt
lt
lt
iV
OI
PG
PG
eI
Bv
Bv
PG
Fi
Fi
Fi
Fi
PP
PP
Fi
Fi
Fi
Fi
pV
"}
(8,1,1) = {"
pV
OI
hh
oq
oq
oq
OS
OI
cY
aT
bn
cD
HF
OI
vc
lt
xQ
jZ
lt
lt
jZ
jZ
rh
PG
PG
Bv
Bv
Bv
PG
Fi
cI
PP
Fi
PP
PP
Fi
PP
cI
Fi
pV
"}
(9,1,1) = {"
pV
OI
oq
oq
Sr
oq
oq
OI
Re
rA
en
en
qa
OI
lt
lt
xQ
Vp
lt
lt
xQ
xQ
rh
PG
PG
Bv
Bv
MS
PG
Fi
ZR
PP
ay
PP
PP
ay
PP
ZR
Fi
pV
"}
(10,1,1) = {"
pV
OI
OI
OI
eK
OI
OI
OI
OI
OI
eK
OI
OI
OI
KK
TJ
xQ
jZ
lt
lt
jZ
jZ
rh
PG
PG
Bv
Bv
Bv
PG
Fi
Il
PP
Fi
PP
PP
Fi
PP
Il
Fi
pV
"}
(11,1,1) = {"
pV
OI
xs
oq
oq
AY
oq
OI
lt
lt
lt
lt
lt
lt
lt
lt
lt
lt
lt
lt
lt
iV
OI
PG
HV
Bv
Bv
Bv
PG
Fi
Fi
Fi
Fi
PP
PP
Fi
Fi
Fi
Fi
pV
"}
(12,1,1) = {"
pV
OI
Mw
oq
oq
ya
oq
eK
lt
lt
lt
lt
lt
lt
lt
lt
lt
lt
lt
lt
lt
lt
OI
PG
PG
Bv
Bv
Bv
PG
Fi
cI
PP
Fi
PP
PP
Fi
PP
cI
Fi
pV
"}
(13,1,1) = {"
pV
OI
xs
oq
oq
Lw
oq
OI
lt
lt
lt
lt
Kw
UZ
jZ
lt
jZ
UZ
jZ
lt
lt
lt
OI
PG
PG
Bv
Bv
Bv
PG
Fi
ZR
PP
ay
PP
PP
ay
PP
ZR
Fi
pV
"}
(14,1,1) = {"
pV
OI
OI
OI
eK
OI
OI
OI
OI
OI
lX
OI
OI
OI
OI
OI
rh
rh
rh
OI
eK
OI
OI
PG
PG
Bv
Bv
Bv
PG
Fi
Il
PP
Fi
PP
PP
Fi
PP
Il
Fi
pV
"}
(15,1,1) = {"
pV
OI
nN
nN
nN
nN
bp
OI
GS
lX
BK
BK
Ev
OI
lO
lO
lO
lO
lO
lO
lO
lO
lO
FR
PG
MS
Bv
Bv
HV
Fi
Fi
Fi
Fi
PP
PP
Fi
Fi
Fi
Fi
pV
"}
(16,1,1) = {"
pV
OI
nN
im
nN
nN
il
OI
OI
OI
BK
BK
xz
OI
lO
Cd
lO
lO
Cd
lO
lO
Cd
lO
FR
PG
Bv
Bv
Bv
PG
Fi
LV
PP
PP
PP
PP
Ja
PP
PP
Fi
pV
"}
(17,1,1) = {"
pV
OI
jo
Lj
nN
nN
vY
OI
GS
lX
BK
BK
Ev
OI
Cd
zz
Cd
Cd
zz
Cd
Cd
zz
Cd
FR
PG
Bv
eI
Bv
PG
Fi
LI
PP
PP
PP
PP
Ja
Qg
PP
Fi
pV
"}
(18,1,1) = {"
pV
OI
HR
wV
nN
nN
bp
OI
OI
OI
OI
OI
OI
OI
lO
Cd
lO
lO
Cd
lO
lO
Cd
lO
FR
PG
Bv
Bv
Bv
PG
ay
PP
PP
PP
PP
PP
BT
PP
PP
Fi
pV
"}
(19,1,1) = {"
pV
OI
OI
OI
OI
OI
OI
OI
PG
PG
PG
PG
PG
MI
lO
lO
lO
lO
lO
lO
lO
lO
lO
FR
PG
Bv
MS
Bv
PG
Fi
LV
PP
PP
PP
PP
Ja
Ja
PP
Fi
pV
"}
(20,1,1) = {"
pV
pV
pV
PG
HV
PG
PG
PG
PG
PG
PG
PG
PG
PG
yi
yi
yi
yi
PG
PG
yi
yi
yi
PG
PG
Bv
Bv
Bv
PG
Fi
LI
PP
PP
PP
PP
PP
PP
PP
Fi
pV
"}
(21,1,1) = {"
pV
pV
pV
PG
PG
PG
PG
PG
PG
PG
PG
HV
PG
PG
PG
PG
PG
PG
PG
PG
PG
PG
PG
PG
PG
Bv
Bv
Bv
PG
Fi
Fi
Fi
Fi
Fi
Fi
Fi
Fi
Fi
Fi
pV
"}
(22,1,1) = {"
Ey
Ey
Ey
Bv
Bv
Bv
Bv
Bv
Bv
Bv
Bv
Bv
Bv
Bv
Bv
Bv
Bv
Bv
Bv
Bv
Bv
Bv
Bv
Bv
Bv
Bv
Bv
Bv
PG
PG
PG
PG
PG
PG
PG
PG
PG
PG
PG
pV
"}
(23,1,1) = {"
Ey
Ey
Ey
Bv
Bv
Bv
Bv
Bv
Bv
Bv
Bv
Bv
Bv
Bv
eI
Bv
Bv
Bv
Bv
Bv
MS
Bv
Bv
Bv
Bv
Bv
Bv
Bv
PG
PG
PG
PG
PG
PG
PG
PG
PG
PG
PG
pV
"}
(24,1,1) = {"
Ey
Ey
Ey
Bv
Bv
Bv
Bv
Bv
Bv
Bv
Bv
Bv
Bv
Bv
Bv
Bv
Bv
Bv
Bv
Bv
Bv
Bv
Bv
Bv
Bv
Bv
Bv
Bv
PG
PG
PG
PG
PG
PG
PG
PG
PG
PG
PG
pV
"}
(25,1,1) = {"
pV
pV
pV
PG
PG
PG
HV
PG
PG
PG
PG
PG
PG
HV
PG
PG
PG
PG
PG
PG
PG
PG
PG
PG
PG
Bv
Bv
eI
PG
PG
PG
PG
PG
PG
PG
PG
PG
PG
PG
pV
"}
(26,1,1) = {"
pV
pV
pV
PG
PG
PG
PG
PG
PG
PG
PG
PG
PG
PG
PG
PG
PG
PG
PG
PG
PG
PG
PG
PG
PG
Bv
Bv
Bv
PG
PG
PG
PG
PG
PG
PG
PG
PG
PG
PG
pV
"}
(27,1,1) = {"
pV
pV
pV
kT
gC
gC
gC
gC
gC
gC
gC
gC
sK
gC
gC
gC
gC
gC
gC
gC
gC
gC
WO
PG
PG
Bv
Bv
Bv
PG
PG
TU
TU
TU
TU
TU
TU
TU
TU
TU
pV
"}
(28,1,1) = {"
pV
pV
pV
ht
rW
rW
rW
rW
rW
rW
rW
pR
pR
pR
pR
pR
pR
pR
pR
pR
pR
pR
ht
PG
PG
Bv
Bv
Bv
PG
PG
TU
zh
zh
zh
zh
zh
zh
zh
TU
pV
"}
(29,1,1) = {"
pV
pV
pV
ht
rW
kM
LM
kM
wF
te
rW
pR
pR
hV
pR
eB
hV
pR
pR
hV
pR
pR
ht
PG
HV
Bv
Bv
Bv
PG
PG
vG
zh
zh
zh
zh
Xm
zh
zh
TU
pV
"}
(30,1,1) = {"
pV
pV
pV
ht
rW
it
FA
kM
kM
kM
Ts
pR
pR
pR
pR
pR
pR
pR
pR
pR
xv
pR
ht
PG
PG
Bv
Bv
Bv
PG
PG
TU
zh
zh
Do
Do
Do
Do
jx
TU
pV
"}
(31,1,1) = {"
pV
pV
pV
ht
rW
it
kM
kg
kM
kM
rW
pR
pR
hV
pR
pR
hV
pR
pR
hV
pR
pR
ht
PG
PG
Bv
Bv
MS
PG
PG
TU
zh
Xm
Do
zh
zh
zh
zh
TU
pV
"}
(32,1,1) = {"
pV
pV
pV
ht
rW
kM
Vu
kM
kM
HK
rW
pR
pR
pR
pR
pR
pR
pR
pR
pR
pR
pR
ht
PG
PG
Bv
Bv
Bv
PG
PG
TU
zh
zh
Do
zh
zh
zh
zh
TU
pV
"}
(33,1,1) = {"
pV
pV
pV
ht
rW
rW
rW
rW
rW
rW
rW
pR
pR
hV
pR
pR
hV
pR
pR
hV
pR
pR
ht
PG
PG
Bv
Bv
Bv
PG
PG
TU
TU
TU
TU
TU
TU
vG
TU
TU
pV
"}
(34,1,1) = {"
pV
pV
pV
ht
rW
kM
Vn
kM
kM
qv
rW
pR
pR
xv
pR
pR
pR
pR
pR
pR
pR
pR
ht
PG
PG
Bv
Bv
Bv
PG
PG
TU
TU
hy
xH
TU
TU
zh
TU
TU
pV
"}
(35,1,1) = {"
pV
pV
pV
ht
rW
it
kM
gz
kM
kM
rW
pR
pR
hV
pR
pR
hV
pR
pR
hV
pR
pR
ht
PG
PG
Bv
Bv
Bv
PG
PG
TU
MN
bI
zh
TU
TU
zh
TU
TU
pV
"}
(36,1,1) = {"
pV
pV
pV
ht
rW
it
yb
kM
kM
kM
pn
pR
pR
pR
pR
pR
pR
eB
pR
pR
pR
pR
ht
PG
HV
Bv
Bv
Bv
PG
PG
TU
xH
zh
zh
ID
zh
zh
TU
TU
pV
"}
(37,1,1) = {"
pV
pV
pV
ht
rW
kM
LM
kM
wF
te
rW
pR
pR
hV
pR
pR
hV
pR
pR
hV
xv
pR
ht
PG
PG
Bv
Bv
Bv
PG
PG
TU
oa
bI
zh
TU
TU
TU
TU
TU
pV
"}
(38,1,1) = {"
pV
pV
pV
ht
rW
rW
rW
rW
rW
rW
rW
pR
pR
pR
pR
pR
pR
pR
pR
pR
pR
pR
ht
PG
PG
Bv
Bv
Bv
PG
PG
TU
TU
gl
xH
TU
TU
TU
TU
TU
pV
"}
(39,1,1) = {"
pV
pV
pV
Oj
gC
gC
gC
gC
gC
gC
gC
gC
gC
gC
gC
gC
gC
gC
gC
gC
gC
gC
Oj
PG
PG
Bv
Bv
Bv
PG
PG
TU
TU
TU
TU
TU
TU
TU
TU
TU
pV
"}
(40,1,1) = {"
pV
pV
pV
pV
pV
pV
pV
pV
pV
pV
pV
pV
pV
pV
pV
pV
pV
pV
pV
pV
pV
pV
pV
pV
pV
Ey
Ey
Ey
pV
pV
pV
pV
pV
pV
pV
pV
pV
pV
pV
pV
"}
