//MAP CONVERTED BY dmm2tgm.py THIS HEADER COMMENT PREVENTS RECONVERSION, DO NOT REMOVE
"a" = (
/turf/template_noop,
/area/template_noop)
"b" = (
/obj/structure/grille,
/obj/structure/window/reinforced{
	dir = 1
	},
/obj/structure/window/reinforced,
/turf/simulated/floor,
/area/submap/solarmoff)
"c" = (
/obj/structure/grille,
/obj/structure/window/reinforced{
	dir = 4;
	health = 1e+006
	},
/obj/structure/window/reinforced{
	dir = 1
	},
/obj/structure/window/reinforced,
/turf/simulated/floor,
/area/submap/solarmoff)
"d" = (
/obj/item/melee/energy/sword/imperial,
/turf/simulated/mineral/floor/ignore_mapgen,
/area/submap/solarmoff)
"g" = (
/obj/effect/decal/cleanable/ash,
/obj/random/energy/highend,
/turf/simulated/mineral/floor/ignore_mapgen,
/area/submap/solarmoff)
"i" = (
/obj/structure/grille,
/obj/structure/window/reinforced{
	dir = 1
	},
/obj/structure/window/reinforced{
	dir = 4
	},
/obj/structure/window/reinforced,
/turf/simulated/floor,
/area/submap/solarmoff)
"m" = (
/obj/item/storage/secure/briefcase/fuelrod,
/turf/simulated/mineral/floor/ignore_mapgen,
/area/submap/solarmoff)
"n" = (
/turf/simulated/floor/water,
/area/submap/solarmoff)
"p" = (
/obj/item/rig_module/ai_container,
/turf/simulated/mineral/floor/ignore_mapgen,
/area/submap/solarmoff)
"s" = (
/obj/item/rig_module/vision/thermal,
/obj/effect/decal/cleanable/ash,
/turf/simulated/mineral/floor/ignore_mapgen,
/area/submap/solarmoff)
"u" = (
/turf/simulated/wall/r_wall,
/area/submap/solarmoff)
"v" = (
/obj/effect/decal/cleanable/ash,
/turf/simulated/floor/water,
/area/submap/solarmoff)
"B" = (
/obj/structure/grille,
/obj/structure/window/reinforced{
	dir = 4;
	health = 1e+006
	},
/obj/structure/window/reinforced{
	dir = 8
	},
/obj/structure/window/reinforced{
	dir = 1
	},
/turf/simulated/floor,
/area/submap/solarmoff)
"C" = (
/obj/effect/decal/cleanable/ash,
/obj/item/rig_module/atmos_shield,
/turf/simulated/mineral/floor/ignore_mapgen,
/area/submap/solarmoff)
"E" = (
/mob/living/simple_mob/animal/space/carp/large,
/turf/simulated/floor/water,
/area/submap/solarmoff)
"F" = (
/obj/random/energy/highend,
/turf/simulated/mineral/floor/ignore_mapgen,
/area/submap/solarmoff)
"G" = (
/turf/simulated/mineral/crystal_shiny,
/area/submap/solarmoff)
"I" = (
/obj/effect/decal/cleanable/ash,
/turf/simulated/mineral/floor/ignore_mapgen,
/area/submap/solarmoff)
"J" = (
/turf/simulated/floor,
/area/submap/solarmoff)
"K" = (
/obj/structure/grille,
/obj/structure/window/reinforced{
	dir = 4;
	health = 1e+006
	},
/obj/structure/window/reinforced{
	dir = 8
	},
/turf/simulated/floor,
/area/submap/solarmoff)
"L" = (
/obj/structure/grille,
/obj/structure/window/reinforced{
	dir = 8
	},
/obj/structure/window/reinforced{
	dir = 1
	},
/obj/structure/window/reinforced,
/turf/simulated/floor,
/area/submap/solarmoff)
"M" = (
/obj/structure/flora/ausbushes/reedbush,
/turf/simulated/floor/water,
/area/submap/solarmoff)
"N" = (
/obj/structure/flora/ausbushes/reedbush,
/obj/effect/decal/cleanable/ash,
/turf/simulated/floor/water,
/area/submap/solarmoff)
"P" = (
/obj/structure/grille,
/obj/structure/window/reinforced{
	dir = 4;
	health = 1e+006
	},
/obj/structure/window/reinforced{
	dir = 8
	},
/obj/structure/window/reinforced,
/turf/simulated/floor,
/area/submap/solarmoff)
"R" = (
/obj/structure/flora/lily2,
/turf/simulated/floor/water,
/area/submap/solarmoff)
"T" = (
/obj/effect/decal/cleanable/ash,
/obj/item/rig_module/rescue_pharm,
/turf/simulated/mineral/floor/ignore_mapgen,
/area/submap/solarmoff)
"U" = (
/mob/living/simple_mob/vore/solarmoth,
/obj/item/rig_module/device/stamp,
/turf/simulated/mineral/floor/ignore_mapgen,
/area/submap/solarmoff)
"V" = (
/turf/simulated/mineral/floor/ignore_mapgen,
/area/submap/solarmoff)
"W" = (
/obj/machinery/door/airlock/highsecurity,
/turf/simulated/floor,
/area/submap/solarmoff)

(1,1,1) = {"
a
a
a
a
a
a
a
a
a
a
a
a
a
a
a
a
a
a
a
"}
(2,1,1) = {"
a
a
a
a
a
a
a
a
a
a
a
a
a
a
a
a
a
a
a
"}
(3,1,1) = {"
a
a
a
a
u
B
K
K
K
K
K
K
K
P
u
a
a
a
a
"}
(4,1,1) = {"
a
a
a
u
u
n
M
n
R
n
n
n
n
M
u
u
a
a
a
"}
(5,1,1) = {"
a
a
u
u
n
n
R
n
n
E
n
n
R
n
n
u
u
a
a
"}
(6,1,1) = {"
a
a
L
n
n
E
n
n
n
n
M
n
n
E
n
n
L
a
a
"}
(7,1,1) = {"
a
a
b
M
n
n
M
v
G
G
G
n
n
n
n
M
b
a
a
"}
(8,1,1) = {"
a
a
b
n
R
n
n
G
G
s
G
G
M
R
n
n
b
a
a
"}
(9,1,1) = {"
a
a
b
n
n
n
G
G
p
I
F
G
G
n
n
n
b
a
a
"}
(10,1,1) = {"
a
a
b
n
E
M
G
T
V
U
I
m
G
n
E
n
b
a
a
"}
(11,1,1) = {"
a
a
b
n
n
R
G
G
g
I
d
G
G
n
R
n
b
a
a
"}
(12,1,1) = {"
a
a
b
M
n
n
n
G
G
C
G
G
N
n
n
M
b
a
a
"}
(13,1,1) = {"
a
a
b
n
n
M
n
n
G
G
G
n
R
n
n
n
b
a
a
"}
(14,1,1) = {"
a
a
c
n
n
E
n
n
M
n
n
n
n
E
n
n
i
a
a
"}
(15,1,1) = {"
a
a
u
u
n
n
R
n
n
E
n
R
n
n
n
u
u
a
a
"}
(16,1,1) = {"
a
a
a
u
u
n
M
n
n
n
n
n
n
M
u
u
a
a
a
"}
(17,1,1) = {"
a
a
a
a
u
B
K
P
u
W
u
B
K
P
u
a
a
a
a
"}
(18,1,1) = {"
a
a
a
a
a
a
a
a
u
J
u
a
a
a
a
a
a
a
a
"}
(19,1,1) = {"
a
a
a
a
a
a
a
a
a
a
a
a
a
a
a
a
a
a
a
"}
