//MAP CONVERTED BY dmm2tgm.py THIS HEADER COMMENT PREVENTS RECONVERSION, DO NOT REMOVE
"a" = (
/turf/template_noop,
/area/template_noop)
"b" = (
/mob/living/simple_mob/humanoid/cultist/human/bloodjaunt/fireball,
/turf/template_noop,
/area/space)
"c" = (
/mob/living/carbon/human/ai_controlled/replicant,
/turf/simulated/floor/tiled/techfloor,
/area/space)
"d" = (
/mob/living/simple_mob/humanoid/merc/ranged/smg,
/turf/template_noop,
/area/space)
"e" = (
/mob/living/simple_mob/humanoid/eclipse/solar/froststalker,
/turf/template_noop,
/area/space)
"f" = (
/mob/living/simple_mob/humanoid/pirate/captain,
/turf/template_noop,
/area/space)
"g" = (
/mob/living/simple_mob/humanoid/pirate/mate/ranged/shotgun,
/turf/template_noop,
/area/space)
"h" = (
/mob/living/simple_mob/humanoid/eclipse/lunar/miner,
/turf/template_noop,
/area/space)
"i" = (
/obj/machinery/door/airlock/maintenance/int,
/turf/simulated/floor/tiled/techfloor,
/area/space)
"j" = (
/obj/machinery/portable_atmospherics/hydroponics,
/turf/simulated/floor/tiled/techfloor,
/area/space)
"k" = (
/mob/living/simple_mob/humanoid/cultist/lizard,
/turf/template_noop,
/area/space)
"l" = (
/mob/living/simple_mob/humanoid/pirate/ranged/handcannon/armored,
/turf/template_noop,
/area/space)
"m" = (
/turf/simulated/floor/tiled/techfloor,
/area/space)
"n" = (
/obj/structure/bookcase,
/turf/simulated/floor/tiled/techfloor,
/area/space)
"o" = (
/mob/living/simple_mob/humanoid/eclipse/solar/guardian,
/turf/template_noop,
/area/space)
"p" = (
/obj/structure/grille,
/obj/structure/window/reinforced/full,
/turf/simulated/floor,
/area/space)
"q" = (
/mob/living/simple_mob/humanoid/cultist/hunter,
/turf/template_noop,
/area/space)
"s" = (
/mob/living/simple_mob/humanoid/merc/ranged/sniper,
/turf/template_noop,
/area/space)
"t" = (
/obj/machinery/telecomms/relay/preset/ruskie,
/turf/simulated/floor/tiled/techfloor,
/area/space)
"u" = (
/obj/machinery/seed_extractor,
/turf/simulated/floor/tiled/techfloor,
/area/space)
"w" = (
/obj/structure/table/steel_reinforced,
/obj/random/cash,
/obj/random/maintenance,
/obj/random/material,
/turf/simulated/floor/tiled/techfloor,
/area/space)
"x" = (
/turf/template_noop,
/area/space)
"y" = (
/obj/structure/table/steel_reinforced,
/obj/item/weapon/telecube/randomized/mated,
/turf/simulated/floor/tiled/techfloor,
/area/space)
"z" = (
/obj/machinery/porta_turret/poi{
	faction = "xeno"
	},
/obj/effect/overlay/snow/floor,
/turf/simulated/floor{
	outdoors = 1
	},
/area/space)
"B" = (
/mob/living/simple_mob/humanoid/eclipse/lunar/pummler,
/turf/template_noop,
/area/space)
"C" = (
/obj/structure/table/steel_reinforced,
/obj/random/cash,
/obj/random/maintenance,
/obj/random/material,
/obj/item/device/radio/headset/heads/captain/sfr,
/turf/simulated/floor/tiled/techfloor,
/area/space)
"D" = (
/mob/living/simple_mob/humanoid/eclipse/solar/snipertesh,
/turf/template_noop,
/area/space)
"E" = (
/mob/living/simple_mob/humanoid/eclipse/lunar/shotgunner,
/turf/template_noop,
/area/space)
"F" = (
/mob/living/simple_mob/humanoid/eclipse/solar/teslanoodle,
/turf/template_noop,
/area/space)
"G" = (
/mob/living/simple_mob/humanoid/merc/ranged/deagle,
/turf/template_noop,
/area/space)
"H" = (
/mob/living/simple_mob/humanoid/merc/ranged/rifle,
/turf/template_noop,
/area/space)
"I" = (
/mob/living/simple_mob/humanoid/eclipse/lunar/wheel,
/turf/template_noop,
/area/space)
"J" = (
/obj/structure/table/steel_reinforced,
/obj/random/contraband/nofail,
/turf/simulated/floor/tiled/techfloor,
/area/space)
"K" = (
/obj/structure/loot_pile/maint/technical,
/turf/simulated/floor/tiled/techfloor,
/area/space)
"L" = (
/obj/machinery/biogenerator,
/turf/simulated/floor/tiled/techfloor,
/area/space)
"M" = (
/obj/structure/table/steel_reinforced,
/obj/random/firstaid,
/obj/random/cash,
/obj/random/maintenance,
/obj/random/material,
/turf/simulated/floor/tiled/techfloor,
/area/space)
"N" = (
/mob/living/simple_mob/humanoid/cultist/noodle,
/turf/template_noop,
/area/space)
"P" = (
/mob/living/simple_mob/humanoid/merc/ranged/laser,
/turf/template_noop,
/area/space)
"Q" = (
/mob/living/simple_mob/humanoid/eclipse/lunar/silvernoodle,
/turf/template_noop,
/area/space)
"R" = (
/mob/living/simple_mob/humanoid/eclipse/solar/hellhound,
/turf/template_noop,
/area/space)
"S" = (
/mob/living/simple_mob/humanoid/eclipse/lunar/aeroblaster,
/turf/template_noop,
/area/space)
"T" = (
/turf/simulated/wall/rpshull,
/area/space)
"U" = (
/mob/living/simple_mob/humanoid/pirate/ranged/armored,
/turf/template_noop,
/area/space)
"V" = (
/mob/living/simple_mob/humanoid/eclipse/solar/firemoff,
/turf/template_noop,
/area/space)
"W" = (
/obj/item/seeds/deathberryseed,
/obj/item/seeds/deathnettleseed,
/obj/item/seeds/gnomes,
/obj/item/seeds/icepepperseed,
/obj/item/seeds/rose/blood,
/obj/item/seeds/ambrosiagaiaseed,
/obj/item/seeds/ambrosiainfernusseed,
/obj/structure/closet,
/turf/simulated/floor/tiled/techfloor,
/area/space)
"X" = (
/mob/living/simple_mob/humanoid/pirate/machete/armored,
/turf/template_noop,
/area/space)
"Y" = (
/mob/living/simple_mob/humanoid/merc/ranged/garand,
/turf/template_noop,
/area/space)
"Z" = (
/obj/structure/table/bench/padded,
/mob/living/carbon/human/ai_controlled/replicant,
/turf/simulated/floor/tiled/techfloor,
/area/space)

(1,1,1) = {"
a
a
a
a
a
a
a
a
a
a
a
a
a
a
a
a
a
a
a
a
a
a
a
a
a
a
a
a
a
a
a
a
a
a
a
"}
(2,1,1) = {"
a
a
a
a
a
a
a
a
a
a
a
a
a
a
a
a
a
a
a
a
a
a
a
a
a
a
a
a
a
a
a
a
a
a
a
"}
(3,1,1) = {"
a
a
a
a
a
a
a
a
a
a
a
a
a
a
a
a
a
a
a
a
a
a
a
a
a
a
a
a
a
a
a
a
a
a
a
"}
(4,1,1) = {"
a
a
a
x
x
x
x
x
x
x
x
x
x
x
x
x
x
x
x
x
x
x
x
x
E
x
x
x
x
x
x
x
a
a
a
"}
(5,1,1) = {"
a
a
a
x
x
x
x
x
x
x
x
x
x
x
x
x
x
x
x
x
x
x
x
x
x
x
x
x
x
x
x
x
a
a
a
"}
(6,1,1) = {"
a
a
a
x
x
x
x
x
x
x
x
x
x
x
x
x
x
x
x
x
x
x
B
h
S
I
x
x
x
x
x
x
a
a
a
"}
(7,1,1) = {"
a
a
a
x
x
x
x
x
s
x
x
Y
x
H
x
x
x
x
x
x
x
x
x
x
x
x
x
x
x
x
x
x
a
a
a
"}
(8,1,1) = {"
a
a
a
x
x
x
x
x
x
G
x
x
P
x
d
x
x
x
x
x
x
x
x
x
Q
x
x
x
x
x
x
x
a
a
a
"}
(9,1,1) = {"
a
a
a
x
x
x
x
x
x
x
T
T
p
T
p
T
T
x
x
x
T
T
p
T
p
T
T
x
x
x
x
x
a
a
a
"}
(10,1,1) = {"
a
a
a
x
x
x
x
x
Y
x
T
t
J
t
J
t
T
x
x
x
T
m
M
w
w
C
T
x
x
R
x
x
a
a
a
"}
(11,1,1) = {"
a
a
a
x
x
x
x
x
x
P
p
J
c
m
c
K
T
x
x
x
T
m
Z
m
Z
w
p
F
x
D
x
V
a
a
a
"}
(12,1,1) = {"
a
a
a
x
x
x
x
x
H
x
T
t
m
m
m
K
T
z
x
z
T
m
m
m
m
w
T
x
x
o
x
x
a
a
a
"}
(13,1,1) = {"
a
a
a
x
x
x
x
x
x
d
p
J
c
m
m
m
T
T
i
T
T
m
m
m
Z
M
p
x
x
e
x
x
a
a
a
"}
(14,1,1) = {"
a
a
a
x
x
x
x
x
x
x
T
t
K
K
m
m
m
m
m
m
m
m
m
m
m
m
T
x
x
x
x
x
a
a
a
"}
(15,1,1) = {"
a
a
a
x
x
x
x
x
x
x
T
T
T
T
T
m
c
T
i
T
c
m
T
T
T
T
T
x
x
x
x
x
a
a
a
"}
(16,1,1) = {"
a
a
a
x
x
x
x
x
x
x
x
x
x
z
T
m
T
m
m
m
T
m
T
z
x
x
x
x
x
x
x
x
a
a
a
"}
(17,1,1) = {"
a
a
a
x
x
x
x
x
x
x
x
x
x
x
i
m
i
m
y
m
i
m
i
x
x
x
x
x
x
x
x
x
a
a
a
"}
(18,1,1) = {"
a
a
a
x
x
x
x
x
x
x
x
x
x
z
T
m
T
m
m
m
T
m
T
z
x
x
x
x
x
x
x
x
a
a
a
"}
(19,1,1) = {"
a
a
a
x
x
x
x
x
x
x
T
T
T
T
T
m
c
T
i
T
c
m
T
T
T
T
T
x
x
x
x
x
a
a
a
"}
(20,1,1) = {"
a
a
a
x
x
x
x
x
x
x
T
L
j
j
m
m
m
m
m
m
m
m
m
m
m
m
T
x
x
k
x
x
a
a
a
"}
(21,1,1) = {"
a
a
a
x
x
x
x
x
x
X
p
c
m
m
m
m
T
T
i
T
T
m
n
m
n
c
p
q
x
x
x
N
a
a
a
"}
(22,1,1) = {"
a
a
a
x
x
x
x
x
l
x
T
m
m
j
m
j
T
z
x
z
T
m
n
m
n
m
T
x
x
x
x
x
a
a
a
"}
(23,1,1) = {"
a
a
a
x
x
x
x
x
x
X
p
c
j
m
m
j
T
x
x
x
T
m
n
m
n
m
p
q
x
x
x
b
a
a
a
"}
(24,1,1) = {"
a
a
a
x
x
x
x
x
x
x
T
W
c
m
c
u
T
x
x
x
T
m
c
m
m
c
T
x
x
x
x
x
a
a
a
"}
(25,1,1) = {"
a
a
a
x
x
x
x
x
x
x
T
T
p
T
p
T
T
x
x
x
T
T
p
T
p
T
T
x
x
x
x
x
a
a
a
"}
(26,1,1) = {"
a
a
a
x
x
x
x
x
U
f
x
x
X
x
X
x
x
x
x
x
x
x
q
x
q
x
x
x
x
x
x
x
a
a
a
"}
(27,1,1) = {"
a
a
a
x
x
x
x
x
g
U
x
x
x
l
x
x
x
x
x
x
x
x
x
x
x
x
x
x
x
x
x
x
a
a
a
"}
(28,1,1) = {"
a
a
a
x
x
x
x
x
x
x
x
x
x
x
x
x
x
x
x
x
k
x
x
x
x
x
x
x
x
x
x
x
a
a
a
"}
(29,1,1) = {"
a
a
a
x
x
x
x
x
x
x
x
x
x
x
x
x
x
x
x
x
x
x
x
x
x
x
x
x
x
x
x
x
a
a
a
"}
(30,1,1) = {"
a
a
a
x
x
x
x
x
x
x
x
x
x
x
x
x
x
x
x
x
x
x
N
x
b
x
x
x
x
x
x
x
a
a
a
"}
(31,1,1) = {"
a
a
a
x
x
x
x
x
x
x
x
x
x
x
x
x
x
x
x
x
x
x
x
x
x
x
x
x
x
x
x
x
a
a
a
"}
(32,1,1) = {"
a
a
a
x
x
x
x
x
x
x
x
x
x
x
x
x
x
x
x
x
x
x
x
x
x
x
x
x
x
x
x
x
a
a
a
"}
(33,1,1) = {"
a
a
a
a
a
a
a
a
a
a
a
a
a
a
a
a
a
a
a
a
a
a
a
a
a
a
a
a
a
a
a
a
a
a
a
"}
(34,1,1) = {"
a
a
a
a
a
a
a
a
a
a
a
a
a
a
a
a
a
a
a
a
a
a
a
a
a
a
a
a
a
a
a
a
a
a
a
"}
(35,1,1) = {"
a
a
a
a
a
a
a
a
a
a
a
a
a
a
a
a
a
a
a
a
a
a
a
a
a
a
a
a
a
a
a
a
a
a
a
"}
