//MAP CONVERTED BY dmm2tgm.py THIS HEADER COMMENT PREVENTS RECONVERSION, DO NOT REMOVE
"az" = (
/mob/living/carbon/human/ai_controlled/replicant,
/turf/simulated/floor/tiled/techfloor,
/area/submap/warzone)
"bt" = (
/mob/living/simple_mob/humanoid/merc/ranged/smg,
/turf/template_noop,
/area/submap/warzone)
"cV" = (
/turf/simulated/wall/rpshull,
/area/submap/warzone)
"ea" = (
/mob/living/simple_mob/humanoid/merc/ranged/rifle,
/turf/template_noop,
/area/submap/warzone)
"fh" = (
/mob/living/simple_mob/humanoid/pirate,
/turf/template_noop,
/area/submap/warzone)
"fZ" = (
/mob/living/simple_mob/humanoid/cultist/lizard,
/turf/template_noop,
/area/submap/warzone)
"gx" = (
/mob/living/simple_mob/humanoid/eclipse/solar/snipertesh,
/turf/template_noop,
/area/submap/warzone)
"gL" = (
/obj/structure/table/steel_reinforced,
/obj/item/weapon/telecube/randomized/mated,
/turf/simulated/floor/tiled/techfloor,
/area/submap/warzone)
"hq" = (
/mob/living/simple_mob/humanoid/eclipse/lunar/pummler,
/turf/template_noop,
/area/submap/warzone)
"ht" = (
/mob/living/simple_mob/humanoid/pirate/ranged,
/turf/template_noop,
/area/submap/warzone)
"jD" = (
/mob/living/simple_mob/humanoid/eclipse/lunar/shotgunner,
/turf/template_noop,
/area/submap/warzone)
"jY" = (
/obj/machinery/porta_turret/poi{
	faction = "xeno"
	},
/obj/effect/overlay/snow/floor,
/turf/simulated/floor{
	outdoors = 1
	},
/area/submap/warzone)
"ku" = (
/mob/living/simple_mob/humanoid/eclipse/solar/firemoff,
/turf/template_noop,
/area/submap/warzone)
"mm" = (
/obj/structure/table/steel_reinforced,
/obj/random/contraband/nofail,
/turf/simulated/floor/tiled/techfloor,
/area/submap/warzone)
"nj" = (
/obj/machinery/portable_atmospherics/hydroponics,
/turf/simulated/floor/tiled/techfloor,
/area/submap/warzone)
"oY" = (
/mob/living/simple_mob/humanoid/eclipse/lunar/ravanger,
/turf/template_noop,
/area/submap/warzone)
"sB" = (
/obj/structure/table/bench/padded,
/mob/living/carbon/human/ai_controlled/replicant,
/turf/simulated/floor/tiled/techfloor,
/area/submap/warzone)
"tU" = (
/mob/living/simple_mob/humanoid/eclipse/solar/teslanoodle,
/turf/template_noop,
/area/submap/warzone)
"ut" = (
/obj/structure/table/steel_reinforced,
/obj/random/cash,
/obj/random/maintenance,
/obj/random/material,
/obj/item/device/radio/headset/heads/captain/sfr,
/turf/simulated/floor/tiled/techfloor,
/area/submap/warzone)
"vA" = (
/mob/living/simple_mob/humanoid/merc/melee/sword,
/turf/template_noop,
/area/submap/warzone)
"vN" = (
/mob/living/simple_mob/humanoid/pirate/machete/armored,
/turf/template_noop,
/area/submap/warzone)
"vO" = (
/mob/living/simple_mob/humanoid/eclipse/lunar/silvernoodle,
/turf/template_noop,
/area/submap/warzone)
"xF" = (
/mob/living/simple_mob/humanoid/pirate/captain,
/turf/template_noop,
/area/submap/warzone)
"yb" = (
/mob/living/simple_mob/humanoid/pirate/ranged/handcannon/armored,
/turf/template_noop,
/area/submap/warzone)
"yO" = (
/mob/living/simple_mob/humanoid/cultist/human,
/turf/template_noop,
/area/submap/warzone)
"yW" = (
/obj/structure/table/steel_reinforced,
/obj/random/firstaid,
/obj/random/cash,
/obj/random/maintenance,
/obj/random/material,
/turf/simulated/floor/tiled/techfloor,
/area/submap/warzone)
"zc" = (
/obj/machinery/seed_extractor,
/turf/simulated/floor/tiled/techfloor,
/area/submap/warzone)
"AC" = (
/mob/living/simple_mob/humanoid/merc/ranged/laser,
/turf/template_noop,
/area/submap/warzone)
"BS" = (
/mob/living/simple_mob/humanoid/eclipse/solar/hellhound,
/turf/template_noop,
/area/submap/warzone)
"BU" = (
/mob/living/simple_mob/humanoid/eclipse/lunar/miner,
/turf/template_noop,
/area/submap/warzone)
"CY" = (
/turf/template_noop,
/area/template_noop)
"Dm" = (
/turf/simulated/floor/tiled/techfloor,
/area/submap/warzone)
"Fb" = (
/mob/living/simple_mob/humanoid/cultist/noodle,
/turf/template_noop,
/area/submap/warzone)
"Fm" = (
/obj/structure/table/steel_reinforced,
/obj/random/cash,
/obj/random/maintenance,
/obj/random/material,
/turf/simulated/floor/tiled/techfloor,
/area/submap/warzone)
"FN" = (
/obj/machinery/door/airlock/maintenance/int,
/turf/simulated/floor/tiled/techfloor,
/area/submap/warzone)
"FQ" = (
/obj/item/seeds/deathberryseed,
/obj/item/seeds/deathnettleseed,
/obj/item/seeds/gnomes,
/obj/item/seeds/icepepperseed,
/obj/item/seeds/rose/blood,
/obj/item/seeds/ambrosiagaiaseed,
/obj/item/seeds/ambrosiainfernusseed,
/obj/structure/closet,
/obj/item/seeds/icepepperseed,
/obj/item/seeds/icepepperseed,
/obj/item/seeds/poisonedappleseed,
/obj/item/seeds/poisonedappleseed,
/obj/item/seeds/telriis,
/obj/item/seeds/telriis,
/obj/item/seeds/replicapod,
/obj/item/seeds/replicapod,
/turf/simulated/floor/tiled/techfloor,
/area/submap/warzone)
"HI" = (
/mob/living/simple_mob/humanoid/cultist/human/bloodjaunt/fireball,
/turf/template_noop,
/area/submap/warzone)
"HW" = (
/mob/living/simple_mob/humanoid/merc/ranged/garand,
/turf/template_noop,
/area/submap/warzone)
"Jl" = (
/mob/living/simple_mob/humanoid/cultist/hunter,
/turf/template_noop,
/area/submap/warzone)
"LX" = (
/mob/living/simple_mob/humanoid/eclipse/lunar/wheel,
/turf/template_noop,
/area/submap/warzone)
"MX" = (
/obj/machinery/telecomms/relay/preset/ruskie,
/turf/simulated/floor/tiled/techfloor,
/area/submap/warzone)
"NH" = (
/mob/living/simple_mob/humanoid/eclipse/solar/guardian,
/turf/template_noop,
/area/submap/warzone)
"OT" = (
/obj/structure/grille,
/obj/structure/window/reinforced/full,
/turf/simulated/floor,
/area/submap/warzone)
"RV" = (
/mob/living/simple_mob/humanoid/merc/ranged/deagle,
/turf/template_noop,
/area/submap/warzone)
"SE" = (
/mob/living/simple_mob/humanoid/merc/ranged/sniper,
/turf/template_noop,
/area/submap/warzone)
"TJ" = (
/mob/living/simple_mob/humanoid/pirate/ranged/armored,
/turf/template_noop,
/area/submap/warzone)
"Uf" = (
/obj/structure/loot_pile/maint/technical,
/turf/simulated/floor/tiled/techfloor,
/area/submap/warzone)
"Vs" = (
/obj/structure/bookcase,
/turf/simulated/floor/tiled/techfloor,
/area/submap/warzone)
"Wc" = (
/mob/living/simple_mob/humanoid/pirate/mate/ranged/shotgun,
/turf/template_noop,
/area/submap/warzone)
"WC" = (
/turf/template_noop,
/area/submap/warzone)
"WZ" = (
/mob/living/simple_mob/humanoid/eclipse/lunar/aeroblaster,
/turf/template_noop,
/area/submap/warzone)
"Xw" = (
/obj/machinery/biogenerator,
/turf/simulated/floor/tiled/techfloor,
/area/submap/warzone)
"Zz" = (
/mob/living/simple_mob/humanoid/eclipse/solar/froststalker,
/turf/template_noop,
/area/submap/warzone)

(1,1,1) = {"
CY
CY
CY
CY
CY
CY
CY
CY
CY
CY
CY
CY
CY
CY
CY
CY
CY
CY
CY
CY
CY
CY
CY
CY
CY
CY
CY
CY
CY
CY
CY
CY
CY
CY
CY
"}
(2,1,1) = {"
CY
CY
CY
CY
CY
CY
CY
CY
CY
CY
CY
CY
CY
CY
CY
CY
CY
CY
CY
CY
CY
CY
CY
CY
CY
CY
CY
CY
CY
CY
CY
CY
CY
CY
CY
"}
(3,1,1) = {"
CY
CY
CY
CY
CY
CY
CY
CY
CY
CY
CY
CY
CY
CY
CY
CY
CY
CY
CY
CY
CY
CY
CY
CY
CY
CY
CY
CY
CY
CY
CY
CY
CY
CY
CY
"}
(4,1,1) = {"
CY
CY
CY
WC
WC
WC
WC
WC
WC
WC
WC
WC
WC
WC
WC
WC
WC
vA
WC
oY
WC
WC
WC
WC
jD
WC
WC
WC
WC
WC
WC
WC
CY
CY
CY
"}
(5,1,1) = {"
CY
CY
CY
WC
WC
WC
WC
WC
WC
WC
WC
WC
WC
WC
WC
WC
WC
vA
WC
oY
WC
WC
WC
WC
WC
WC
WC
WC
ku
WC
WC
WC
CY
CY
CY
"}
(6,1,1) = {"
CY
CY
CY
WC
WC
WC
WC
WC
WC
WC
WC
WC
WC
WC
WC
WC
WC
WC
WC
WC
WC
WC
hq
BU
WZ
LX
WC
WC
WC
WC
WC
WC
CY
CY
CY
"}
(7,1,1) = {"
CY
CY
CY
WC
WC
WC
WC
WC
SE
WC
WC
HW
WC
ea
WC
WC
WC
vA
WC
oY
WC
WC
WC
WC
WC
WC
Zz
WC
WC
WC
ku
WC
CY
CY
CY
"}
(8,1,1) = {"
CY
CY
CY
WC
WC
WC
WC
WC
WC
RV
WC
WC
AC
WC
bt
WC
WC
vA
WC
oY
WC
WC
WC
WC
vO
WC
WC
WC
WC
WC
WC
WC
CY
CY
CY
"}
(9,1,1) = {"
CY
CY
CY
WC
WC
WC
WC
WC
WC
WC
cV
cV
OT
cV
OT
cV
cV
WC
WC
WC
cV
cV
OT
cV
OT
cV
cV
WC
Zz
WC
WC
WC
CY
CY
CY
"}
(10,1,1) = {"
CY
CY
CY
WC
WC
WC
WC
WC
HW
WC
cV
MX
mm
MX
mm
MX
cV
WC
WC
WC
cV
Dm
yW
Fm
Fm
ut
cV
WC
WC
BS
WC
WC
CY
CY
CY
"}
(11,1,1) = {"
CY
CY
CY
WC
WC
WC
WC
WC
WC
AC
OT
mm
az
Dm
az
Uf
cV
WC
WC
WC
cV
Dm
sB
Dm
sB
Fm
OT
tU
WC
gx
WC
ku
CY
CY
CY
"}
(12,1,1) = {"
CY
CY
CY
WC
WC
WC
WC
WC
ea
WC
cV
MX
Dm
Dm
Dm
Uf
cV
jY
WC
jY
cV
Dm
Dm
Dm
Dm
Fm
cV
WC
WC
NH
WC
WC
CY
CY
CY
"}
(13,1,1) = {"
CY
CY
CY
WC
WC
WC
WC
WC
WC
bt
OT
mm
az
Dm
Dm
Dm
cV
cV
FN
cV
cV
Dm
Dm
Dm
sB
yW
OT
WC
WC
Zz
WC
WC
CY
CY
CY
"}
(14,1,1) = {"
CY
CY
CY
WC
WC
WC
WC
WC
WC
WC
cV
MX
Uf
Uf
Dm
Dm
Dm
Dm
Dm
Dm
Dm
Dm
Dm
Dm
Dm
Dm
cV
WC
WC
WC
WC
WC
CY
CY
CY
"}
(15,1,1) = {"
CY
CY
CY
WC
WC
WC
WC
WC
WC
WC
cV
cV
cV
cV
cV
Dm
az
cV
FN
cV
az
Dm
cV
cV
cV
cV
cV
WC
WC
WC
WC
WC
CY
CY
CY
"}
(16,1,1) = {"
CY
CY
CY
WC
WC
vA
vA
WC
vA
vA
WC
WC
WC
jY
cV
Dm
cV
az
Dm
az
cV
Dm
cV
jY
WC
WC
WC
oY
oY
WC
oY
oY
CY
CY
CY
"}
(17,1,1) = {"
CY
CY
CY
WC
WC
WC
WC
WC
WC
WC
WC
WC
WC
WC
FN
Dm
FN
Dm
gL
Dm
FN
Dm
FN
WC
WC
WC
WC
WC
WC
WC
WC
WC
CY
CY
CY
"}
(18,1,1) = {"
CY
CY
CY
WC
WC
fh
fh
WC
fh
fh
WC
WC
WC
jY
cV
Dm
cV
az
Dm
az
cV
Dm
cV
jY
WC
WC
WC
yO
yO
WC
yO
yO
CY
CY
CY
"}
(19,1,1) = {"
CY
CY
CY
WC
WC
WC
ht
WC
ht
WC
cV
cV
cV
cV
cV
Dm
az
cV
FN
cV
az
Dm
cV
cV
cV
cV
cV
WC
WC
WC
WC
WC
CY
CY
CY
"}
(20,1,1) = {"
CY
CY
CY
WC
WC
WC
WC
WC
WC
WC
cV
Xw
nj
nj
Dm
Dm
Dm
Dm
Dm
Dm
Dm
Dm
Dm
Dm
Dm
Dm
cV
WC
WC
fZ
WC
WC
CY
CY
CY
"}
(21,1,1) = {"
CY
CY
CY
WC
WC
WC
WC
WC
WC
vN
OT
az
Dm
Dm
Dm
Dm
cV
cV
FN
cV
cV
Dm
Vs
Dm
Vs
az
OT
Jl
WC
WC
WC
Fb
CY
CY
CY
"}
(22,1,1) = {"
CY
CY
CY
WC
WC
WC
WC
WC
yb
WC
cV
Dm
Dm
nj
Dm
nj
cV
jY
WC
jY
cV
Dm
Vs
Dm
Vs
Dm
cV
WC
WC
WC
WC
WC
CY
CY
CY
"}
(23,1,1) = {"
CY
CY
CY
WC
WC
WC
WC
WC
WC
vN
OT
az
nj
Dm
Dm
nj
cV
WC
WC
WC
cV
Dm
Vs
Dm
Vs
Dm
OT
Jl
WC
WC
WC
HI
CY
CY
CY
"}
(24,1,1) = {"
CY
CY
CY
WC
WC
WC
WC
WC
WC
WC
cV
FQ
az
Dm
az
zc
cV
WC
WC
WC
cV
Dm
az
Dm
Dm
az
cV
WC
WC
WC
WC
WC
CY
CY
CY
"}
(25,1,1) = {"
CY
CY
CY
WC
WC
WC
WC
WC
WC
WC
cV
cV
OT
cV
OT
cV
cV
WC
WC
WC
cV
cV
OT
cV
OT
cV
cV
WC
WC
WC
WC
WC
CY
CY
CY
"}
(26,1,1) = {"
CY
CY
CY
WC
WC
WC
WC
WC
TJ
xF
WC
WC
vN
WC
vN
WC
WC
fh
WC
yO
WC
WC
Jl
WC
Jl
WC
WC
WC
WC
WC
WC
WC
CY
CY
CY
"}
(27,1,1) = {"
CY
CY
CY
WC
WC
WC
WC
WC
Wc
TJ
WC
WC
WC
yb
WC
WC
ht
fh
WC
yO
WC
WC
WC
WC
WC
WC
WC
WC
WC
WC
WC
WC
CY
CY
CY
"}
(28,1,1) = {"
CY
CY
CY
WC
WC
WC
WC
WC
WC
WC
WC
WC
WC
WC
WC
WC
WC
WC
WC
WC
fZ
WC
WC
WC
WC
WC
WC
WC
WC
WC
WC
WC
CY
CY
CY
"}
(29,1,1) = {"
CY
CY
CY
WC
WC
WC
WC
WC
WC
WC
WC
WC
WC
WC
WC
WC
ht
fh
WC
yO
WC
WC
WC
WC
WC
WC
WC
WC
WC
WC
WC
WC
CY
CY
CY
"}
(30,1,1) = {"
CY
CY
CY
WC
WC
WC
WC
WC
WC
WC
WC
WC
WC
WC
WC
WC
WC
fh
WC
yO
WC
WC
Fb
WC
HI
WC
WC
WC
WC
WC
WC
WC
CY
CY
CY
"}
(31,1,1) = {"
CY
CY
CY
WC
WC
WC
WC
WC
WC
WC
WC
WC
WC
WC
WC
WC
WC
WC
WC
WC
WC
WC
WC
WC
WC
WC
WC
WC
WC
WC
WC
WC
CY
CY
CY
"}
(32,1,1) = {"
CY
CY
CY
WC
WC
WC
WC
WC
WC
WC
WC
WC
WC
WC
WC
WC
WC
WC
WC
WC
WC
WC
WC
WC
WC
WC
WC
WC
WC
WC
WC
WC
CY
CY
CY
"}
(33,1,1) = {"
CY
CY
CY
CY
CY
CY
CY
CY
CY
CY
CY
CY
CY
CY
CY
CY
CY
CY
CY
CY
CY
CY
CY
CY
CY
CY
CY
CY
CY
CY
CY
CY
CY
CY
CY
"}
(34,1,1) = {"
CY
CY
CY
CY
CY
CY
CY
CY
CY
CY
CY
CY
CY
CY
CY
CY
CY
CY
CY
CY
CY
CY
CY
CY
CY
CY
CY
CY
CY
CY
CY
CY
CY
CY
CY
"}
(35,1,1) = {"
CY
CY
CY
CY
CY
CY
CY
CY
CY
CY
CY
CY
CY
CY
CY
CY
CY
CY
CY
CY
CY
CY
CY
CY
CY
CY
CY
CY
CY
CY
CY
CY
CY
CY
CY
"}
