//MAP CONVERTED BY dmm2tgm.py THIS HEADER COMMENT PREVENTS RECONVERSION, DO NOT REMOVE
"az" = (
/mob/living/carbon/human/ai_controlled/replicant,
/turf/simulated/floor/tiled/techfloor,
/area/submap/warzone)
"bt" = (
/mob/living/carbon/human/ai_controlled/replicant,
/mob/living/carbon/human/ai_controlled/replicant,
/turf/simulated/floor/tiled/techfloor,
/area/submap/warzone)
"cV" = (
/turf/simulated/wall/rpshull,
/area/submap/warzone)
"gL" = (
/obj/structure/table/steel_reinforced,
/obj/item/telecube/randomized/mated,
/turf/simulated/floor/tiled/techfloor,
/area/submap/warzone)
"jY" = (
/obj/machinery/porta_turret/poi{
	faction = "xeno"
	},
/obj/effect/overlay/snow/floor,
/turf/simulated/floor{
	outdoors = 1
	},
/area/submap/warzone)
"mm" = (
/obj/structure/table/steel_reinforced,
/obj/random/contraband/nofail,
/turf/simulated/floor/tiled/techfloor,
/area/submap/warzone)
"nj" = (
/obj/machinery/portable_atmospherics/hydroponics,
/turf/simulated/floor/tiled/techfloor,
/area/submap/warzone)
"sB" = (
/obj/structure/table/bench/padded,
/mob/living/carbon/human/ai_controlled/replicant,
/turf/simulated/floor/tiled/techfloor,
/area/submap/warzone)
"ut" = (
/obj/structure/table/steel_reinforced,
/obj/random/cash,
/obj/random/maintenance,
/obj/random/material,
/obj/item/radio/headset/heads/captain/sfr,
/turf/simulated/floor/tiled/techfloor,
/area/submap/warzone)
"yW" = (
/obj/structure/table/steel_reinforced,
/obj/random/firstaid,
/obj/random/cash,
/obj/random/maintenance,
/obj/random/material,
/turf/simulated/floor/tiled/techfloor,
/area/submap/warzone)
"zc" = (
/obj/machinery/seed_extractor,
/turf/simulated/floor/tiled/techfloor,
/area/submap/warzone)
"CY" = (
/turf/template_noop,
/area/template_noop)
"Dm" = (
/turf/simulated/floor/tiled/techfloor,
/area/submap/warzone)
"Fm" = (
/obj/structure/table/steel_reinforced,
/obj/random/cash,
/obj/random/maintenance,
/obj/random/material,
/turf/simulated/floor/tiled/techfloor,
/area/submap/warzone)
"FN" = (
/obj/machinery/door/airlock/maintenance/int,
/turf/simulated/floor/tiled/techfloor,
/area/submap/warzone)
"FQ" = (
/obj/item/seeds/deathberryseed,
/obj/item/seeds/deathnettleseed,
/obj/item/seeds/gnomes,
/obj/item/seeds/icepepperseed,
/obj/item/seeds/rose/blood,
/obj/item/seeds/ambrosiagaiaseed,
/obj/item/seeds/ambrosiainfernusseed,
/obj/structure/closet,
/obj/item/seeds/icepepperseed,
/obj/item/seeds/icepepperseed,
/obj/item/seeds/poisonedappleseed,
/obj/item/seeds/poisonedappleseed,
/obj/item/seeds/telriis,
/obj/item/seeds/telriis,
/obj/item/seeds/replicapod,
/obj/item/seeds/replicapod,
/turf/simulated/floor/tiled/techfloor,
/area/submap/warzone)
"MX" = (
/obj/machinery/telecomms/relay/preset/ruskie,
/turf/simulated/floor/tiled/techfloor,
/area/submap/warzone)
"OT" = (
/obj/structure/grille,
/obj/structure/window/reinforced/full,
/turf/simulated/floor,
/area/submap/warzone)
"Uf" = (
/obj/structure/loot_pile/maint/technical,
/turf/simulated/floor/tiled/techfloor,
/area/submap/warzone)
"Vs" = (
/obj/structure/bookcase,
/turf/simulated/floor/tiled/techfloor,
/area/submap/warzone)
"WC" = (
/turf/template_noop,
/area/submap/warzone)
"Xw" = (
/obj/machinery/biogenerator,
/turf/simulated/floor/tiled/techfloor,
/area/submap/warzone)

(1,1,1) = {"
CY
CY
CY
CY
CY
CY
CY
CY
CY
CY
CY
CY
CY
CY
CY
CY
CY
CY
CY
CY
CY
CY
CY
CY
CY
CY
CY
CY
CY
CY
CY
CY
CY
CY
CY
"}
(2,1,1) = {"
CY
CY
CY
CY
CY
CY
CY
CY
CY
CY
CY
CY
CY
CY
CY
CY
CY
CY
CY
CY
CY
CY
CY
CY
CY
CY
CY
CY
CY
CY
CY
CY
CY
CY
CY
"}
(3,1,1) = {"
CY
CY
CY
CY
CY
CY
CY
CY
CY
CY
CY
CY
CY
CY
CY
CY
CY
CY
CY
CY
CY
CY
CY
CY
CY
CY
CY
CY
CY
CY
CY
CY
CY
CY
CY
"}
(4,1,1) = {"
CY
CY
CY
WC
WC
WC
WC
WC
WC
WC
WC
WC
WC
WC
WC
WC
WC
WC
WC
WC
WC
WC
WC
WC
WC
WC
WC
WC
WC
WC
WC
WC
CY
CY
CY
"}
(5,1,1) = {"
CY
CY
CY
WC
WC
WC
WC
WC
WC
WC
WC
WC
WC
WC
WC
WC
WC
WC
WC
WC
WC
WC
WC
WC
WC
WC
WC
WC
WC
WC
WC
WC
CY
CY
CY
"}
(6,1,1) = {"
CY
CY
CY
WC
WC
WC
WC
WC
WC
WC
WC
WC
WC
WC
WC
WC
WC
WC
WC
WC
WC
WC
WC
WC
WC
WC
WC
WC
WC
WC
WC
WC
CY
CY
CY
"}
(7,1,1) = {"
CY
CY
CY
WC
WC
WC
WC
WC
WC
WC
WC
WC
WC
WC
WC
WC
WC
WC
WC
WC
WC
WC
WC
WC
WC
WC
WC
WC
WC
WC
WC
WC
CY
CY
CY
"}
(8,1,1) = {"
CY
CY
CY
WC
WC
WC
WC
WC
WC
WC
WC
WC
WC
WC
WC
WC
WC
WC
WC
WC
WC
WC
WC
WC
WC
WC
WC
WC
WC
WC
WC
WC
CY
CY
CY
"}
(9,1,1) = {"
CY
CY
CY
WC
WC
WC
WC
WC
WC
WC
cV
cV
OT
cV
OT
cV
cV
WC
WC
WC
cV
cV
OT
cV
OT
cV
cV
WC
WC
WC
WC
WC
CY
CY
CY
"}
(10,1,1) = {"
CY
CY
CY
WC
WC
WC
WC
WC
WC
WC
cV
MX
mm
MX
mm
MX
cV
WC
WC
WC
cV
Dm
yW
Fm
Fm
ut
cV
WC
WC
WC
WC
WC
CY
CY
CY
"}
(11,1,1) = {"
CY
CY
CY
WC
WC
WC
WC
WC
WC
WC
OT
mm
az
Dm
az
Uf
cV
WC
WC
WC
cV
Dm
sB
Dm
sB
Fm
OT
WC
WC
WC
WC
WC
CY
CY
CY
"}
(12,1,1) = {"
CY
CY
CY
WC
WC
WC
WC
WC
WC
WC
cV
MX
Dm
Dm
Dm
Uf
cV
jY
WC
jY
cV
Dm
Dm
Dm
Dm
Fm
cV
WC
WC
WC
WC
WC
CY
CY
CY
"}
(13,1,1) = {"
CY
CY
CY
WC
WC
WC
WC
WC
WC
WC
OT
mm
az
Dm
Dm
Dm
cV
cV
FN
cV
cV
Dm
Dm
Dm
sB
yW
OT
WC
WC
WC
WC
WC
CY
CY
CY
"}
(14,1,1) = {"
CY
CY
CY
WC
WC
WC
WC
WC
WC
WC
cV
MX
Uf
Uf
Dm
Dm
Dm
Dm
Dm
Dm
Dm
Dm
Dm
Dm
Dm
Dm
cV
WC
WC
WC
WC
WC
CY
CY
CY
"}
(15,1,1) = {"
CY
CY
CY
WC
WC
WC
WC
WC
WC
WC
cV
cV
cV
cV
cV
Dm
bt
cV
FN
cV
bt
Dm
cV
cV
cV
cV
cV
WC
WC
WC
WC
WC
CY
CY
CY
"}
(16,1,1) = {"
CY
CY
CY
WC
WC
WC
WC
WC
WC
WC
WC
WC
WC
jY
cV
Dm
cV
az
Dm
az
cV
Dm
cV
jY
WC
WC
WC
WC
WC
WC
WC
WC
CY
CY
CY
"}
(17,1,1) = {"
CY
CY
CY
WC
WC
WC
WC
WC
WC
WC
WC
WC
WC
WC
FN
Dm
FN
Dm
gL
Dm
FN
Dm
FN
WC
WC
WC
WC
WC
WC
WC
WC
WC
CY
CY
CY
"}
(18,1,1) = {"
CY
CY
CY
WC
WC
WC
WC
WC
WC
WC
WC
WC
WC
jY
cV
Dm
cV
az
Dm
az
cV
Dm
cV
jY
WC
WC
WC
WC
WC
WC
WC
WC
CY
CY
CY
"}
(19,1,1) = {"
CY
CY
CY
WC
WC
WC
WC
WC
WC
WC
cV
cV
cV
cV
cV
Dm
bt
cV
FN
cV
bt
Dm
cV
cV
cV
cV
cV
WC
WC
WC
WC
WC
CY
CY
CY
"}
(20,1,1) = {"
CY
CY
CY
WC
WC
WC
WC
WC
WC
WC
cV
Xw
nj
nj
Dm
Dm
Dm
Dm
Dm
Dm
Dm
Dm
Dm
Dm
Dm
Dm
cV
WC
WC
WC
WC
WC
CY
CY
CY
"}
(21,1,1) = {"
CY
CY
CY
WC
WC
WC
WC
WC
WC
WC
OT
az
Dm
Dm
Dm
Dm
cV
cV
FN
cV
cV
Dm
Vs
Dm
Vs
az
OT
WC
WC
WC
WC
WC
CY
CY
CY
"}
(22,1,1) = {"
CY
CY
CY
WC
WC
WC
WC
WC
WC
WC
cV
Dm
Dm
nj
Dm
nj
cV
jY
WC
jY
cV
Dm
Vs
Dm
Vs
Dm
cV
WC
WC
WC
WC
WC
CY
CY
CY
"}
(23,1,1) = {"
CY
CY
CY
WC
WC
WC
WC
WC
WC
WC
OT
az
nj
Dm
Dm
nj
cV
WC
WC
WC
cV
Dm
Vs
Dm
Vs
Dm
OT
WC
WC
WC
WC
WC
CY
CY
CY
"}
(24,1,1) = {"
CY
CY
CY
WC
WC
WC
WC
WC
WC
WC
cV
FQ
az
Dm
az
zc
cV
WC
WC
WC
cV
Dm
az
Dm
Dm
az
cV
WC
WC
WC
WC
WC
CY
CY
CY
"}
(25,1,1) = {"
CY
CY
CY
WC
WC
WC
WC
WC
WC
WC
cV
cV
OT
cV
OT
cV
cV
WC
WC
WC
cV
cV
OT
cV
OT
cV
cV
WC
WC
WC
WC
WC
CY
CY
CY
"}
(26,1,1) = {"
CY
CY
CY
WC
WC
WC
WC
WC
WC
WC
WC
WC
WC
WC
WC
WC
WC
WC
WC
WC
WC
WC
WC
WC
WC
WC
WC
WC
WC
WC
WC
WC
CY
CY
CY
"}
(27,1,1) = {"
CY
CY
CY
WC
WC
WC
WC
WC
WC
WC
WC
WC
WC
WC
WC
WC
WC
WC
WC
WC
WC
WC
WC
WC
WC
WC
WC
WC
WC
WC
WC
WC
CY
CY
CY
"}
(28,1,1) = {"
CY
CY
CY
WC
WC
WC
WC
WC
WC
WC
WC
WC
WC
WC
WC
WC
WC
WC
WC
WC
WC
WC
WC
WC
WC
WC
WC
WC
WC
WC
WC
WC
CY
CY
CY
"}
(29,1,1) = {"
CY
CY
CY
WC
WC
WC
WC
WC
WC
WC
WC
WC
WC
WC
WC
WC
WC
WC
WC
WC
WC
WC
WC
WC
WC
WC
WC
WC
WC
WC
WC
WC
CY
CY
CY
"}
(30,1,1) = {"
CY
CY
CY
WC
WC
WC
WC
WC
WC
WC
WC
WC
WC
WC
WC
WC
WC
WC
WC
WC
WC
WC
WC
WC
WC
WC
WC
WC
WC
WC
WC
WC
CY
CY
CY
"}
(31,1,1) = {"
CY
CY
CY
WC
WC
WC
WC
WC
WC
WC
WC
WC
WC
WC
WC
WC
WC
WC
WC
WC
WC
WC
WC
WC
WC
WC
WC
WC
WC
WC
WC
WC
CY
CY
CY
"}
(32,1,1) = {"
CY
CY
CY
WC
WC
WC
WC
WC
WC
WC
WC
WC
WC
WC
WC
WC
WC
WC
WC
WC
WC
WC
WC
WC
WC
WC
WC
WC
WC
WC
WC
WC
CY
CY
CY
"}
(33,1,1) = {"
CY
CY
CY
CY
CY
CY
CY
CY
CY
CY
CY
CY
CY
CY
CY
CY
CY
CY
CY
CY
CY
CY
CY
CY
CY
CY
CY
CY
CY
CY
CY
CY
CY
CY
CY
"}
(34,1,1) = {"
CY
CY
CY
CY
CY
CY
CY
CY
CY
CY
CY
CY
CY
CY
CY
CY
CY
CY
CY
CY
CY
CY
CY
CY
CY
CY
CY
CY
CY
CY
CY
CY
CY
CY
CY
"}
(35,1,1) = {"
CY
CY
CY
CY
CY
CY
CY
CY
CY
CY
CY
CY
CY
CY
CY
CY
CY
CY
CY
CY
CY
CY
CY
CY
CY
CY
CY
CY
CY
CY
CY
CY
CY
CY
CY
"}
