//MAP CONVERTED BY dmm2tgm.py THIS HEADER COMMENT PREVENTS RECONVERSION, DO NOT REMOVE
"a" = (
/turf/template_noop,
/area/template_noop)
"b" = (
/obj/random/outcrop,
/turf/simulated/mineral/floor/vacuum,
/area/submap/asteroid3)
"c" = (
/turf/simulated/mineral,
/area/submap/asteroid3)
"d" = (
/turf/simulated/mineral/floor/vacuum,
/area/submap/asteroid3)
"e" = (
/obj/effect/decal/remains/human,
/turf/simulated/mineral/floor/vacuum,
/area/submap/asteroid3)
"f" = (
/obj/item/weapon/pickaxe/diamond,
/turf/simulated/mineral/floor/vacuum,
/area/submap/asteroid3)
"i" = (
/obj/structure/outcrop/gold,
/turf/simulated/mineral/floor/vacuum,
/area/submap/asteroid3)
"p" = (
/obj/structure/outcrop/uranium,
/turf/simulated/mineral/floor/vacuum,
/area/submap/asteroid3)
"I" = (
/obj/item/stack/material/supermatter{
	amount = 7
	},
/turf/simulated/mineral/floor/vacuum,
/area/submap/asteroid3)

(1,1,1) = {"
a
a
a
a
d
a
a
a
a
a
i
c
c
c
c
d
a
a
a
a
"}
(2,1,1) = {"
a
a
a
a
a
a
a
a
a
d
d
d
d
c
c
c
c
c
a
a
"}
(3,1,1) = {"
a
a
b
d
a
d
d
d
a
d
d
d
d
c
c
d
i
d
d
a
"}
(4,1,1) = {"
a
a
d
d
i
d
c
c
i
d
c
i
b
c
c
d
d
d
d
a
"}
(5,1,1) = {"
a
a
d
d
c
c
c
c
c
c
c
c
c
c
c
b
d
d
c
a
"}
(6,1,1) = {"
a
a
a
i
c
c
c
c
c
c
c
c
p
c
c
c
c
c
d
a
"}
(7,1,1) = {"
a
a
a
a
d
i
c
b
c
c
p
d
d
d
c
c
c
c
d
a
"}
(8,1,1) = {"
a
a
a
d
d
c
c
c
c
d
d
I
f
d
d
c
c
i
d
d
"}
(9,1,1) = {"
a
a
a
d
d
c
c
c
c
d
p
e
d
d
p
c
c
c
d
d
"}
(10,1,1) = {"
a
a
a
d
d
c
c
p
d
d
d
d
d
p
c
c
c
c
c
d
"}
(11,1,1) = {"
a
a
a
i
d
c
c
c
c
c
d
p
c
c
c
c
d
d
d
b
"}
(12,1,1) = {"
a
a
a
a
d
d
b
c
c
c
c
c
c
c
c
c
d
d
d
i
"}
(13,1,1) = {"
a
a
a
a
d
d
d
c
c
c
b
c
c
c
c
c
c
d
d
a
"}
(14,1,1) = {"
a
a
a
a
d
d
i
c
c
c
c
c
c
c
c
i
d
d
a
a
"}
(15,1,1) = {"
a
a
b
a
d
c
c
c
c
c
c
c
c
c
c
d
a
a
a
d
"}
(16,1,1) = {"
a
a
a
a
i
d
d
c
c
c
c
c
c
d
d
a
a
a
a
a
"}
(17,1,1) = {"
a
a
a
a
a
b
d
c
c
d
d
c
c
d
b
a
a
a
a
a
"}
(18,1,1) = {"
a
a
a
a
a
a
a
a
c
i
b
a
a
a
a
a
a
a
a
a
"}
(19,1,1) = {"
a
a
a
a
d
a
a
a
a
a
a
a
a
a
i
a
a
a
b
a
"}
(20,1,1) = {"
a
a
a
a
a
a
a
a
a
a
a
a
a
a
a
a
a
a
a
a
"}
