//MAP CONVERTED BY dmm2tgm.py THIS HEADER COMMENT PREVENTS RECONVERSION, DO NOT REMOVE
"a" = (
/turf/template_noop,
/area/template_noop)
"b" = (
/obj/random/outcrop,
/turf/simulated/mineral/floor/vacuum,
/area/submap/asteroid1)
"c" = (
/turf/simulated/mineral/vacuum,
/area/submap/asteroid1)
"g" = (
/obj/structure/outcrop/phoron,
/turf/simulated/mineral/floor/vacuum,
/area/submap/asteroid1)
"t" = (
/obj/structure/outcrop/gold,
/turf/simulated/mineral/floor/vacuum,
/area/submap/asteroid1)
"P" = (
/obj/structure/outcrop/diamond,
/turf/simulated/mineral/floor/vacuum,
/area/submap/asteroid1)
"V" = (
/obj/structure/outcrop/uranium,
/turf/simulated/mineral/floor/vacuum,
/area/submap/asteroid1)
"Z" = (
/turf/simulated/mineral/floor/vacuum,
/area/submap/asteroid1)

(1,1,1) = {"
a
a
a
a
a
a
a
a
a
a
a
a
a
a
a
a
a
a
a
a
"}
(2,1,1) = {"
a
a
a
a
a
a
a
a
a
a
a
a
a
a
a
a
a
a
a
a
"}
(3,1,1) = {"
a
a
a
a
a
a
a
a
a
a
a
a
a
a
a
a
a
a
a
a
"}
(4,1,1) = {"
a
a
a
a
a
a
a
a
a
a
a
a
c
Z
g
a
a
a
a
a
"}
(5,1,1) = {"
a
a
a
c
c
a
a
a
a
a
a
g
Z
b
Z
a
a
a
b
a
"}
(6,1,1) = {"
a
a
a
c
b
a
a
a
a
Z
P
c
t
Z
g
a
a
a
a
a
"}
(7,1,1) = {"
a
a
a
a
g
a
a
a
a
V
c
c
c
a
a
a
a
a
a
a
"}
(8,1,1) = {"
a
a
a
a
a
a
a
a
g
Z
c
c
P
a
a
a
a
a
a
a
"}
(9,1,1) = {"
a
a
a
a
a
a
a
a
a
t
b
a
a
a
a
a
a
a
a
a
"}
(10,1,1) = {"
a
a
a
a
a
Z
a
a
a
a
a
a
a
a
a
a
a
a
a
a
"}
(11,1,1) = {"
a
a
a
a
a
b
t
Z
a
a
a
a
a
a
a
a
a
a
a
a
"}
(12,1,1) = {"
a
a
a
a
a
c
c
a
a
a
a
Z
Z
a
a
a
a
P
Z
a
"}
(13,1,1) = {"
a
a
a
a
a
g
a
a
a
a
a
c
P
Z
a
a
a
c
g
a
"}
(14,1,1) = {"
a
a
a
a
a
a
a
a
a
a
a
c
c
V
a
a
a
a
a
a
"}
(15,1,1) = {"
a
a
a
a
a
a
a
a
a
V
c
c
c
a
a
a
a
a
a
a
"}
(16,1,1) = {"
a
a
a
a
a
a
a
a
a
P
c
c
a
a
a
a
a
a
a
a
"}
(17,1,1) = {"
a
a
a
a
a
a
a
a
a
Z
t
Z
a
a
a
a
a
a
a
a
"}
(18,1,1) = {"
a
a
b
a
a
a
a
a
a
a
a
a
a
a
a
a
a
a
a
a
"}
(19,1,1) = {"
a
a
a
a
a
a
a
a
a
a
a
a
a
a
a
a
a
a
a
a
"}
(20,1,1) = {"
a
a
a
a
a
a
a
a
a
a
a
a
a
a
a
a
a
a
a
a
"}
