//MAP CONVERTED BY dmm2tgm.py THIS HEADER COMMENT PREVENTS RECONVERSION, DO NOT REMOVE
"a" = (
/turf/template_noop,
/area/template_noop)
"b" = (
/obj/structure/window/reinforced{
	dir = 4;
	tag = "icon-rwindow (EAST)"
	},
/turf/template_noop,
/area/submap/derelict2)
"c" = (
/obj/machinery/door/airlock/external,
/turf/simulated/floor/plating,
/area/submap/derelict2)
"d" = (
/obj/structure/window/reinforced{
	dir = 8;
	tag = "icon-rwindow (WEST)"
	},
/turf/template_noop,
/area/submap/derelict2)
"e" = (
/obj/structure/window/reinforced{
	dir = 4;
	tag = "icon-rwindow (EAST)"
	},
/obj/structure/window/reinforced{
	dir = 8;
	tag = "icon-rwindow (WEST)"
	},
/turf/simulated/floor/plating,
/area/submap/derelict2)
"f" = (
/turf/simulated/wall,
/area/submap/derelict2)
"g" = (
/obj/effect/wingrille_spawn/reinforced,
/turf/simulated/floor/tiled/asteroid_steel,
/turf/simulated/floor/plating,
/area/submap/derelict2)
"h" = (
/obj/machinery/light/small{
	dir = 1;
	tag = "icon-bulb1 (NORTH)"
	},
/turf/simulated/floor/tiled/asteroid_steel/airless,
/area/submap/derelict2)
"i" = (
/turf/simulated/floor/tiled/asteroid_steel/airless,
/area/submap/derelict2)
"j" = (
/obj/machinery/light/small{
	dir = 4;
	tag = "icon-bulb1 (EAST)"
	},
/turf/simulated/floor/tiled/asteroid_steel/airless,
/area/submap/derelict2)
"k" = (
/obj/structure/window/reinforced,
/turf/template_noop,
/area/submap/derelict2)
"l" = (
/obj/structure/window/reinforced,
/obj/structure/window/reinforced{
	dir = 1;
	tag = "icon-rwindow (NORTH)"
	},
/turf/simulated/floor/plating,
/area/submap/derelict2)
"m" = (
/obj/effect/decal/remains/human,
/obj/structure/bed/chair{
	dir = 4
	},
/turf/simulated/floor/tiled/asteroid_steel/airless,
/area/submap/derelict2)
"n" = (
/obj/item/trash/plate{
	pixel_x = 10
	},
/obj/item/trash/plate{
	pixel_x = -10
	},
/obj/structure/table/glass,
/obj/item/weapon/flame/candle/everburn,
/turf/simulated/floor/tiled/asteroid_steel/airless,
/area/submap/derelict2)
"o" = (
/obj/effect/decal/remains/human,
/obj/structure/bed/chair{
	dir = 8
	},
/obj/item/clothing/ears/earring/stud/diamond,
/turf/simulated/floor/tiled/asteroid_steel/airless,
/area/submap/derelict2)
"p" = (
/obj/structure/window/reinforced{
	dir = 1;
	tag = "icon-rwindow (NORTH)"
	},
/turf/template_noop,
/area/submap/derelict2)
"q" = (
/obj/machinery/light/small{
	dir = 8;
	tag = "icon-bulb1 (WEST)"
	},
/turf/simulated/floor/tiled/asteroid_steel/airless,
/area/submap/derelict2)
"r" = (
/obj/machinery/light/small,
/turf/simulated/floor/tiled/asteroid_steel/airless,
/area/submap/derelict2)
"D" = (
/obj/item/toy/bosunwhistle/fluff/strix,
/turf/simulated/floor/tiled/asteroid_steel/airless,
/area/submap/derelict2)
"I" = (
/obj/item/weapon/coin/gold,
/turf/simulated/floor/tiled/asteroid_steel/airless,
/area/submap/derelict2)
"V" = (
/obj/effect/wingrille_spawn/reinforced,
/turf/simulated/floor/plating,
/turf/space,
/area/submap/derelict2)

(1,1,1) = {"
a
a
a
a
a
a
a
a
a
a
a
a
a
a
a
a
a
a
a
a
a
a
a
a
a
a
a
a
a
a
a
a
a
a
a
a
a
a
a
a
"}
(2,1,1) = {"
a
a
a
a
a
a
a
a
a
a
a
a
a
a
a
a
a
a
a
a
a
a
a
a
a
a
a
a
a
a
a
a
a
a
a
a
a
a
a
a
"}
(3,1,1) = {"
a
a
a
a
a
a
a
a
a
a
a
a
a
a
a
a
a
a
a
a
a
a
a
a
a
a
a
a
a
a
a
a
a
a
a
a
a
a
a
a
"}
(4,1,1) = {"
a
a
a
a
a
a
a
a
a
a
a
a
a
a
a
a
a
a
a
a
a
a
a
a
a
a
a
a
a
a
a
a
a
a
a
a
a
a
a
a
"}
(5,1,1) = {"
a
a
a
a
a
a
a
a
a
a
a
a
a
a
a
a
a
a
a
a
a
a
a
a
a
a
a
a
a
a
a
a
a
a
a
a
a
a
a
a
"}
(6,1,1) = {"
a
a
a
a
a
a
a
a
a
a
a
a
a
a
a
a
a
a
a
a
a
a
a
a
a
a
a
a
a
a
a
a
a
a
a
a
a
a
a
a
"}
(7,1,1) = {"
a
a
a
a
a
a
a
a
a
a
a
a
a
a
a
a
a
a
a
a
a
a
a
a
a
a
a
a
a
a
a
a
a
a
a
a
a
a
a
a
"}
(8,1,1) = {"
a
a
a
a
a
a
a
a
a
a
a
a
a
a
a
a
a
a
a
a
a
a
a
a
a
a
a
a
a
a
a
a
a
a
a
a
a
a
a
a
"}
(9,1,1) = {"
a
a
a
a
a
a
a
a
a
a
a
a
a
a
a
a
a
a
a
a
a
a
a
a
a
a
a
a
a
a
a
a
a
a
a
a
a
a
a
a
"}
(10,1,1) = {"
a
a
a
a
a
a
a
a
a
a
a
a
a
a
a
a
a
a
a
a
a
a
a
a
a
a
a
a
a
a
a
a
a
a
a
a
a
a
a
a
"}
(11,1,1) = {"
a
a
a
a
a
a
a
a
a
a
a
a
a
a
a
a
a
a
a
a
a
a
a
a
a
a
a
a
a
a
a
a
a
a
a
a
a
a
a
a
"}
(12,1,1) = {"
a
a
a
a
a
a
a
a
a
a
a
a
a
a
a
a
a
a
a
a
a
a
a
a
a
a
a
a
a
a
a
a
a
a
a
a
a
a
a
a
"}
(13,1,1) = {"
a
a
a
a
a
a
a
a
a
a
a
a
a
a
a
a
a
a
k
c
p
a
a
a
a
a
a
a
a
a
a
a
a
a
a
a
a
a
a
a
"}
(14,1,1) = {"
a
a
a
a
a
a
a
a
a
a
a
a
a
a
a
a
a
a
k
l
p
a
a
a
a
a
a
a
a
a
a
a
a
a
a
a
a
a
a
a
"}
(15,1,1) = {"
a
a
a
a
a
a
a
a
a
a
a
a
a
a
a
a
a
a
k
l
p
a
a
a
a
a
a
a
a
a
a
a
a
a
a
a
a
a
a
a
"}
(16,1,1) = {"
a
a
a
a
a
a
a
a
a
a
a
a
a
a
a
a
a
a
k
l
p
a
a
a
a
a
a
a
a
a
a
a
a
a
a
a
a
a
a
a
"}
(17,1,1) = {"
a
a
a
a
a
a
a
a
a
a
a
a
a
a
a
a
a
f
V
c
V
f
a
a
a
a
a
a
a
a
a
a
a
a
a
a
a
a
a
a
"}
(18,1,1) = {"
a
a
a
a
a
a
a
a
a
a
a
a
a
a
a
a
f
i
i
i
i
q
f
a
a
a
a
a
a
a
a
a
a
a
a
a
a
a
a
a
"}
(19,1,1) = {"
a
a
a
a
a
a
a
a
a
a
a
a
a
a
a
f
h
I
i
i
i
i
D
f
a
a
a
a
a
a
a
a
a
a
a
a
a
a
a
a
"}
(20,1,1) = {"
a
a
a
a
a
a
a
a
a
a
a
b
b
b
b
g
i
i
i
m
i
i
i
V
b
b
b
b
a
a
a
a
a
a
a
a
a
a
a
a
"}
(21,1,1) = {"
a
a
a
a
a
a
a
a
a
a
a
c
e
e
e
c
i
i
i
n
i
i
i
c
e
e
e
c
a
a
a
a
a
a
a
a
a
a
a
a
"}
(22,1,1) = {"
a
a
a
a
a
a
a
a
a
a
a
d
d
d
d
g
i
i
i
o
i
i
i
g
d
d
d
d
a
a
a
a
a
a
a
a
a
a
a
a
"}
(23,1,1) = {"
a
a
a
a
a
a
a
a
a
a
a
a
a
a
a
f
i
i
i
i
i
i
r
f
a
a
a
a
a
a
a
a
a
a
a
a
a
a
a
a
"}
(24,1,1) = {"
a
a
a
a
a
a
a
a
a
a
a
a
a
a
a
a
f
j
i
i
i
i
f
a
a
a
a
a
a
a
a
a
a
a
a
a
a
a
a
a
"}
(25,1,1) = {"
a
a
a
a
a
a
a
a
a
a
a
a
a
a
a
a
a
f
g
c
V
f
a
a
a
a
a
a
a
a
a
a
a
a
a
a
a
a
a
a
"}
(26,1,1) = {"
a
a
a
a
a
a
a
a
a
a
a
a
a
a
a
a
a
a
k
l
p
a
a
a
a
a
a
a
a
a
a
a
a
a
a
a
a
a
a
a
"}
(27,1,1) = {"
a
a
a
a
a
a
a
a
a
a
a
a
a
a
a
a
a
a
k
l
p
a
a
a
a
a
a
a
a
a
a
a
a
a
a
a
a
a
a
a
"}
(28,1,1) = {"
a
a
a
a
a
a
a
a
a
a
a
a
a
a
a
a
a
a
k
l
p
a
a
a
a
a
a
a
a
a
a
a
a
a
a
a
a
a
a
a
"}
(29,1,1) = {"
a
a
a
a
a
a
a
a
a
a
a
a
a
a
a
a
a
a
k
c
p
a
a
a
a
a
a
a
a
a
a
a
a
a
a
a
a
a
a
a
"}
(30,1,1) = {"
a
a
a
a
a
a
a
a
a
a
a
a
a
a
a
a
a
a
a
a
a
a
a
a
a
a
a
a
a
a
a
a
a
a
a
a
a
a
a
a
"}
(31,1,1) = {"
a
a
a
a
a
a
a
a
a
a
a
a
a
a
a
a
a
a
a
a
a
a
a
a
a
a
a
a
a
a
a
a
a
a
a
a
a
a
a
a
"}
(32,1,1) = {"
a
a
a
a
a
a
a
a
a
a
a
a
a
a
a
a
a
a
a
a
a
a
a
a
a
a
a
a
a
a
a
a
a
a
a
a
a
a
a
a
"}
(33,1,1) = {"
a
a
a
a
a
a
a
a
a
a
a
a
a
a
a
a
a
a
a
a
a
a
a
a
a
a
a
a
a
a
a
a
a
a
a
a
a
a
a
a
"}
(34,1,1) = {"
a
a
a
a
a
a
a
a
a
a
a
a
a
a
a
a
a
a
a
a
a
a
a
a
a
a
a
a
a
a
a
a
a
a
a
a
a
a
a
a
"}
(35,1,1) = {"
a
a
a
a
a
a
a
a
a
a
a
a
a
a
a
a
a
a
a
a
a
a
a
a
a
a
a
a
a
a
a
a
a
a
a
a
a
a
a
a
"}
(36,1,1) = {"
a
a
a
a
a
a
a
a
a
a
a
a
a
a
a
a
a
a
a
a
a
a
a
a
a
a
a
a
a
a
a
a
a
a
a
a
a
a
a
a
"}
(37,1,1) = {"
a
a
a
a
a
a
a
a
a
a
a
a
a
a
a
a
a
a
a
a
a
a
a
a
a
a
a
a
a
a
a
a
a
a
a
a
a
a
a
a
"}
(38,1,1) = {"
a
a
a
a
a
a
a
a
a
a
a
a
a
a
a
a
a
a
a
a
a
a
a
a
a
a
a
a
a
a
a
a
a
a
a
a
a
a
a
a
"}
(39,1,1) = {"
a
a
a
a
a
a
a
a
a
a
a
a
a
a
a
a
a
a
a
a
a
a
a
a
a
a
a
a
a
a
a
a
a
a
a
a
a
a
a
a
"}
(40,1,1) = {"
a
a
a
a
a
a
a
a
a
a
a
a
a
a
a
a
a
a
a
a
a
a
a
a
a
a
a
a
a
a
a
a
a
a
a
a
a
a
a
a
"}
