"a" = (/turf/template_noop,/area/template_noop)
"b" = (/obj/structure/lattice,/turf/template_noop,/area/submap/derelict1)
"c" = (/turf/simulated/wall,/area/submap/derelict1)
"d" = (/turf/simulated/wall/resin,/area/submap/derelict1)
"e" = (/obj/structure/girder,/obj/effect/alien/weeds,/turf/simulated/floor/tiled/asteroid_steel/airless,/area/submap/derelict1)
"f" = (/obj/effect/alien/weeds,/turf/simulated/floor/tiled/asteroid_steel/airless,/area/submap/derelict1)
"g" = (/obj/effect/alien/weeds,/obj/structure/table,/turf/simulated/floor/tiled/asteroid_steel/airless,/area/submap/derelict1)
"h" = (/obj/effect/alien/weeds/node,/obj/effect/landmark/loot_spawn,/turf/simulated/floor/tiled/asteroid_steel/airless,/area/submap/derelict1)
"i" = (/obj/effect/alien/weeds,/obj/structure/bed/nest,/turf/simulated/floor/tiled/asteroid_steel/airless,/area/submap/derelict1)
"j" = (/obj/effect/alien/weeds,/obj/structure/bed/nest,/obj/effect/decal/remains/human,/turf/simulated/floor/tiled/asteroid_steel/airless,/area/submap/derelict1)
"k" = (/obj/structure/simple_door/resin,/turf/simulated/floor/tiled/asteroid_steel/airless,/area/submap/derelict1)
"l" = (/obj/structure/girder/resin,/turf/simulated/floor/tiled/asteroid_steel/airless,/area/submap/derelict1)
"m" = (/obj/effect/alien/weeds,/obj/structure/table/standard,/turf/simulated/floor/tiled/asteroid_steel/airless,/area/submap/derelict1)
"n" = (/obj/effect/alien/weeds,/obj/effect/decal/remains/robot,/turf/simulated/floor/tiled/asteroid_steel/airless,/area/submap/derelict1)
"o" = (/obj/effect/alien/weeds/node,/obj/structure/table/standard,/turf/simulated/floor/tiled/asteroid_steel/airless,/area/submap/derelict1)
"p" = (/obj/structure/girder,/turf/simulated/floor/tiled/asteroid_steel/airless,/area/submap/derelict1)
"q" = (/turf/simulated/floor/tiled/asteroid_steel/airless,/area/submap/derelict1)
"r" = (/obj/effect/alien/weeds,/obj/structure/bed/nest,/obj/effect/decal/remains/xeno,/turf/simulated/floor/tiled/asteroid_steel/airless,/area/submap/derelict1)
"D" = (/obj/effect/alien/weeds,/mob/living/simple_mob/animal/space/alien/sentinel/praetorian,/turf/simulated/floor/tiled/asteroid_steel/airless,/area/submap/derelict1)
"E" = (/obj/item/stack/rods,/turf/template_noop,/area/submap/derelict1)
"F" = (/obj/structure/loot_pile/maint/boxfort,/turf/simulated/floor/tiled/asteroid_steel/airless,/area/submap/derelict1)
"G" = (/turf/simulated/floor/airless,/area/submap/derelict1)
"K" = (/obj/effect/alien/weeds,/obj/structure/loot_pile/maint/boxfort,/turf/simulated/floor/tiled/asteroid_steel/airless,/area/submap/derelict1)
"M" = (/obj/effect/alien/weeds/node,/turf/simulated/floor/tiled/asteroid_steel/airless,/area/submap/derelict1)
"N" = (/obj/structure/lattice,/obj/item/stack/rods,/turf/template_noop,/area/submap/derelict1)
"O" = (/obj/effect/alien/weeds,/mob/living/simple_mob/animal/space/alien/sentinel,/turf/simulated/floor/tiled/asteroid_steel/airless,/area/submap/derelict1)
"P" = (/obj/effect/alien/weeds,/obj/effect/landmark/loot_spawn/low,/turf/simulated/floor/tiled/asteroid_steel/airless,/area/submap/derelict1)
"R" = (/obj/effect/alien/weeds/node,/mob/living/simple_mob/animal/space/alien/sentinel,/turf/simulated/floor/tiled/asteroid_steel/airless,/area/submap/derelict1)
"X" = (/obj/item/stack/material/resin,/turf/template_noop,/area/template_noop)
"Y" = (/obj/structure/girder/resin,/turf/simulated/floor/airless,/area/submap/derelict1)

(1,1,1) = {"
aaaaaaaaaaaaaaaaaaaaaaaaaaaaaaaaaaaaaaaa
aaaaaaaaaaaaaaaaaaaaaaaaaaaaaaaaaaaaaaaa
aaaaaaaaaaaaaaaaaaaaaaaaaaaaaaaaaaaaaaaa
aaaaaaaaaaaaaaaaaaaaaaaaaaaaaaaaaaaaaaaa
aaaaaaaaaaaaaaaaaaaaaaaaaaaaaaaaaaaaaaaa
aaaaaaaaaaaaaaaaaaaaaaaaaaaaaaaaaaaaaaaa
aaaaaaaaaaaaaaaaaaaaaEaaEaaaaaaaaaaaaaaa
aaaaaaaaaaaaaaaaaaaaaaaaaaaaaaaaaaaaaaaa
aaaaaaaaaaaaaaaaaaaabbbaaaaaaaaaaaaaaaaa
aaaaaaaaaaaaaaEaaaabbbbaaaaEaaaaaaaaaaaa
aaaaaaaaaaEaabbbGEbbbbbbbaaaaaaaaaaaaaaa
aaaaaaaaaaabbbbbcccccdcccGGaaaaaaaaaaaaa
aaaaaaaaaabbbGGefcghcKijcbbbbbaaaaaaaaaa
aaaaaaaaEbbbbdlffcffcfffccbbbbbaaaaaaaaa
aaaaaaaaabbblffMfcffcfMffccdbbbaaaaaaaaa
aaaaaaaaaEbdffiffcfOcfffffmdbbbaaaaaaaaa
aaaaaaaaaabcffffOkffkffffnolbbaaEaaaaaaa
aaaaaaaaXaaaecceccfDccceccclbaaaaaaaaaaa
aaaaaaaaaaaEacmPjffffffifcaaaEaaaaaaaaaa
aaaaaaaaaaEbccmMfjffffRficaaaaaaaaaaaaaa
aaaaaaaaaabbdffffffffiffqlbaaaaaaaaaaaaa
aaaaaaaaaabbpccccckkcccqdGbaaaaaaaaaaaaa
aaaaaaaaaabbbbbcMfffPiclqbaEaaaaaaaaaaaa
aaaaaaaaaGbbbaacfffffgcGbbaaaaaaaaaaaaaa
aaaaaaaaaabbEaEcelfrffMGbaaaaaaaaaaaaaaa
aaaaaaaEaabGaaaabGlffbbbbaaaaaaaaaaaaaaa
aaaaaaaaaEGaaaaaGGqYbbbbaaaaaaaaaaaaaaaa
aaaaaaaaabGaaaaaaGbbbaaaEaaaaaaaaaaaaaaa
aaaEaaEbbbaaaaaaaaaaaaEaaaaaaaaaaaaaaaaa
aaabaacbbGaaaaaaaaaaaaaaaaaaaaaaaaaaaaaa
aabbbcqFbbaaaaaaaaaaaaaaaaaaaaaaaaaaaaaa
abbqqqqqbNaaEaaaaaaaaaaaaaaaaaaaaaaaaaaa
bpcqqqqqbbaaaaaaaaaaaaaaaaaaaaaaaaaaaaaa
bpqFqqcbbGaaaaaaaaaaaaaaaaaaaaaaaaaaaaaa
bpqqqqqbaaaaaaaaaaaaaaaaaaaaaaaaaaaaaaaa
Eccccpbbaaaaaaaaaaaaaaaaaaaaaaaaaaaaaaaa
aaGbbbbaEaaaaaaaaaaaaaaaaaaaaaaaaaaaaaaa
aaGaaaaaaaaaaaaaaaaaaaaaaaaaaaaaaaaaaaaa
aaaaaaaaaaaaaaaaaaaaaaaaaaaaaaaaaaaaaaaa
aaaaaaaaaaaaaaaaaaaaaaaaaaaaaaaaaaaaaaaa
"}
