"a" = (/turf/template_noop,/area/template_noop)
"b" = (/obj/structure/lattice,/turf/template_noop,/area/template_noop)
"c" = (/turf/simulated/wall,/area/submap/gasthelizards)
"d" = (/obj/machinery/light{dir = 1},/obj/structure/bed,/obj/effect/decal/remains/human,/turf/simulated/floor/tiled/yellow,/area/submap/gasthelizards)
"e" = (/obj/structure/window/reinforced{dir = 4},/mob/living/simple_mob/animal/passive/lizard/event,/turf/simulated/floor/tiled/yellow,/area/submap/gasthelizards)
"f" = (/obj/structure/window/reinforced{dir = 8},/obj/machinery/light{dir = 1},/obj/structure/bed,/obj/effect/decal/remains/human,/turf/simulated/floor/tiled/yellow,/area/submap/gasthelizards)
"g" = (/obj/structure/window/reinforced{dir = 8},/obj/machinery/light{dir = 1},/obj/structure/bed,/turf/simulated/floor/tiled/yellow,/area/submap/gasthelizards)
"h" = (/mob/living/simple_mob/animal/passive/lizard/event,/turf/simulated/floor/tiled/yellow,/area/submap/gasthelizards)
"i" = (/turf/simulated/floor/tiled/yellow,/area/submap/gasthelizards)
"j" = (/obj/structure/window/reinforced{dir = 4},/obj/machinery/atmospherics/unary/outlet_injector,/turf/simulated/floor/tiled/yellow,/area/submap/gasthelizards)
"k" = (/obj/structure/window/reinforced{dir = 8},/turf/simulated/floor/tiled/yellow,/area/submap/gasthelizards)
"l" = (/obj/machinery/atmospherics/unary/outlet_injector,/turf/simulated/floor/tiled/yellow,/area/submap/gasthelizards)
"m" = (/obj/structure/closet/crate/freezer,/obj/item/stack/animalhide/lizard{amount = 25},/turf/simulated/floor/tiled/asteroid_steel{icon_state = "dark"},/area/submap/gasthelizards)
"n" = (/obj/structure/closet/crate/freezer,/obj/machinery/light{dir = 1},/obj/item/weapon/reagent_containers/food/snacks/meat,/obj/item/weapon/reagent_containers/food/snacks/meat,/obj/item/weapon/reagent_containers/food/snacks/meat,/obj/item/weapon/reagent_containers/food/snacks/meat,/obj/item/weapon/reagent_containers/food/snacks/meat,/obj/item/weapon/reagent_containers/food/snacks/meat,/obj/item/weapon/reagent_containers/food/snacks/meat,/obj/item/weapon/reagent_containers/food/snacks/meat,/obj/item/weapon/reagent_containers/food/snacks/meat,/obj/item/weapon/reagent_containers/food/snacks/meat,/obj/item/weapon/reagent_containers/food/snacks/meat,/turf/simulated/floor/tiled/asteroid_steel{icon_state = "dark"},/area/submap/gasthelizards)
"o" = (/obj/structure/closet/crate/freezer,/obj/item/weapon/reagent_containers/food/snacks/meat,/obj/item/weapon/reagent_containers/food/snacks/meat,/obj/item/weapon/reagent_containers/food/snacks/meat,/obj/item/weapon/reagent_containers/food/snacks/meat,/obj/item/weapon/reagent_containers/food/snacks/meat,/obj/item/weapon/reagent_containers/food/snacks/meat,/obj/item/weapon/reagent_containers/food/snacks/meat,/obj/item/weapon/reagent_containers/food/snacks/meat,/obj/item/weapon/reagent_containers/food/snacks/meat,/obj/item/weapon/reagent_containers/food/snacks/meat,/turf/simulated/floor/tiled/asteroid_steel{icon_state = "dark"},/area/submap/gasthelizards)
"p" = (/obj/structure/window/reinforced{dir = 1; layer = 2.9},/obj/machinery/power/apc/high{dir = 8; pixel_x = -20},/turf/simulated/floor/tiled/techmaint,/area/submap/gasthelizards)
"q" = (/obj/structure/window/reinforced{dir = 1; layer = 2.9},/turf/simulated/floor/tiled/techmaint,/area/submap/gasthelizards)
"r" = (/obj/machinery/door/window/brigdoor/northleft,/turf/simulated/floor/tiled/techmaint,/area/submap/gasthelizards)
"s" = (/turf/simulated/floor/tiled/asteroid_steel{icon_state = "dark"},/area/submap/gasthelizards)
"t" = (/turf/simulated/floor/tiled/asteroid_steel,/area/submap/gasthelizards)
"u" = (/obj/machinery/light{dir = 1},/obj/random/trash,/turf/simulated/floor/tiled/asteroid_steel,/area/submap/gasthelizards)
"v" = (/obj/machinery/light{dir = 4},/turf/simulated/floor/tiled/asteroid_steel,/area/submap/gasthelizards)
"w" = (/obj/structure/kitchenspike,/turf/simulated/floor/tiled/asteroid_steel{icon_state = "dark"},/area/submap/gasthelizards)
"x" = (/obj/structure/table/reinforced,/obj/item/weapon/reagent_containers/spray/pepper,/obj/random/junk,/obj/item/weapon/material/knife/butch,/obj/item/weapon/handcuffs,/obj/item/stolenpackage,/turf/simulated/floor/tiled/asteroid_steel{icon_state = "dark"},/area/submap/gasthelizards)
"y" = (/obj/machinery/portable_atmospherics/canister/carbon_dioxide,/turf/simulated/floor/tiled/asteroid_steel,/area/submap/gasthelizards)
"z" = (/obj/machinery/gibber,/turf/simulated/floor/tiled/asteroid_steel{icon_state = "dark"},/area/submap/gasthelizards)
"A" = (/obj/structure/table/reinforced,/obj/item/clothing/suit/straight_jacket,/turf/simulated/floor/tiled/asteroid_steel{icon_state = "dark"},/area/submap/gasthelizards)
"B" = (/obj/machinery/portable_atmospherics/canister/empty/nitrogen,/turf/simulated/floor/tiled/asteroid_steel,/area/submap/gasthelizards)
"C" = (/obj/machinery/door/airlock/security,/turf/simulated/floor/tiled/asteroid_steel{icon_state = "dark"},/area/submap/gasthelizards)
"D" = (/obj/item/weapon/reagent_containers/glass/bottle/toxin{pixel_x = 6; pixel_y = 8},/obj/structure/table/reinforced,/obj/item/weapon/reagent_containers/glass/bottle/stoxin,/obj/item/weapon/reagent_containers/glass/bottle/tramadol{pixel_x = -3; pixel_y = 6},/obj/item/weapon/reagent_containers/glass/bottle/peridaxon{pixel_x = 7; pixel_y = -3},/turf/simulated/floor/tiled/asteroid_steel{icon_state = "dark"},/area/submap/gasthelizards)
"E" = (/obj/item/weapon/melee/baton/cattleprod,/obj/structure/table/rack/shelf/steel,/turf/simulated/floor/tiled/asteroid_steel,/area/submap/gasthelizards)
"F" = (/obj/item/weapon/pen/red,/obj/structure/table/standard,/turf/simulated/floor/tiled/asteroid_steel,/area/submap/gasthelizards)
"G" = (/obj/item/weapon/paper_bin,/obj/structure/table/standard,/turf/simulated/floor/tiled/asteroid_steel,/area/submap/gasthelizards)
"H" = (/obj/structure/table/standard,/obj/random/junk,/turf/simulated/floor/tiled/asteroid_steel,/area/submap/gasthelizards)
"I" = (/obj/structure/window/reinforced{dir = 4},/obj/machinery/light,/obj/structure/table/standard,/obj/item/toy/plushie/lizardplushie,/turf/simulated/floor/tiled/asteroid_steel,/area/submap/gasthelizards)
"J" = (/obj/machinery/portable_atmospherics/powered/scrubber,/obj/effect/floor_decal/industrial/outline/yellow,/turf/simulated/floor/tiled/asteroid_steel,/area/submap/gasthelizards)
"K" = (/obj/structure/table/reinforced,/obj/machinery/light,/obj/item/weapon/surgical/circular_saw{pixel_y = 8},/obj/item/weapon/surgical/scalpel,/turf/simulated/floor/tiled/asteroid_steel{icon_state = "dark"},/area/submap/gasthelizards)
"L" = (/obj/effect/decal/cleanable/blood/gibs,/turf/simulated/floor/tiled/asteroid_steel{icon_state = "dark"},/area/submap/gasthelizards)
"M" = (/obj/structure/table/reinforced,/obj/item/weapon/reagent_containers/syringe,/obj/item/weapon/reagent_containers/dropper,/obj/item/weapon/reagent_containers/glass/bottle/mutagen,/obj/item/weapon/reagent_containers/glass/bottle/mutagen,/obj/item/weapon/surgical/cautery,/obj/item/weapon/surgical/hemostat,/turf/simulated/floor/tiled/asteroid_steel{icon_state = "dark"},/area/submap/gasthelizards)
"N" = (/obj/machinery/suit_cycler,/turf/simulated/floor/tiled/asteroid_steel,/area/submap/gasthelizards)
"O" = (/obj/machinery/light,/turf/simulated/floor/tiled/asteroid_steel,/area/submap/gasthelizards)
"P" = (/obj/structure/closet/emcloset,/turf/simulated/floor/tiled/asteroid_steel,/area/submap/gasthelizards)
"Q" = (/obj/machinery/door/airlock/external,/turf/simulated/floor/plating,/area/submap/gasthelizards)
"R" = (/turf/simulated/floor/plating,/area/submap/gasthelizards)
"S" = (/obj/effect/floor_decal/rust,/turf/simulated/floor/tiled/asteroid_steel{icon_state = "dark"},/area/submap/gasthelizards)
"T" = (/obj/item/stack/rods,/turf/template_noop,/area/template_noop)
"U" = (/obj/effect/floor_decal/rust,/turf/simulated/floor/tiled/asteroid_steel,/area/submap/gasthelizards)
"V" = (/mob/living/simple_mob/humanoid/merc/ranged/technician,/turf/simulated/floor/tiled/asteroid_steel,/area/submap/gasthelizards)
"W" = (/mob/living/simple_mob/humanoid/merc/ranged/space/tommylas,/turf/simulated/floor/tiled/asteroid_steel,/area/submap/gasthelizards)
"X" = (/obj/random/junk,/turf/simulated/floor/tiled/asteroid_steel,/area/submap/gasthelizards)
"Y" = (/obj/random/trash,/turf/simulated/floor/tiled/asteroid_steel{icon_state = "dark"},/area/submap/gasthelizards)
"Z" = (/obj/random/trash,/turf/simulated/floor/tiled/asteroid_steel,/area/submap/gasthelizards)

(1,1,1) = {"
aaTababababbaaaaaaa
aaababbbbababbbbaaT
aaabccccccccccbbbba
abbbcdefegefhccccca
abbbcijkjkjklcmnocb
abcccprqrqrqrcSYscb
abcPutUVttVtvcwsxca
aacytUWtUUXUtczSAca
bbcBtttZtttttCssDcb
abcEUUtFGHIJJcKLMcb
abcNOtPcccccccccccb
TacccQccbbbbbbaabba
aabbcRcbbTaaaaTabaa
aaabcQcbaaaaaaaaaaa
"}
