//MAP CONVERTED BY dmm2tgm.py THIS HEADER COMMENT PREVENTS RECONVERSION, DO NOT REMOVE
"aa" = (
/turf/template_noop,
/area/submap/explorerhouse)
"ab" = (
/obj/structure/railing,
/turf/template_noop,
/area/submap/explorerhouse)
"ac" = (
/obj/structure/railing{
	dir = 4
	},
/turf/template_noop,
/area/submap/explorerhouse)
"ad" = (
/turf/simulated/floor/outdoors/grass/sif,
/area/submap/explorerhouse)
"ae" = (
/obj/structure/railing{
	dir = 8
	},
/turf/template_noop,
/area/submap/explorerhouse)
"af" = (
/obj/structure/railing{
	dir = 4
	},
/turf/simulated/floor/outdoors/grass/sif,
/area/submap/explorerhouse)
"ag" = (
/turf/simulated/floor/outdoors/dirt,
/area/submap/explorerhouse)
"ah" = (
/obj/structure/table/bench/wooden,
/turf/simulated/floor/outdoors/dirt,
/area/submap/explorerhouse)
"ai" = (
/obj/structure/railing{
	dir = 8
	},
/turf/simulated/floor/outdoors/grass/sif,
/area/submap/explorerhouse)
"aj" = (
/obj/structure/target_stake,
/turf/simulated/floor/outdoors/dirt,
/area/submap/explorerhouse)
"ak" = (
/obj/item/target,
/turf/simulated/floor/outdoors/grass/sif,
/area/submap/explorerhouse)
"al" = (
/obj/item/target/syndicate,
/turf/simulated/floor/outdoors/grass/sif,
/area/submap/explorerhouse)
"am" = (
/turf/simulated/wall/wood,
/area/submap/explorerhouse)
"an" = (
/obj/structure/simple_door/wood,
/turf/simulated/floor/wood,
/area/submap/explorerhouse)
"ao" = (
/obj/structure/table/marble,
/obj/machinery/microwave,
/turf/simulated/floor/tiled,
/area/submap/explorerhouse)
"ap" = (
/obj/machinery/button/remote/blast_door/bear{
	id = "explorerhome"
	},
/turf/simulated/floor/wood,
/area/submap/explorerhouse)
"aq" = (
/obj/structure/table/marble,
/obj/random/drinkbottle,
/obj/item/material/kitchen/rollingpin,
/turf/simulated/floor/tiled,
/area/submap/explorerhouse)
"ar" = (
/obj/structure/table/marble,
/obj/item/material/knife,
/turf/simulated/floor/tiled,
/area/submap/explorerhouse)
"as" = (
/obj/structure/grille/rustic,
/obj/structure/window/reinforced/full,
/turf/simulated/floor/plating,
/area/submap/explorerhouse)
"at" = (
/obj/structure/table/standard,
/obj/item/reagent_containers/hypospray/autoinjector/biginjector/brute,
/obj/item/reagent_containers/hypospray/autoinjector/biginjector/burn,
/obj/item/reagent_containers/hypospray/autoinjector/biginjector/purity,
/turf/simulated/floor/tiled/freezer,
/area/submap/explorerhouse)
"au" = (
/obj/structure/toilet,
/turf/simulated/floor/tiled/freezer,
/area/submap/explorerhouse)
"av" = (
/obj/machinery/portable_atmospherics/canister/air,
/turf/simulated/floor/outdoors/grass/sif,
/area/submap/explorerhouse)
"aw" = (
/obj/structure/table/glass,
/obj/structure/window/reinforced,
/obj/item/coin/phoron{
	desc = "This phoron coin is a very early mint. It still flips as good as any other.";
	name = "vintage phoron coin"
	},
/obj/structure/sign/kiddieplaque/poi4{
	pixel_y = 28
	},
/turf/simulated/floor/wood,
/area/submap/explorerhouse)
"ax" = (
/obj/item/clothing/head/bearpelt{
	desc = "A bit worn, but still fuzzy. There's a harpoon-shaped patch on the back of it.";
	name = "vintage bear pelt hat";
	pixel_y = 6
	},
/obj/structure/table/glass,
/obj/structure/window/reinforced,
/obj/structure/sign/kiddieplaque/poi3{
	pixel_y = 28
	},
/turf/simulated/floor/wood,
/area/submap/explorerhouse)
"ay" = (
/obj/item/material/harpoon{
	desc = "This harpoon looks like it's seen better days, but is reinforced enough to still skewer beasts.";
	name = "vintage harpoon"
	},
/obj/structure/table/glass,
/obj/structure/window/reinforced,
/obj/structure/sign/kiddieplaque/poi2{
	pixel_y = 28
	},
/turf/simulated/floor/wood,
/area/submap/explorerhouse)
"az" = (
/obj/structure/table/glass,
/obj/structure/window/reinforced,
/obj/item/clothing/accessory/medal/conduct{
	desc = "A rusted medal. It's too faded to make much out beyond the words 'Audentes fortuna iuvat'.";
	name = "expeditionary corps medal";
	pixel_y = 6
	},
/obj/structure/sign/kiddieplaque/poi1{
	pixel_y = 28
	},
/turf/simulated/floor/wood,
/area/submap/explorerhouse)
"aA" = (
/obj/structure/closet/cabinet,
/obj/item/cane,
/obj/item/stack/medical/splint,
/obj/item/stack/medical/crude_pack,
/turf/simulated/floor/carpet/sblucarpet,
/area/submap/explorerhouse)
"aB" = (
/obj/structure/cable{
	d2 = 4;
	icon_state = "0-4"
	},
/obj/machinery/power/apc{
	dir = 1;
	name = "north bump";
	operating = 1;
	pixel_x = 0;
	pixel_y = 24
	},
/obj/effect/decal/cleanable/dirt,
/obj/machinery/door/window/westleft,
/turf/simulated/floor/wood,
/area/submap/explorerhouse)
"aC" = (
/obj/item/towel,
/turf/simulated/floor/tiled/freezer,
/area/submap/explorerhouse)
"aD" = (
/obj/structure/closet/secure_closet/freezer/fridge,
/turf/simulated/floor/tiled,
/area/submap/explorerhouse)
"aE" = (
/turf/simulated/floor/tiled,
/area/submap/explorerhouse)
"aF" = (
/obj/structure/simple_door/wood,
/turf/simulated/floor/tiled,
/area/submap/explorerhouse)
"aG" = (
/obj/structure/simple_door/wood,
/turf/simulated/floor/tiled/freezer,
/area/submap/explorerhouse)
"aH" = (
/obj/effect/decal/cleanable/dirt,
/obj/machinery/power/terminal{
	dir = 4
	},
/obj/structure/cable{
	d2 = 4;
	icon_state = "0-4"
	},
/obj/structure/cable{
	d1 = 4;
	d2 = 8;
	icon_state = "4-8"
	},
/turf/simulated/floor/wood,
/area/submap/explorerhouse)
"aI" = (
/obj/structure/window/reinforced/tinted{
	dir = 8;
	icon_state = "twindow"
	},
/obj/machinery/shower{
	dir = 1
	},
/obj/random/soap,
/turf/simulated/floor/tiled/freezer,
/area/submap/explorerhouse)
"aJ" = (
/turf/simulated/floor/carpet/turcarpet,
/area/submap/explorerhouse)
"aK" = (
/obj/structure/bed/chair/wood,
/turf/simulated/floor/carpet/turcarpet,
/area/submap/explorerhouse)
"aL" = (
/obj/structure/bed/chair/wood{
	dir = 4
	},
/turf/simulated/floor/carpet/turcarpet,
/area/submap/explorerhouse)
"aM" = (
/obj/structure/table/wooden_reinforced,
/obj/item/storage/fancy/candle_box,
/turf/simulated/floor/carpet/turcarpet,
/area/submap/explorerhouse)
"aN" = (
/obj/structure/table/wooden_reinforced,
/obj/item/binoculars/spyglass,
/turf/simulated/floor/carpet/turcarpet,
/area/submap/explorerhouse)
"aO" = (
/obj/structure/table/wooden_reinforced,
/obj/item/flashlight/lantern,
/turf/simulated/floor/carpet/turcarpet,
/area/submap/explorerhouse)
"aP" = (
/obj/structure/bed/chair/wood{
	dir = 1
	},
/turf/simulated/floor/carpet/turcarpet,
/area/submap/explorerhouse)
"aQ" = (
/obj/structure/table/rack,
/obj/item/gps/explorer,
/turf/simulated/floor/tiled/techfloor,
/area/submap/explorerhouse)
"aR" = (
/obj/structure/simple_door/wood,
/turf/simulated/floor/carpet/sblucarpet,
/area/submap/explorerhouse)
"aS" = (
/turf/simulated/floor/carpet/sblucarpet,
/area/submap/explorerhouse)
"aT" = (
/obj/machinery/power/smes/buildable/point_of_interest,
/obj/effect/decal/cleanable/dirt,
/obj/structure/cable{
	d2 = 8;
	icon_state = "0-8"
	},
/turf/simulated/floor/wood,
/area/submap/explorerhouse)
"aU" = (
/obj/machinery/button/remote/blast_door{
	id = "explorerhome";
	name = "Armory Door";
	pixel_y = 28
	},
/turf/simulated/floor/tiled/techfloor,
/area/submap/explorerhouse)
"aV" = (
/obj/machinery/door/blast/regular/bookcase{
	id = "explorerhome"
	},
/turf/simulated/floor/tiled/techfloor,
/area/submap/explorerhouse)
"aW" = (
/turf/simulated/floor/wood,
/area/submap/explorerhouse)
"aX" = (
/obj/structure/coatrack,
/turf/simulated/floor/wood,
/area/submap/explorerhouse)
"aY" = (
/obj/structure/table/rack,
/obj/item/clothing/under/explorer,
/obj/item/cell/device,
/obj/item/cell/device,
/obj/item/cell/device,
/turf/simulated/floor/tiled/techfloor,
/area/submap/explorerhouse)
"aZ" = (
/obj/structure/table/woodentable,
/obj/item/book/manual/excavation,
/obj/item/clothing/glasses/regular,
/turf/simulated/floor/carpet/sblucarpet,
/area/submap/explorerhouse)
"ba" = (
/obj/machinery/space_heater,
/turf/simulated/floor/outdoors/grass/sif,
/area/submap/explorerhouse)
"bb" = (
/obj/item/bedsheet/hopdouble,
/obj/structure/bed/double/padded,
/turf/simulated/floor/carpet/sblucarpet,
/area/submap/explorerhouse)
"bc" = (
/obj/structure/loot_pile/maint/junk,
/obj/effect/decal/cleanable/dirt,
/turf/simulated/floor/wood,
/area/submap/explorerhouse)
"bd" = (
/obj/structure/loot_pile/maint/trash,
/obj/effect/decal/cleanable/dirt,
/turf/simulated/floor/wood,
/area/submap/explorerhouse)
"be" = (
/obj/structure/bed/chair/wood{
	dir = 8
	},
/turf/simulated/floor/carpet/turcarpet,
/area/submap/explorerhouse)
"bf" = (
/obj/structure/bonfire/sifwood,
/turf/simulated/floor/outdoors/dirt,
/area/submap/explorerhouse)
"bg" = (
/obj/machinery/light{
	dir = 8
	},
/turf/simulated/floor/wood,
/area/submap/explorerhouse)
"bh" = (
/obj/structure/table/rack,
/obj/item/clothing/suit/storage/hooded/explorer,
/obj/item/clothing/mask/gas/explorer,
/obj/item/material/knife/tacknife/survival,
/turf/simulated/floor/tiled/techfloor,
/area/submap/explorerhouse)
"bi" = (
/obj/item/clothing/shoes/boots/winter/explorer,
/turf/simulated/floor/tiled/techfloor,
/area/submap/explorerhouse)
"bj" = (
/obj/machinery/light{
	dir = 4
	},
/turf/simulated/floor/wood,
/area/submap/explorerhouse)
"bk" = (
/obj/item/tool/prybar,
/turf/simulated/floor/outdoors/grass/sif,
/area/submap/explorerhouse)
"bl" = (
/obj/machinery/door/window/eastright,
/obj/effect/decal/cleanable/dirt,
/turf/simulated/floor/wood,
/area/submap/explorerhouse)
"bm" = (
/obj/machinery/portable_atmospherics/powered/scrubber/huge/stationary,
/obj/machinery/light/small{
	brightness_color = "#DA0205";
	brightness_power = 1;
	brightness_range = 5;
	dir = 8
	},
/turf/simulated/floor/wood,
/area/submap/explorerhouse)
"bn" = (
/obj/machinery/portable_atmospherics/powered/scrubber/huge/stationary,
/obj/machinery/light/small{
	dir = 4
	},
/turf/simulated/floor/wood,
/area/submap/explorerhouse)
"bo" = (
/obj/machinery/light/small{
	dir = 4
	},
/turf/simulated/floor/tiled,
/area/submap/explorerhouse)
"bp" = (
/obj/structure/sink{
	dir = 8;
	icon_state = "sink";
	pixel_x = -12;
	pixel_y = 2
	},
/obj/structure/mirror{
	dir = 4;
	pixel_x = -28;
	pixel_y = 0
	},
/obj/machinery/light/small{
	brightness_color = "#DA0205";
	brightness_power = 1;
	brightness_range = 5;
	dir = 8
	},
/turf/simulated/floor/tiled/freezer,
/area/submap/explorerhouse)
"bq" = (
/turf/simulated/floor/tiled/freezer,
/area/submap/explorerhouse)
"br" = (
/obj/machinery/light_switch{
	pixel_y = -24
	},
/turf/simulated/floor/wood,
/area/submap/explorerhouse)
"bw" = (
/obj/machinery/light/small{
	dir = 4
	},
/turf/simulated/floor/tiled/techfloor,
/area/submap/explorerhouse)
"bx" = (
/obj/machinery/light/small{
	brightness_color = "#DA0205";
	brightness_power = 1;
	brightness_range = 5;
	dir = 8
	},
/turf/simulated/floor/carpet/sblucarpet,
/area/submap/explorerhouse)
"bz" = (
/obj/structure/sign/kiddieplaque{
	desc = "To anyone reading this, you'll note that I'm not home right now, and unfortunately due to reassignment, I won't be for a very long time. Exploring somewhere really far and dangerous now. You can stay if you want, but please try to keep my home in good condition.";
	name = "read me visitors";
	pixel_y = 0
	},
/turf/simulated/wall/wood,
/area/submap/explorerhouse)

(1,1,1) = {"
aa
ac
af
af
af
af
ad
ad
ad
ad
ad
ad
bk
ad
ad
ad
ad
ad
ad
ad
"}
(2,1,1) = {"
ab
ad
ad
ag
ad
ak
am
am
as
am
am
aB
am
am
am
am
am
ad
ag
ag
"}
(3,1,1) = {"
ab
ad
ag
aj
ag
al
am
ao
aq
aD
am
aH
am
aQ
aY
bh
am
ad
ag
ag
"}
(4,1,1) = {"
ab
ad
ag
ag
ag
ak
am
ar
bo
aE
am
aT
am
aU
bw
bi
am
ad
ag
ag
"}
(5,1,1) = {"
ab
ad
ag
ag
ag
ad
am
am
am
aF
am
am
am
aV
am
am
am
ad
ag
ag
"}
(6,1,1) = {"
ab
ad
ag
ag
ag
ad
av
am
aw
aW
aW
bg
aW
aW
aW
as
ad
ad
ag
ag
"}
(7,1,1) = {"
ab
ad
ag
ag
ag
am
am
am
ax
aW
aJ
aL
aJ
aW
aX
am
am
am
ag
ag
"}
(8,1,1) = {"
ab
ad
ag
ag
ag
am
bm
am
am
aW
aK
aM
aP
aW
am
am
bm
am
ag
ag
"}
(9,1,1) = {"
ab
ad
ag
ag
ag
an
aW
aW
an
aW
aK
aN
aP
aW
an
aW
aW
an
ag
ag
"}
(10,1,1) = {"
ab
ad
ag
ag
ag
am
bn
am
am
aW
aK
aO
aP
br
am
am
bn
bz
ag
ag
"}
(11,1,1) = {"
ab
ad
ag
ag
ag
am
am
am
ay
aW
aJ
be
aJ
aW
ap
am
am
am
ag
ag
"}
(12,1,1) = {"
ab
ad
ah
ag
ah
ad
ba
am
az
aW
aW
bj
aW
aW
aW
as
ad
ad
ag
ag
"}
(13,1,1) = {"
ab
ad
ah
bf
ah
ad
am
am
am
aG
am
am
am
aR
am
am
am
ad
ag
ag
"}
(14,1,1) = {"
ab
ad
ah
ag
ah
ad
am
at
bp
bq
am
bc
am
aS
bx
aZ
am
ad
ag
ag
"}
(15,1,1) = {"
ab
ad
ag
ag
ag
ad
am
au
aC
aI
am
bd
am
aA
aS
bb
am
ad
ag
ag
"}
(16,1,1) = {"
ab
ad
ad
ag
ad
ad
am
am
am
am
am
bl
am
am
as
am
am
ad
ag
ag
"}
(17,1,1) = {"
aa
ae
ai
ai
ai
ai
ad
ad
ad
ad
ad
ad
ad
ad
ad
ad
ad
ad
ad
ad
"}
