"a" = (/turf/template_noop,/area/template_noop)
"b" = (/turf/simulated/floor/outdoors/dirt,/area/submap/farm)
"c" = (/obj/structure/railing,/turf/simulated/floor/outdoors/dirt,/area/submap/farm)
"d" = (/obj/structure/railing{icon_state = "railing0"; dir = 4},/turf/simulated/floor/outdoors/dirt,/area/submap/farm)
"e" = (/turf/simulated/floor/outdoors/grass/sif,/area/submap/farm)
"f" = (/obj/structure/railing{icon_state = "railing0"; dir = 8},/turf/simulated/floor/outdoors/dirt,/area/submap/farm)
"g" = (/turf/simulated/wall/wood,/area/submap/farm)
"h" = (/obj/structure/grille/rustic,/obj/structure/window/reinforced/full,/turf/simulated/floor/plating,/area/submap/farm)
"i" = (/obj/structure/window/reinforced/full,/obj/structure/grille/rustic,/turf/simulated/floor/plating,/area/submap/farm)
"j" = (/obj/structure/closet/secure_closet/freezer/fridge,/turf/simulated/floor/wood,/area/submap/farm)
"k" = (/turf/simulated/floor/wood,/area/submap/farm)
"l" = (/obj/structure/table/marble,/turf/simulated/floor/wood,/area/submap/farm)
"m" = (/obj/structure/table/marble,/obj/item/material/kitchen/rollingpin,/turf/simulated/floor/wood,/area/submap/farm)
"n" = (/obj/machinery/portable_atmospherics/hydroponics/soil,/obj/item/seeds/cornseed,/turf/simulated/floor/outdoors/dirt{outdoors = 0},/area/submap/farm)
"o" = (/turf/simulated/floor/outdoors/dirt{outdoors = 0},/area/submap/farm)
"p" = (/obj/structure/table/marble,/obj/item/material/knife,/turf/simulated/floor/wood,/area/submap/farm)
"q" = (/obj/structure/window/reinforced/full{dir = 8},/obj/structure/window/reinforced/full{dir = 4},/obj/machinery/portable_atmospherics/powered/scrubber/huge/stationary,/turf/simulated/floor/plating,/area/submap/farm)
"r" = (/obj/machinery/portable_atmospherics/hydroponics/soil,/obj/item/seeds/bluetomatoseed,/turf/simulated/floor/outdoors/dirt{outdoors = 0},/area/submap/farm)
"s" = (/turf/simulated/floor/outdoors/mud{outdoors = 0},/area/submap/farm)
"t" = (/obj/machinery/portable_atmospherics/hydroponics/soil,/obj/item/seeds/icepepperseed,/turf/simulated/floor/outdoors/dirt{outdoors = 0},/area/submap/farm)
"u" = (/obj/structure/simple_door/wood,/turf/simulated/floor/wood,/area/submap/farm)
"v" = (/obj/machinery/door/window/eastleft,/obj/machinery/door/window/westleft,/turf/simulated/floor/outdoors/dirt,/area/submap/farm)
"w" = (/mob/living/bot/farmbot,/turf/simulated/floor/outdoors/dirt{outdoors = 0},/area/submap/farm)
"x" = (/obj/structure/sink/puddle,/turf/simulated/floor/outdoors/mud{outdoors = 0},/area/submap/farm)
"y" = (/obj/item/material/knife/machete/hatchet,/turf/simulated/floor/outdoors/mud{outdoors = 0},/area/submap/farm)
"z" = (/obj/structure/table/woodentable,/obj/item/storage/box/matches,/obj/item/flame/match,/turf/simulated/floor/wood,/area/submap/farm)
"A" = (/obj/structure/table/woodentable,/turf/simulated/floor/wood,/area/submap/farm)
"B" = (/obj/item/clothing/shoes/boots/winter/hydro,/obj/item/clothing/suit/storage/hooded/wintercoat/hydro,/turf/simulated/floor/wood,/area/submap/farm)
"C" = (/obj/structure/bed/chair/wood{icon_state = "wooden_chair"; dir = 8},/turf/simulated/floor/wood,/area/submap/farm)
"D" = (/obj/machinery/portable_atmospherics/powered/scrubber/huge/stationary,/turf/simulated/floor/wood,/area/submap/farm)
"E" = (/obj/structure/table/woodentable,/obj/item/storage/fancy/candle_box,/turf/simulated/floor/wood,/area/submap/farm)
"F" = (/obj/machinery/portable_atmospherics/hydroponics/soil,/obj/item/seeds/wheatseed,/turf/simulated/floor/outdoors/dirt{outdoors = 0},/area/submap/farm)
"G" = (/obj/structure/closet/crate/bin,/turf/simulated/floor/wood,/area/submap/farm)
"H" = (/obj/machinery/space_heater,/turf/simulated/floor/wood,/area/submap/farm)
"I" = (/obj/structure/bookcase,/obj/item/book/manual/hydroponics_pod_people,/turf/simulated/floor/wood,/area/submap/farm)
"J" = (/obj/structure/bed/padded,/obj/item/bedsheet/blue,/turf/simulated/floor/wood,/area/submap/farm)
"K" = (/obj/structure/table/woodentable,/obj/item/trash/candle,/turf/simulated/floor/wood,/area/submap/farm)
"L" = (/turf/simulated/floor/outdoors/rocks,/area/submap/farm)
"M" = (/turf/simulated/floor/plating,/area/submap/farm)
"N" = (/turf/simulated/floor/water,/area/submap/farm)
"O" = (/obj/structure/loot_pile/maint/technical,/turf/simulated/floor/plating,/area/submap/farm)
"P" = (/obj/machinery/power/port_gen/pacman,/turf/simulated/floor/plating,/area/submap/farm)
"Q" = (/obj/structure/closet/crate/hydroponics/prespawned,/turf/simulated/floor/plating,/area/submap/farm)
"R" = (/obj/structure/table/steel,/obj/machinery/cell_charger,/turf/simulated/floor/plating,/area/submap/farm)
"S" = (/obj/structure/table/steel,/turf/simulated/floor/plating,/area/submap/farm)
"T" = (/obj/structure/railing{icon_state = "railing0"; dir = 1},/turf/simulated/floor/outdoors/dirt,/area/submap/farm)
"U" = (/obj/structure/table/marble,/obj/item/seeds/eggplantseed,/obj/fruitspawner/eggplant,/turf/simulated/floor/wood,/area/submap/farm)
"V" = (/obj/item/reagent_containers/food/snacks/pitcher_fruit,/turf/simulated/floor/outdoors/dirt{outdoors = 0},/area/submap/farm)
"W" = (/obj/item/reagent_containers/food/snacks/pitcher_fruit,/turf/simulated/floor/outdoors/mud{outdoors = 0},/area/submap/farm)
"X" = (/mob/living/simple_mob/vore/pitcher_plant,/obj/machinery/portable_atmospherics/hydroponics/soil,/obj/item/seeds/icepepperseed,/obj/effect/decal/remains,/turf/simulated/floor/outdoors/dirt{outdoors = 0},/area/submap/farm)
"Y" = (/mob/living/simple_mob/vore/pitcher_plant,/obj/machinery/portable_atmospherics/hydroponics/soil,/obj/item/seeds/bluetomatoseed,/turf/simulated/floor/outdoors/dirt{outdoors = 0},/area/submap/farm)
"Z" = (/obj/item/seeds/eggplantseed,/turf/simulated/floor/outdoors/dirt{outdoors = 0},/area/submap/farm)

(1,1,1) = {"
aaaaaaaaaaaaaaaaaaaaaaaaaaaaaaaa
aaaaaaaaaaaaaaaaaaaaaaaaaaaaaaaa
abccccccccccccccccccccccccbaaaaa
adeeeeeeeeeeeeeeeeeeeeeeeefaaaaa
adeeeeeeeeeeeeeeeeeeeeeeeefaaaaa
adeegghhggeeeeiiiiiiiiiiiefaaaaa
adeegjklmgeeeeinnnnnnnnniefaaaaa
adeegkkkUheeeeiooVooooooiefaaaaa
adeegkkkpgebbeqrrrWssXttiefaaaaa
adegggugggebbbvwVosxyoooiefaaaaa
adegzAkBggggbbirrYssstttiefaaaaa
adehACkkgDDgbeiooooZooooiefaaaaa
adehEkkkukkubeiFFFFFFFFFiefaaaaa
adegGkkHggggbeiiiiiiiiiiiefaaaaa
adeggugggeeebeeeeeeeeeeeeefaaaaa
adegIkkJgeebbbeeeeebbbbbbbbbbbba
adegHkkKgeebbbbbbbbbbbbbbbbbbbba
adeggggggeebeeeeeeebbbbbbbbbbbba
adeebbbbbbbbeeeeeeebbbeeeefaaaaa
adebbLLLLLLbbeeegggMMMgggefaaaaa
adebLLNNNNLLbbeegOMMMMMOgefaaaaa
adebLNNNNNNLLbbehPMMMMMMhefaaaaa
adebLLNNNNNNLLbehOMMMMMOhefaaaaa
adebbLLNNNNNNLbehQMMMMMMhefaaaaa
adeebbLLNNNNLLbegOMRSSMOgefaaaaa
adeeebbLLLLLLbbegggggggggefaaaaa
adeeeebbbbbbbbeeeeeeeeeeeefaaaaa
adeeeeeeeeeeeeeeeeeeeeeeeefaaaaa
abTTTTTTTTTTTTTTTTTTTTTTTTbaaaaa
aaaaaaaaaaaaaaaaaaaaaaaaaaaaaaaa
aaaaaaaaaaaaaaaaaaaaaaaaaaaaaaaa
aaaaaaaaaaaaaaaaaaaaaaaaaaaaaaaa
"}
