//MAP CONVERTED BY dmm2tgm.py THIS HEADER COMMENT PREVENTS RECONVERSION, DO NOT REMOVE
"a" = (
/turf/template_noop,
/area/template_noop)
"b" = (
/turf/simulated/mineral/ignore_mapgen,
/area/submap/kururak)
"c" = (
/obj/random/trash,
/turf/simulated/mineral/floor/ignore_mapgen,
/area/submap/kururak)
"d" = (
/obj/random/firstaid,
/turf/simulated/mineral/floor/ignore_mapgen,
/area/submap/kururak)
"e" = (
/turf/simulated/mineral/floor/ignore_mapgen,
/area/submap/kururak)
"f" = (
/obj/random/projectile/sec,
/turf/simulated/mineral/floor/ignore_mapgen,
/area/submap/kururak)
"g" = (
/obj/random/tech_supply,
/obj/random/tech_supply,
/turf/simulated/mineral/floor/ignore_mapgen,
/area/submap/kururak)
"h" = (
/mob/living/simple_mob/animal/sif/kururak,
/turf/simulated/mineral/floor/ignore_mapgen,
/area/submap/kururak)
"i" = (
/obj/random/outcrop,
/turf/simulated/mineral/floor/ignore_mapgen,
/area/submap/kururak)
"j" = (
/obj/random/contraband,
/turf/simulated/mineral/floor/ignore_mapgen,
/area/submap/kururak)
"k" = (
/mob/living/simple_mob/animal/sif/diyaab,
/turf/simulated/mineral/floor/ignore_mapgen,
/area/submap/kururak)
"l" = (
/obj/random/trash,
/turf/template_noop,
/area/submap/kururak)
"m" = (
/turf/template_noop,
/area/submap/kururak)

(1,1,1) = {"
a
a
b
b
b
b
a
a
a
a
"}
(2,1,1) = {"
a
b
b
b
b
b
b
a
a
a
"}
(3,1,1) = {"
a
b
b
g
i
b
b
b
a
a
"}
(4,1,1) = {"
a
b
c
e
e
j
b
b
a
a
"}
(5,1,1) = {"
a
b
d
e
e
e
c
b
b
a
"}
(6,1,1) = {"
a
b
e
h
b
b
k
b
b
a
"}
(7,1,1) = {"
a
b
f
i
b
k
k
i
b
a
"}
(8,1,1) = {"
a
b
b
b
b
l
b
b
b
a
"}
(9,1,1) = {"
a
a
a
b
b
m
b
b
a
a
"}
(10,1,1) = {"
a
a
a
a
a
a
a
a
a
a
"}
