//MAP CONVERTED BY dmm2tgm.py THIS HEADER COMMENT PREVENTS RECONVERSION, DO NOT REMOVE
"a" = (
/turf/template_noop,
/area/template_noop)
"b" = (
/turf/template_noop,
/area/submap/mechpit)
"c" = (
/obj/item/trash/chips,
/turf/template_noop,
/area/submap/mechpit)
"d" = (
/obj/structure/railing,
/turf/template_noop,
/area/submap/mechpit)
"e" = (
/obj/structure/railing,
/obj/structure/table/woodentable,
/obj/item/reagent_containers/food/snacks/chips,
/turf/template_noop,
/area/submap/mechpit)
"f" = (
/obj/structure/railing,
/obj/structure/table/woodentable,
/obj/item/cell/high,
/obj/item/cell/high,
/turf/template_noop,
/area/submap/mechpit)
"g" = (
/obj/structure/railing,
/obj/structure/table/woodentable,
/turf/template_noop,
/area/submap/mechpit)
"h" = (
/obj/structure/railing,
/obj/structure/table/woodentable,
/obj/item/spacecash/c10,
/obj/item/spacecash/c10,
/turf/template_noop,
/area/submap/mechpit)
"i" = (
/obj/structure/railing{
	dir = 4;
	icon_state = "railing0"
	},
/turf/template_noop,
/area/submap/mechpit)
"j" = (
/turf/simulated/floor/outdoors/dirt,
/area/submap/mechpit)
"k" = (
/obj/structure/railing{
	dir = 8;
	icon_state = "railing0"
	},
/turf/template_noop,
/area/submap/mechpit)
"l" = (
/obj/item/stack/rods,
/turf/simulated/floor/outdoors/dirt,
/area/submap/mechpit)
"m" = (
/obj/effect/decal/cleanable/blood/oil,
/turf/simulated/floor/outdoors/dirt,
/area/submap/mechpit)
"n" = (
/obj/effect/decal/cleanable/blood/oil/streak,
/turf/simulated/floor/outdoors/dirt,
/area/submap/mechpit)
"o" = (
/obj/effect/decal/mecha_wreckage/ripley/deathripley,
/turf/simulated/floor/outdoors/dirt,
/area/submap/mechpit)
"p" = (
/obj/effect/decal/mecha_wreckage/ripley/firefighter,
/turf/simulated/floor/outdoors/dirt,
/area/submap/mechpit)
"q" = (
/obj/item/stack/cable_coil,
/turf/simulated/floor/outdoors/dirt,
/area/submap/mechpit)
"r" = (
/obj/structure/railing{
	dir = 1;
	icon_state = "railing0"
	},
/turf/template_noop,
/area/submap/mechpit)
"s" = (
/obj/structure/railing{
	dir = 1;
	icon_state = "railing0"
	},
/obj/structure/table/woodentable,
/obj/structure/reagent_dispensers/beerkeg,
/turf/template_noop,
/area/submap/mechpit)
"t" = (
/obj/structure/railing{
	dir = 1;
	icon_state = "railing0"
	},
/obj/structure/table/woodentable,
/obj/item/spacecash/c50,
/turf/template_noop,
/area/submap/mechpit)
"u" = (
/obj/structure/railing{
	dir = 1;
	icon_state = "railing0"
	},
/obj/structure/table/woodentable,
/obj/item/cell/high,
/obj/item/cell/device/weapon,
/turf/template_noop,
/area/submap/mechpit)
"v" = (
/obj/structure/railing{
	dir = 1;
	icon_state = "railing0"
	},
/obj/structure/table/woodentable,
/obj/item/reagent_containers/food/drinks/bottle/small/beer,
/turf/template_noop,
/area/submap/mechpit)

(1,1,1) = {"
a
a
a
a
a
a
a
a
a
a
a
a
a
a
a
a
a
a
a
a
"}
(2,1,1) = {"
a
b
b
b
b
b
b
b
j
b
b
b
b
b
b
b
b
b
b
a
"}
(3,1,1) = {"
a
b
b
b
i
i
i
i
j
j
i
i
i
i
i
b
b
b
b
a
"}
(4,1,1) = {"
a
b
b
d
j
j
j
j
j
j
j
j
j
j
j
r
b
b
b
a
"}
(5,1,1) = {"
a
b
b
d
j
j
j
j
j
j
j
j
j
n
j
r
b
b
b
a
"}
(6,1,1) = {"
a
b
b
d
j
j
j
j
j
j
j
j
j
j
j
r
b
b
b
a
"}
(7,1,1) = {"
a
b
b
d
j
j
l
j
j
j
j
j
j
j
j
r
b
b
b
a
"}
(8,1,1) = {"
a
b
b
d
j
j
j
j
j
j
j
j
j
j
j
r
b
b
b
a
"}
(9,1,1) = {"
a
b
b
d
j
j
j
m
j
j
j
j
j
j
j
r
b
b
b
a
"}
(10,1,1) = {"
a
b
b
d
j
j
j
j
j
j
j
j
j
j
j
r
b
b
b
a
"}
(11,1,1) = {"
a
b
c
d
j
j
j
j
j
j
j
j
m
j
j
r
b
b
b
a
"}
(12,1,1) = {"
a
b
b
d
j
j
j
j
o
j
j
j
j
j
j
r
b
b
b
a
"}
(13,1,1) = {"
a
b
b
e
j
j
j
j
j
j
j
j
j
j
j
s
b
b
b
a
"}
(14,1,1) = {"
a
b
b
f
j
j
j
j
j
j
j
j
q
j
j
t
b
b
b
a
"}
(15,1,1) = {"
a
b
b
g
j
j
j
j
j
j
p
j
j
j
j
u
b
b
b
a
"}
(16,1,1) = {"
a
b
b
h
j
j
j
j
j
j
j
j
j
j
j
t
b
b
b
a
"}
(17,1,1) = {"
a
b
b
g
j
j
j
j
j
j
j
j
j
j
j
v
b
b
b
a
"}
(18,1,1) = {"
a
b
b
d
j
j
j
j
j
j
j
j
j
j
j
r
b
b
b
a
"}
(19,1,1) = {"
a
b
b
d
j
j
j
j
j
j
m
j
j
j
j
r
b
b
b
a
"}
(20,1,1) = {"
a
b
b
d
j
j
m
j
j
j
j
j
j
j
j
r
b
b
b
a
"}
(21,1,1) = {"
a
b
b
d
j
j
j
j
j
j
j
j
j
j
j
r
b
b
b
a
"}
(22,1,1) = {"
a
b
b
d
j
j
j
j
j
j
j
j
j
j
j
r
b
b
b
a
"}
(23,1,1) = {"
a
b
b
d
j
j
j
j
j
j
j
j
j
j
j
r
b
b
b
a
"}
(24,1,1) = {"
a
b
b
d
j
j
n
j
j
j
j
j
j
j
j
r
b
b
b
a
"}
(25,1,1) = {"
a
b
b
d
j
j
j
j
j
j
j
j
j
j
j
r
b
b
b
a
"}
(26,1,1) = {"
a
b
b
d
j
j
j
j
j
j
j
j
j
j
j
r
b
b
b
a
"}
(27,1,1) = {"
a
b
b
d
j
j
j
j
j
j
j
j
j
j
j
r
b
b
b
a
"}
(28,1,1) = {"
a
b
b
d
j
j
j
j
j
j
j
j
j
j
j
r
b
b
b
a
"}
(29,1,1) = {"
a
b
b
b
k
k
k
k
j
j
k
k
k
k
k
b
b
b
b
a
"}
(30,1,1) = {"
a
a
a
a
a
a
a
a
a
a
a
a
a
a
a
a
a
a
a
a
"}
