//MAP CONVERTED BY dmm2tgm.py THIS HEADER COMMENT PREVENTS RECONVERSION, DO NOT REMOVE
"aa" = (
/turf/template_noop,
/area/template_noop)
"ab" = (
/turf/template_noop,
/area/submap/Blackshuttledown)
"ac" = (
/obj/effect/decal/remains/human,
/turf/template_noop,
/area/submap/Blackshuttledown)
"ad" = (
/turf/simulated/mineral/ignore_mapgen,
/area/submap/Blackshuttledown)
"ae" = (
/obj/effect/decal/cleanable/blood,
/turf/template_noop,
/area/submap/Blackshuttledown)
"af" = (
/obj/structure/flora/tree/sif,
/turf/template_noop,
/area/submap/Blackshuttledown)
"ag" = (
/obj/effect/alien/weeds,
/mob/living/simple_mob/animal/space/alien/queen/empress,
/turf/simulated/floor/tiled/steel,
/area/submap/Blackshuttledown)
"ah" = (
/mob/living/simple_mob/animal/space/alien/drone,
/obj/effect/alien/weeds,
/turf/simulated/floor/tiled/steel,
/area/submap/Blackshuttledown)
"ai" = (
/turf/template_noop,
/turf/simulated/shuttle/wall/dark{
	icon_state = "dark6";
	name = "Unknown Shuttle"
	},
/area/submap/Blackshuttledown)
"aj" = (
/turf/simulated/shuttle/wall/dark{
	icon_state = "dark0";
	name = "Unknown Shuttle"
	},
/area/submap/Blackshuttledown)
"ak" = (
/turf/template_noop,
/turf/simulated/shuttle/wall/dark{
	icon_state = "dark10";
	name = "Unknown Shuttle"
	},
/area/submap/Blackshuttledown)
"al" = (
/obj/structure/shuttle/engine/heater{
	dir = 4;
	icon_state = "heater"
	},
/turf/simulated/shuttle/wall/dark{
	icon_state = "dark0";
	name = "Unknown Shuttle"
	},
/area/submap/Blackshuttledown)
"am" = (
/obj/structure/shuttle/engine/propulsion{
	dir = 4;
	icon_state = "propulsion_l"
	},
/turf/template_noop,
/area/submap/Blackshuttledown)
"an" = (
/obj/machinery/light{
	dir = 1
	},
/obj/effect/floor_decal/borderfloor{
	dir = 9
	},
/obj/effect/alien/weeds,
/obj/structure/alien/wall,
/turf/simulated/floor/tiled/steel,
/area/submap/Blackshuttledown)
"ao" = (
/obj/effect/floor_decal/borderfloor{
	dir = 5
	},
/obj/effect/alien/weeds,
/obj/structure/alien/wall,
/turf/simulated/floor/tiled/steel,
/area/submap/Blackshuttledown)
"ap" = (
/obj/machinery/door/airlock/external{
	density = 1;
	frequency = 1331;
	id_tag = "merc_shuttle_outer";
	name = "Ship External Access"
	},
/obj/machinery/door/blast/regular{
	id = "blueshuttle"
	},
/turf/simulated/floor/tiled/steel,
/area/submap/Blackshuttledown)
"aq" = (
/obj/effect/floor_decal/corner/green/border{
	dir = 9;
	icon_state = "bordercolor"
	},
/turf/simulated/floor/tiled/white,
/area/submap/Blackshuttledown)
"ar" = (
/obj/effect/floor_decal/corner/green/border{
	dir = 1;
	icon_state = "bordercolor"
	},
/obj/structure/morgue{
	dir = 8;
	icon_state = "morgue1"
	},
/turf/simulated/floor/tiled/white,
/area/submap/Blackshuttledown)
"as" = (
/obj/machinery/light{
	dir = 1
	},
/obj/effect/floor_decal/corner/green/border{
	dir = 1;
	icon_state = "bordercolor"
	},
/obj/structure/table/standard,
/obj/random/firstaid,
/obj/random/firstaid,
/obj/random/firstaid,
/turf/simulated/floor/tiled/white,
/area/submap/Blackshuttledown)
"at" = (
/obj/machinery/bodyscanner{
	dir = 8
	},
/obj/effect/floor_decal/corner/green/border{
	dir = 1;
	icon_state = "bordercolor"
	},
/turf/simulated/floor/tiled/white,
/area/submap/Blackshuttledown)
"au" = (
/obj/machinery/body_scanconsole,
/obj/effect/floor_decal/corner/green/border{
	dir = 5;
	icon_state = "bordercolor"
	},
/turf/simulated/floor/tiled/white,
/area/submap/Blackshuttledown)
"av" = (
/turf/simulated/floor/tiled/steel,
/turf/simulated/shuttle/wall/dark{
	icon_state = "dark5";
	name = "Unknown Shuttle"
	},
/area/submap/Blackshuttledown)
"aw" = (
/turf/simulated/floor/tiled/yellow,
/area/submap/Blackshuttledown)
"ax" = (
/obj/structure/closet/crate,
/obj/item/stolenpackage,
/obj/item/stolenpackage,
/obj/item/stolenpackage,
/obj/random/contraband/nofail,
/obj/random/contraband/nofail,
/obj/effect/floor_decal/borderfloor{
	dir = 6
	},
/obj/item/clothing/suit/space/pirate,
/obj/item/clothing/head/hgpiratecap,
/turf/simulated/floor/tiled/red,
/area/submap/Blackshuttledown)
"ay" = (
/obj/effect/floor_decal/borderfloor{
	dir = 8
	},
/mob/living/simple_mob/animal/space/alien/drone,
/obj/effect/alien/weeds,
/turf/simulated/floor/tiled/steel,
/area/submap/Blackshuttledown)
"az" = (
/obj/effect/floor_decal/borderfloor{
	dir = 4
	},
/mob/living/simple_mob/animal/space/alien/sentinel/praetorian,
/obj/effect/alien/weeds,
/turf/simulated/floor/tiled/steel,
/area/submap/Blackshuttledown)
"aA" = (
/obj/machinery/door/airlock/external,
/turf/simulated/floor/tiled/steel,
/area/submap/Blackshuttledown)
"aB" = (
/obj/effect/floor_decal/corner/green/border{
	dir = 8;
	icon_state = "bordercolor"
	},
/turf/simulated/floor/tiled/white,
/area/submap/Blackshuttledown)
"aC" = (
/obj/machinery/optable,
/turf/simulated/floor/tiled/white,
/area/submap/Blackshuttledown)
"aD" = (
/obj/effect/alien/weeds,
/obj/structure/closet/secure_closet/egg/xenomorph,
/obj/random/maintenance/research,
/obj/random/material/precious,
/obj/random/maintenance/cargo,
/obj/item/stolenpackage,
/turf/simulated/floor/tiled/yellow,
/area/submap/Blackshuttledown)
"aE" = (
/turf/simulated/floor/tiled/white,
/area/submap/Blackshuttledown)
"aF" = (
/obj/machinery/organ_printer/flesh,
/obj/effect/floor_decal/corner/green/border{
	dir = 5;
	icon_state = "bordercolor"
	},
/turf/simulated/floor/tiled/white,
/area/submap/Blackshuttledown)
"aG" = (
/turf/simulated/floor/tiled/steel,
/turf/simulated/shuttle/wall/dark{
	icon_state = "dark9";
	name = "Unknown Shuttle"
	},
/area/submap/Blackshuttledown)
"aH" = (
/turf/simulated/floor/tiled/steel,
/turf/simulated/shuttle/wall/dark{
	icon_state = "dark6";
	name = "Unknown Shuttle"
	},
/area/submap/Blackshuttledown)
"aI" = (
/obj/structure/table/steel,
/obj/effect/floor_decal/borderfloor{
	dir = 8
	},
/obj/random/projectile,
/obj/effect/alien/weeds,
/turf/simulated/floor/tiled/steel,
/area/submap/Blackshuttledown)
"aJ" = (
/obj/machinery/light/small{
	dir = 4;
	pixel_y = 0
	},
/obj/structure/closet/crate,
/obj/item/stolenpackage,
/obj/item/stolenpackage,
/obj/item/stolenpackage,
/obj/random/contraband/nofail,
/obj/random/contraband/nofail,
/obj/effect/floor_decal/borderfloor{
	dir = 4
	},
/obj/item/clothing/under/pirate,
/turf/simulated/floor/tiled/red,
/area/submap/Blackshuttledown)
"aK" = (
/obj/effect/floor_decal/borderfloor/corner{
	dir = 4
	},
/obj/effect/alien/weeds,
/turf/simulated/floor/tiled/steel,
/area/submap/Blackshuttledown)
"aL" = (
/obj/effect/floor_decal/borderfloor{
	dir = 1
	},
/obj/effect/alien/weeds,
/turf/simulated/floor/tiled/steel,
/area/submap/Blackshuttledown)
"aM" = (
/obj/effect/floor_decal/borderfloor{
	dir = 5
	},
/obj/effect/alien/weeds,
/turf/simulated/floor/tiled/steel,
/area/submap/Blackshuttledown)
"aN" = (
/obj/structure/closet/crate,
/obj/item/stolenpackage,
/obj/item/stolenpackage,
/obj/item/stolenpackage,
/obj/random/contraband/nofail,
/obj/random/contraband/nofail,
/obj/effect/floor_decal/borderfloor{
	dir = 5
	},
/obj/item/clothing/head/helmet/space/pirate,
/obj/item/melee/energy/sword/pirate,
/turf/simulated/floor/tiled/red,
/area/submap/Blackshuttledown)
"aO" = (
/mob/living/simple_mob/animal/space/alien/queen/empress/mother,
/obj/effect/alien/weeds,
/turf/simulated/floor/tiled/steel,
/area/submap/Blackshuttledown)
"aP" = (
/obj/machinery/light{
	dir = 4;
	icon_state = "tube1";
	pixel_x = 0
	},
/obj/effect/floor_decal/corner/green/border{
	dir = 4;
	icon_state = "bordercolor"
	},
/turf/simulated/floor/tiled/white,
/area/submap/Blackshuttledown)
"aQ" = (
/obj/structure/table/steel,
/obj/effect/floor_decal/borderfloor/full,
/obj/effect/alien/weeds,
/turf/simulated/floor/tiled/steel,
/area/submap/Blackshuttledown)
"aR" = (
/obj/effect/floor_decal/borderfloor{
	dir = 8
	},
/obj/effect/alien/weeds,
/turf/simulated/floor/tiled/steel,
/area/submap/Blackshuttledown)
"aS" = (
/obj/effect/floor_decal/borderfloor/corner,
/obj/effect/alien/weeds,
/turf/simulated/floor/tiled/steel,
/area/submap/Blackshuttledown)
"aT" = (
/obj/effect/floor_decal/borderfloor,
/obj/effect/alien/weeds,
/turf/simulated/floor/tiled/steel,
/area/submap/Blackshuttledown)
"aU" = (
/obj/machinery/light{
	dir = 4;
	icon_state = "tube1";
	pixel_x = 0
	},
/obj/effect/floor_decal/borderfloor{
	dir = 6
	},
/obj/effect/alien/weeds,
/turf/simulated/floor/tiled/steel,
/area/submap/Blackshuttledown)
"aV" = (
/obj/structure/table/standard,
/obj/item/storage/firstaid/surgery,
/obj/effect/floor_decal/corner/green/border{
	dir = 10;
	icon_state = "bordercolor"
	},
/turf/simulated/floor/tiled/white,
/area/submap/Blackshuttledown)
"aW" = (
/obj/structure/table/standard,
/obj/item/tank/anesthetic,
/obj/effect/floor_decal/corner/green/border,
/turf/simulated/floor/tiled/white,
/area/submap/Blackshuttledown)
"aX" = (
/obj/effect/floor_decal/corner/green/border,
/turf/simulated/floor/tiled/white,
/area/submap/Blackshuttledown)
"aY" = (
/obj/structure/table/standard,
/obj/item/clothing/gloves/sterile,
/obj/item/clothing/gloves/sterile,
/obj/effect/floor_decal/corner/green/border,
/turf/simulated/floor/tiled/white,
/area/submap/Blackshuttledown)
"aZ" = (
/obj/structure/table/standard,
/obj/item/reagent_containers/spray/sterilizine,
/obj/item/reagent_containers/spray/sterilizine,
/obj/effect/floor_decal/corner/green/border,
/turf/simulated/floor/tiled/white,
/area/submap/Blackshuttledown)
"ba" = (
/obj/structure/table/standard,
/obj/item/storage/box/masks,
/obj/effect/floor_decal/corner/green/border{
	dir = 6;
	icon_state = "bordercolor"
	},
/turf/simulated/floor/tiled/white,
/area/submap/Blackshuttledown)
"bb" = (
/obj/machinery/light{
	dir = 8;
	icon_state = "tube1"
	},
/obj/effect/floor_decal/borderfloor{
	dir = 9
	},
/obj/effect/alien/weeds,
/turf/simulated/floor/tiled/steel,
/area/submap/Blackshuttledown)
"bc" = (
/obj/structure/bed/chair/office/dark{
	dir = 1
	},
/obj/effect/floor_decal/borderfloor{
	dir = 5
	},
/obj/effect/alien/weeds,
/turf/simulated/floor/tiled/steel,
/area/submap/Blackshuttledown)
"bd" = (
/obj/machinery/door/airlock/security{
	locked = 1
	},
/obj/machinery/door/blast/regular{
	id = "blueshuttle"
	},
/turf/simulated/floor/tiled/steel,
/area/submap/Blackshuttledown)
"be" = (
/obj/machinery/door/airlock/glass,
/obj/machinery/door/blast/regular{
	id = "blueshuttle"
	},
/turf/simulated/floor/tiled/white,
/area/submap/Blackshuttledown)
"bf" = (
/turf/simulated/floor/tiled/steel,
/turf/simulated/shuttle/wall/dark{
	icon_state = "dark10";
	name = "Unknown Shuttle"
	},
/area/submap/Blackshuttledown)
"bg" = (
/obj/machinery/computer/communications,
/obj/effect/floor_decal/borderfloor{
	dir = 9
	},
/obj/effect/alien/weeds,
/turf/simulated/floor/tiled/steel,
/area/submap/Blackshuttledown)
"bh" = (
/obj/effect/floor_decal/borderfloor/corner{
	dir = 1
	},
/obj/effect/alien/weeds,
/turf/simulated/floor/tiled/steel,
/area/submap/Blackshuttledown)
"bi" = (
/obj/effect/floor_decal/borderfloor{
	dir = 9
	},
/obj/effect/alien/weeds,
/turf/simulated/floor/tiled/steel,
/area/submap/Blackshuttledown)
"bj" = (
/obj/structure/closet/secure_closet/freezer/fridge,
/obj/effect/alien/weeds,
/turf/simulated/floor/tiled/steel,
/area/submap/Blackshuttledown)
"bk" = (
/obj/structure/table/steel,
/obj/item/material/knife,
/obj/effect/alien/weeds,
/turf/simulated/floor/tiled/steel,
/area/submap/Blackshuttledown)
"bl" = (
/turf/simulated/floor/tiled/steel,
/area/submap/Blackshuttledown)
"bm" = (
/obj/machinery/light{
	dir = 1
	},
/obj/effect/alien/weeds,
/turf/simulated/floor/tiled/steel,
/area/submap/Blackshuttledown)
"bn" = (
/obj/structure/curtain/open/shower/security,
/obj/structure/window/reinforced/tinted/frosted{
	dir = 1;
	icon_state = "fwindow"
	},
/obj/structure/window/reinforced/tinted/frosted,
/turf/simulated/floor/tiled/hydro,
/area/submap/Blackshuttledown)
"bo" = (
/obj/structure/table/steel,
/obj/random/maintenance/engineering,
/obj/random/maintenance/engineering,
/obj/random/maintenance/research,
/obj/random/maintenance/research,
/obj/effect/alien/weeds,
/turf/simulated/floor/tiled/yellow,
/area/submap/Blackshuttledown)
"bp" = (
/obj/machinery/light/small{
	dir = 4;
	pixel_y = 0
	},
/obj/structure/table/steel,
/obj/random/maintenance/engineering,
/obj/random/maintenance/engineering,
/obj/random/maintenance/research,
/obj/random/maintenance/research,
/obj/effect/alien/weeds,
/turf/simulated/floor/tiled/yellow,
/area/submap/Blackshuttledown)
"bq" = (
/obj/structure/grille,
/obj/structure/window/reinforced{
	dir = 1
	},
/obj/structure/window/reinforced{
	dir = 8
	},
/obj/structure/window/reinforced{
	dir = 4
	},
/obj/machinery/door/blast/regular{
	id = "blueshuttle"
	},
/turf/simulated/floor/plating,
/area/submap/Blackshuttledown)
"br" = (
/obj/structure/table/steel,
/obj/effect/floor_decal/borderfloor{
	dir = 8
	},
/obj/effect/alien/weeds,
/obj/item/cell/super,
/turf/simulated/floor/tiled/steel,
/area/submap/Blackshuttledown)
"bs" = (
/obj/machinery/light{
	dir = 8;
	icon_state = "tube1"
	},
/obj/effect/floor_decal/borderfloor{
	dir = 8
	},
/obj/effect/alien/weeds,
/turf/simulated/floor/tiled/steel,
/area/submap/Blackshuttledown)
"bt" = (
/obj/machinery/light{
	dir = 4;
	icon_state = "tube1";
	pixel_x = 0
	},
/obj/effect/floor_decal/borderfloor{
	dir = 4
	},
/obj/effect/alien/weeds,
/turf/simulated/floor/tiled/steel,
/area/submap/Blackshuttledown)
"bu" = (
/obj/item/stool,
/obj/effect/alien/weeds,
/turf/simulated/floor/tiled/steel,
/area/submap/Blackshuttledown)
"bv" = (
/obj/structure/table/steel,
/obj/random/toolbox,
/obj/effect/alien/weeds,
/obj/item/clothing/suit/armor/pcarrier/blue/sol,
/turf/simulated/floor/tiled/yellow,
/area/submap/Blackshuttledown)
"bw" = (
/obj/structure/sink{
	dir = 8;
	icon_state = "sink";
	pixel_x = -16
	},
/turf/simulated/floor/tiled/hydro,
/area/submap/Blackshuttledown)
"bx" = (
/obj/structure/grille,
/obj/structure/window/reinforced{
	dir = 4
	},
/obj/structure/window/reinforced{
	dir = 8
	},
/obj/machinery/door/blast/regular{
	id = "blueshuttle"
	},
/turf/simulated/floor/plating,
/area/submap/Blackshuttledown)
"by" = (
/obj/random/maintenance/foodstuff,
/obj/effect/alien/weeds,
/turf/simulated/floor/tiled/steel,
/area/submap/Blackshuttledown)
"bz" = (
/mob/living/simple_mob/humanoid/merc/ranged/smg/sol{
	faction = "neutral"
	},
/turf/simulated/floor/tiled/white,
/area/submap/Blackshuttledown)
"bA" = (
/obj/machinery/door/airlock/glass,
/turf/simulated/floor/tiled/steel,
/area/submap/Blackshuttledown)
"bB" = (
/obj/structure/table/steel,
/obj/effect/alien/weeds,
/obj/structure/alien/wall,
/turf/simulated/floor/tiled/steel,
/area/submap/Blackshuttledown)
"bC" = (
/obj/structure/table/steel,
/obj/random/maintenance/foodstuff,
/obj/effect/alien/weeds,
/turf/simulated/floor/tiled/steel,
/area/submap/Blackshuttledown)
"bD" = (
/obj/machinery/door/airlock,
/turf/simulated/floor/tiled/steel,
/area/submap/Blackshuttledown)
"bE" = (
/obj/effect/alien/weeds,
/obj/structure/closet/secure_closet/egg/xenomorph,
/obj/random/maintenance/security,
/obj/random/material/precious,
/obj/random/maintenance/cargo,
/obj/item/stolenpackage,
/turf/simulated/floor/tiled/yellow,
/area/submap/Blackshuttledown)
"bF" = (
/obj/effect/floor_decal/borderfloor/corner{
	dir = 8
	},
/obj/effect/alien/weeds,
/turf/simulated/floor/tiled/steel,
/area/submap/Blackshuttledown)
"bG" = (
/obj/structure/grille,
/obj/structure/window/reinforced,
/obj/structure/window/reinforced{
	dir = 8
	},
/obj/structure/window/reinforced{
	dir = 4
	},
/obj/machinery/door/blast/regular{
	id = "blueshuttle"
	},
/turf/simulated/floor/plating,
/area/submap/Blackshuttledown)
"bH" = (
/obj/effect/alien/weeds,
/obj/item/frame/apc,
/turf/simulated/floor/tiled/yellow,
/area/submap/Blackshuttledown)
"bI" = (
/mob/living/simple_mob/animal/space/alien/sentinel/praetorian,
/obj/effect/alien/weeds,
/turf/simulated/floor/tiled/steel,
/area/submap/Blackshuttledown)
"bJ" = (
/obj/machinery/computer/area_atmos,
/obj/effect/floor_decal/borderfloor{
	dir = 10
	},
/obj/effect/alien/weeds,
/turf/simulated/floor/tiled/steel,
/area/submap/Blackshuttledown)
"bK" = (
/obj/machinery/door/airlock/glass,
/obj/machinery/door/blast/regular{
	id = "blueshuttle"
	},
/turf/simulated/floor/tiled/steel,
/area/submap/Blackshuttledown)
"bL" = (
/obj/effect/floor_decal/borderfloor{
	dir = 10
	},
/obj/effect/alien/weeds,
/turf/simulated/floor/tiled/steel,
/area/submap/Blackshuttledown)
"bM" = (
/obj/effect/floor_decal/borderfloor{
	dir = 4
	},
/obj/effect/floor_decal/borderfloor{
	dir = 4
	},
/obj/effect/alien/weeds,
/turf/simulated/floor/tiled/steel,
/area/submap/Blackshuttledown)
"bN" = (
/obj/effect/floor_decal/borderfloor,
/obj/effect/alien/weeds,
/obj/structure/alien/wall,
/turf/simulated/floor/tiled/steel,
/area/submap/Blackshuttledown)
"bO" = (
/obj/effect/alien/weeds,
/obj/structure/alien/wall,
/turf/simulated/floor/tiled/steel,
/area/submap/Blackshuttledown)
"bP" = (
/obj/machinery/light,
/obj/effect/alien/weeds,
/turf/simulated/floor/tiled/steel,
/area/submap/Blackshuttledown)
"bQ" = (
/obj/machinery/atmospherics/pipe/tank/oxygen,
/obj/effect/alien/weeds,
/turf/simulated/floor/tiled/yellow,
/area/submap/Blackshuttledown)
"bR" = (
/obj/machinery/portable_atmospherics/canister/empty/oxygen,
/obj/effect/alien/weeds,
/turf/simulated/floor/tiled/yellow,
/area/submap/Blackshuttledown)
"bS" = (
/obj/machinery/atmospherics/pipe/tank/oxygen,
/obj/machinery/light/small{
	dir = 4;
	pixel_y = 0
	},
/obj/effect/alien/weeds,
/turf/simulated/floor/tiled/yellow,
/area/submap/Blackshuttledown)
"bT" = (
/obj/machinery/light{
	dir = 8;
	icon_state = "tube1"
	},
/obj/effect/floor_decal/borderfloor{
	dir = 10
	},
/obj/effect/alien/weeds,
/turf/simulated/floor/tiled/steel,
/area/submap/Blackshuttledown)
"bU" = (
/obj/structure/bed/chair/office/dark,
/obj/effect/floor_decal/borderfloor{
	dir = 6
	},
/obj/effect/alien/weeds,
/turf/simulated/floor/tiled/steel,
/area/submap/Blackshuttledown)
"bV" = (
/obj/effect/floor_decal/borderfloor{
	dir = 1
	},
/mob/living/simple_mob/animal/space/alien/drone,
/obj/effect/alien/weeds,
/turf/simulated/floor/tiled/steel,
/area/submap/Blackshuttledown)
"bW" = (
/obj/effect/floor_decal/borderfloor/corner{
	dir = 4
	},
/obj/effect/floor_decal/borderfloor/corner{
	dir = 4
	},
/obj/effect/alien/weeds,
/turf/simulated/floor/tiled/steel,
/area/submap/Blackshuttledown)
"bX" = (
/obj/machinery/light{
	dir = 4;
	icon_state = "tube1";
	pixel_x = 0
	},
/obj/effect/floor_decal/borderfloor{
	dir = 5
	},
/obj/effect/alien/weeds,
/turf/simulated/floor/tiled/steel,
/area/submap/Blackshuttledown)
"bY" = (
/obj/structure/bed,
/obj/item/bedsheet,
/turf/simulated/floor/tiled/steel,
/area/submap/Blackshuttledown)
"bZ" = (
/obj/machinery/door/airlock,
/turf/simulated/floor/tiled/hydro,
/area/submap/Blackshuttledown)
"ca" = (
/turf/simulated/floor/tiled/hydro,
/area/submap/Blackshuttledown)
"cb" = (
/obj/machinery/light/small{
	dir = 4;
	pixel_y = 0
	},
/obj/structure/curtain/open/shower/security,
/obj/structure/window/reinforced/tinted/frosted{
	dir = 1;
	icon_state = "fwindow"
	},
/obj/structure/window/reinforced/tinted/frosted,
/mob/living/simple_mob/humanoid/merc/ranged/smg/sol{
	faction = "neutral"
	},
/turf/simulated/floor/tiled/hydro,
/area/submap/Blackshuttledown)
"cc" = (
/obj/machinery/light/small{
	dir = 4;
	pixel_y = 0
	},
/obj/structure/bed,
/turf/simulated/floor/tiled/yellow,
/area/submap/Blackshuttledown)
"cd" = (
/obj/effect/floor_decal/borderfloor{
	dir = 6
	},
/obj/effect/alien/weeds,
/turf/simulated/floor/tiled/steel,
/area/submap/Blackshuttledown)
"ce" = (
/obj/structure/bed,
/obj/item/bedsheet,
/obj/structure/bed,
/turf/simulated/floor/tiled/steel,
/area/submap/Blackshuttledown)
"cf" = (
/obj/structure/urinal{
	dir = 4;
	icon_state = "urinal";
	pixel_x = -32
	},
/turf/simulated/floor/tiled/hydro,
/area/submap/Blackshuttledown)
"cg" = (
/obj/structure/toilet{
	dir = 4;
	icon_state = "toilet00"
	},
/obj/structure/curtain,
/obj/structure/window/reinforced/tinted/frosted{
	dir = 1;
	icon_state = "fwindow"
	},
/turf/simulated/floor/tiled/hydro,
/area/submap/Blackshuttledown)
"ch" = (
/obj/structure/bed,
/turf/simulated/floor/tiled/yellow,
/area/submap/Blackshuttledown)
"ci" = (
/obj/structure/alien/wall,
/turf/simulated/shuttle/wall/dark{
	icon_state = "dark0";
	name = "Unknown Shuttle"
	},
/area/submap/Blackshuttledown)
"cj" = (
/obj/effect/floor_decal/borderfloor{
	dir = 10
	},
/obj/effect/alien/weeds,
/obj/structure/alien/wall,
/turf/simulated/floor/tiled/steel,
/area/submap/Blackshuttledown)
"ck" = (
/obj/effect/floor_decal/borderfloor{
	dir = 6
	},
/obj/effect/alien/weeds,
/obj/structure/alien/wall,
/turf/simulated/floor/tiled/steel,
/area/submap/Blackshuttledown)
"cl" = (
/obj/structure/table/woodentable,
/obj/random/projectile,
/obj/random/maintenance/security,
/turf/simulated/floor/tiled/steel,
/area/submap/Blackshuttledown)
"cm" = (
/obj/structure/bed,
/obj/item/bedsheet,
/obj/machinery/light,
/turf/simulated/floor/tiled/steel,
/area/submap/Blackshuttledown)
"cp" = (
/turf/template_noop,
/turf/simulated/shuttle/wall/dark{
	icon_state = "dark5";
	name = "Unknown Shuttle"
	},
/area/submap/Blackshuttledown)
"cq" = (
/turf/template_noop,
/turf/simulated/shuttle/wall/dark{
	icon_state = "dark9";
	name = "Unknown Shuttle"
	},
/area/submap/Blackshuttledown)
"cr" = (
/obj/effect/floor_decal/borderfloor{
	dir = 4
	},
/obj/effect/alien/weeds,
/turf/simulated/floor/tiled/steel,
/area/submap/Blackshuttledown)
"cs" = (
/mob/living/simple_mob/humanoid/merc/ranged/laser/poi{
	faction = "neutral"
	},
/turf/simulated/floor/tiled/white,
/area/submap/Blackshuttledown)
"ct" = (
/obj/effect/alien/weeds,
/turf/simulated/floor/tiled/steel,
/area/submap/Blackshuttledown)
"hS" = (
/obj/effect/floor_decal/borderfloor{
	dir = 4
	},
/obj/effect/alien/weeds,
/mob/living/simple_mob/animal/space/alien/drone,
/turf/simulated/floor/tiled/steel,
/area/submap/Blackshuttledown)
"iF" = (
/obj/effect/floor_decal/borderfloor,
/mob/living/simple_mob/animal/space/alien/drone,
/obj/effect/alien/weeds,
/turf/simulated/floor/tiled/steel,
/area/submap/Blackshuttledown)
"mZ" = (
/obj/effect/floor_decal/borderfloor{
	dir = 8
	},
/turf/simulated/floor/tiled/red,
/area/submap/Blackshuttledown)
"oi" = (
/obj/effect/alien/weeds,
/obj/effect/map_helper/no_phaseshift/area,
/turf/simulated/floor/tiled/steel,
/area/submap/Blackshuttledown)
"so" = (
/obj/structure/table/steel,
/obj/random/toolbox,
/obj/effect/alien/weeds,
/obj/item/module/power_control,
/turf/simulated/floor/tiled/yellow,
/area/submap/Blackshuttledown)
"uQ" = (
/obj/effect/alien/weeds,
/obj/structure/closet/secure_closet/egg/xenomorph,
/obj/random/maintenance/security,
/obj/random/material/precious,
/obj/random/maintenance/cargo,
/obj/random/rigsuit/chancetofail,
/turf/simulated/floor/tiled/yellow,
/area/submap/Blackshuttledown)
"BR" = (
/obj/effect/alien/weeds,
/obj/structure/closet/secure_closet/egg/xenomorph,
/obj/random/maintenance/research,
/obj/random/material/precious,
/obj/random/maintenance/cargo,
/obj/random/rigsuit/chancetofail,
/turf/simulated/floor/tiled/yellow,
/area/submap/Blackshuttledown)
"Gj" = (
/obj/effect/floor_decal/borderfloor{
	dir = 8
	},
/obj/effect/alien/weeds,
/obj/structure/alien/wall,
/turf/simulated/floor/tiled/steel,
/area/submap/Blackshuttledown)
"JN" = (
/obj/effect/floor_decal/borderfloor/corner{
	dir = 1
	},
/mob/living/simple_mob/animal/space/alien/drone,
/obj/effect/alien/weeds,
/turf/simulated/floor/tiled/steel,
/area/submap/Blackshuttledown)
"KB" = (
/obj/effect/floor_decal/borderfloor{
	dir = 4
	},
/obj/effect/alien/weeds,
/obj/structure/alien/wall,
/turf/simulated/floor/tiled/steel,
/area/submap/Blackshuttledown)
"NI" = (
/obj/structure/table/steel,
/obj/effect/floor_decal/borderfloor{
	dir = 8
	},
/obj/effect/alien/weeds,
/obj/machinery/button/remote/blast_door{
	id = "blueshuttle"
	},
/turf/simulated/floor/tiled/steel,
/area/submap/Blackshuttledown)
"PE" = (
/obj/effect/floor_decal/borderfloor{
	dir = 9
	},
/turf/simulated/floor/tiled/red,
/area/submap/Blackshuttledown)
"Ql" = (
/obj/effect/floor_decal/borderfloor/corner{
	dir = 4
	},
/obj/effect/alien/weeds,
/obj/structure/alien/wall,
/turf/simulated/floor/tiled/steel,
/area/submap/Blackshuttledown)
"Ri" = (
/mob/living/simple_mob/humanoid/pirate/armored,
/turf/simulated/floor/tiled/yellow,
/area/submap/Blackshuttledown)
"TF" = (
/obj/effect/floor_decal/borderfloor{
	dir = 1
	},
/obj/effect/alien/weeds,
/obj/structure/alien/wall,
/turf/simulated/floor/tiled/steel,
/area/submap/Blackshuttledown)
"Ue" = (
/obj/structure/table/woodentable,
/obj/random/projectile,
/obj/random/maintenance/security,
/obj/item/clothing/suit/armor/pcarrier/blue/sol,
/turf/simulated/floor/tiled/steel,
/area/submap/Blackshuttledown)
"Vz" = (
/obj/effect/floor_decal/borderfloor/corner{
	dir = 8
	},
/mob/living/simple_mob/animal/space/alien/drone,
/obj/effect/alien/weeds,
/turf/simulated/floor/tiled/steel,
/area/submap/Blackshuttledown)
"Ym" = (
/obj/effect/floor_decal/borderfloor{
	dir = 10
	},
/turf/simulated/floor/tiled/red,
/area/submap/Blackshuttledown)
"Yy" = (
/obj/structure/table/steel,
/obj/random/projectile,
/obj/effect/alien/weeds,
/obj/item/clothing/suit/armor/pcarrier/blue/sol,
/turf/simulated/floor/tiled/steel,
/area/submap/Blackshuttledown)

(1,1,1) = {"
aa
aa
aa
aa
aa
aa
aa
aa
aa
aa
aa
aa
aa
aa
aa
aa
aa
aa
aa
aa
aa
aa
aa
aa
aa
aa
aa
aa
aa
aa
aa
aa
aa
aa
aa
"}
(2,1,1) = {"
aa
ab
ab
ab
ab
ab
ab
ab
ab
ab
ab
ab
ab
ab
ab
ab
ab
ab
ab
ab
ab
ab
ab
ab
ab
ab
ab
ab
ab
ab
ab
ab
ab
ab
aa
"}
(3,1,1) = {"
aa
ab
ab
ab
ab
ab
ab
ab
ab
ab
ab
ab
af
ab
ab
ab
ab
ab
ab
ab
ab
ab
af
ab
ab
ab
ab
ab
ab
ad
ab
ab
ab
ab
aa
"}
(4,1,1) = {"
aa
ab
ab
ab
af
ab
ab
ab
ab
ab
ab
ab
ab
ab
ab
ab
ab
ab
ab
ab
ab
ab
ab
ab
ab
ab
af
ab
ad
ad
ad
ab
ab
ab
aa
"}
(5,1,1) = {"
aa
ab
ab
ab
ab
ab
ab
ab
ab
ab
ab
ab
ab
ab
ab
ab
ab
ab
ab
ab
ab
ab
ab
ab
ab
ab
ab
ad
ad
ad
ad
ab
af
ab
aa
"}
(6,1,1) = {"
aa
ab
ab
ab
ad
ab
ab
ab
ab
af
ab
ab
ab
ab
ab
ab
ab
ab
ab
ab
ab
ab
ab
ab
ab
ab
ab
ab
ab
ab
ab
ab
ab
ab
aa
"}
(7,1,1) = {"
aa
ac
ab
ab
ad
ad
ab
ab
ab
ab
ab
ab
ab
aH
aj
bq
bx
bx
bG
aj
av
ab
ab
ab
ab
ab
ab
ab
ac
ab
ab
ab
ab
ab
aa
"}
(8,1,1) = {"
aa
ab
ae
ab
ad
ad
ad
ab
ab
ab
ab
ab
aH
aj
bg
br
aI
aI
NI
bJ
aj
av
ab
ab
ab
ab
ab
ab
ab
ab
ac
ab
ad
ab
aa
"}
(9,1,1) = {"
aa
ab
ab
ab
ab
ad
ad
ai
aj
aj
av
aH
aj
bb
JN
ct
ct
ct
ct
Vz
bT
aj
av
aH
aj
aj
cp
ab
ab
ab
ab
ad
ad
ad
aa
"}
(10,1,1) = {"
aa
ab
ab
ab
ab
ab
ab
aj
aj
aj
aj
aj
aQ
bc
cr
az
aK
aS
az
cr
bU
aQ
aj
aj
aj
aj
aj
ab
ab
ab
ad
ad
ad
ad
aa
"}
(11,1,1) = {"
aa
ab
ab
ab
ab
ac
af
aj
aj
aj
aj
aj
aj
ci
ci
ci
aL
aT
ci
ci
ci
ci
aj
aj
aj
aj
aj
af
ab
ab
ab
af
ab
ab
aa
"}
(12,1,1) = {"
aa
ab
ab
ab
ab
ab
ab
aj
aj
aj
PE
mZ
Ym
bd
bi
bs
bh
bF
Gj
bL
bd
aw
Ri
aw
aj
aj
aj
ab
af
ab
ab
ab
ab
ac
aa
"}
(13,1,1) = {"
aa
ab
ab
ab
af
ab
ab
ak
aj
aj
aN
aJ
ax
ci
aL
ct
ag
ct
ct
aT
ci
ch
cc
ch
aj
aj
cq
ab
ab
ae
ab
ab
ab
ab
aa
"}
(14,1,1) = {"
aa
ab
ab
ab
ab
ab
ab
ab
aj
aj
ci
ci
ci
ci
TF
ct
ct
bO
ct
aT
ci
bq
bx
bG
ci
aj
ab
ab
ab
ab
ab
ab
ab
ab
aa
"}
(15,1,1) = {"
aa
ab
ab
ad
ab
ab
ab
ab
aj
an
ay
aR
aR
aR
bh
bI
ct
oi
bI
bF
aR
aR
Gj
Gj
cj
aj
ab
ab
ab
ab
ab
af
ab
ab
aa
"}
(16,1,1) = {"
aa
ad
ad
ad
ab
ab
ab
ab
aj
ao
KB
Ql
aS
cr
KB
bt
ct
ct
bt
bM
cr
bW
aS
hS
ck
aj
ab
ab
ab
ab
ab
ab
ab
ab
aa
"}
(17,1,1) = {"
aa
ad
ad
ab
ab
ab
ab
ab
aj
aj
aj
aL
iF
ci
ci
ci
bA
bA
ci
ci
ci
bV
bN
aj
aj
aj
ab
ab
ab
ab
ab
ab
ab
ab
aa
"}
(18,1,1) = {"
aa
ab
ab
ab
ab
ab
ab
ab
ab
ap
aA
aL
aT
ci
bj
ah
ct
ct
ah
bO
ci
aL
aT
aA
ap
ab
ab
ab
ab
ab
ab
ab
ab
ab
aa
"}
(19,1,1) = {"
aa
ac
ab
ab
ab
ab
ab
ab
ab
ap
aA
aM
aU
ci
bk
ct
bO
ct
bO
bO
ci
bX
cd
aA
ap
ab
ab
ab
ab
ab
ab
ab
af
ab
aa
"}
(20,1,1) = {"
aa
ab
ab
af
ab
ab
ab
ab
aj
aj
aj
aj
aj
ci
ah
bu
bB
by
bu
ah
ci
ci
ci
aj
aj
aj
ab
ab
ab
ab
ab
ac
ab
ab
aa
"}
(21,1,1) = {"
aa
ab
ab
ab
ab
ab
ab
ab
aj
aq
aB
aB
aV
ci
bm
bO
bO
bC
bu
bP
ci
bY
ce
bY
bY
aj
ab
ab
ab
ab
ab
ab
ad
ab
aa
"}
(22,1,1) = {"
aa
ab
ab
ab
ab
ab
ab
ab
aj
ar
aC
aE
aW
ci
ct
bu
bC
Yy
bu
bO
ci
bl
cl
bl
Ue
aj
ab
ab
ab
ab
ab
ad
ad
ab
aa
"}
(23,1,1) = {"
aa
ab
ab
ab
ab
ab
ab
ab
aj
as
bz
aE
aE
be
ct
bI
ct
ct
bI
ct
bK
bl
bY
bY
cm
aj
ab
ab
ab
ab
ad
ad
ad
ab
aa
"}
(24,1,1) = {"
aa
ab
ab
af
ab
ab
ab
ab
aj
at
aE
aE
aX
aj
bO
ct
ct
ct
bO
ct
ci
bZ
aj
aj
aj
aj
ab
af
ab
ad
ad
ad
ad
ad
aa
"}
(25,1,1) = {"
aa
ac
ab
ab
ab
ab
ab
af
aj
au
cs
aE
aY
aj
ci
ci
bD
bD
ci
ci
aj
ca
bw
cf
cg
aj
cp
ab
ab
ad
ad
af
ab
ae
aa
"}
(26,1,1) = {"
aa
ab
ab
ab
ab
ab
ab
ai
aj
aj
aE
aE
aZ
aj
bv
so
ct
ct
bH
bQ
aj
ca
ca
ca
ca
aj
aj
af
ac
ab
ab
ab
ab
ab
aa
"}
(27,1,1) = {"
aa
ab
ab
ae
ab
ac
ab
aj
aj
aj
aF
aP
ba
aj
bo
bI
ct
ct
bI
bR
aj
bn
cb
bn
bn
aj
aj
ab
ab
ab
ab
ab
ab
ac
aa
"}
(28,1,1) = {"
aa
ab
ab
ab
ab
ab
ab
aj
aj
aj
aj
aj
aj
aj
bp
ct
ct
aO
ct
bS
aj
aj
aj
aj
aj
aj
aj
ab
ab
ab
ab
ab
ab
af
aa
"}
(29,1,1) = {"
aa
ab
ab
ab
ab
af
ab
aj
aj
aj
aj
aG
ab
bf
aj
bE
BR
uQ
aD
aj
aG
ab
bf
aj
aj
aj
aj
ab
ad
ad
ab
ab
ab
ab
aa
"}
(30,1,1) = {"
aa
ab
ad
ad
ad
ab
ab
aj
aj
aj
aG
ab
ab
ab
bf
al
al
al
al
aG
ab
ab
ab
bf
al
al
cq
ad
ad
ad
ad
ab
ab
ab
aa
"}
(31,1,1) = {"
aa
ab
af
ad
ad
ad
ab
ak
al
al
ab
ab
ab
ab
ab
am
am
am
am
ab
ab
ab
af
ab
am
am
ab
ad
ad
ad
ad
ab
ab
ab
aa
"}
(32,1,1) = {"
aa
ab
ab
ab
ab
ab
ab
ab
am
am
ab
ab
ab
ab
ab
ab
ab
ab
ab
ab
ab
ab
ab
ab
ab
ab
ab
ad
ad
ad
ab
ab
af
ab
aa
"}
(33,1,1) = {"
aa
ab
ab
ab
ab
ab
ab
ab
ab
ab
ab
ab
af
ab
ab
ab
ab
ab
ab
ab
ab
ab
ab
ab
ab
ab
ab
ab
ab
ab
ab
ab
ab
ab
aa
"}
(34,1,1) = {"
aa
ab
ac
ab
ab
ab
ab
ab
ab
ab
ab
ab
ab
ab
ab
ab
ab
ab
ab
ab
ab
ab
ab
ab
ab
ab
ab
ab
ab
ab
ab
ab
ab
ab
aa
"}
(35,1,1) = {"
aa
aa
aa
aa
aa
aa
aa
aa
aa
aa
aa
aa
aa
aa
aa
aa
aa
aa
aa
aa
aa
aa
aa
aa
aa
aa
aa
aa
aa
aa
aa
aa
aa
aa
aa
"}
