//MAP CONVERTED BY dmm2tgm.py THIS HEADER COMMENT PREVENTS RECONVERSION, DO NOT REMOVE
"aa" = (
/turf/template_noop,
/area/template_noop)
"ab" = (
/turf/template_noop,
/area/submap/BoomBase)
"ac" = (
/obj/effect/decal/remains/human,
/turf/template_noop,
/area/submap/BoomBase)
"ad" = (
/obj/structure/flora/tree/sif,
/turf/template_noop,
/area/submap/BoomBase)
"ae" = (
/turf/simulated/wall/r_wall,
/area/submap/BoomBase)
"af" = (
/obj/structure/girder,
/turf/simulated/floor/plating,
/area/submap/BoomBase)
"ag" = (
/obj/structure/girder,
/obj/item/stack/rods,
/turf/simulated/floor/plating/sif/planetuse,
/area/submap/BoomBase)
"ah" = (
/obj/item/stack/rods,
/turf/simulated/wall/r_wall,
/area/submap/BoomBase)
"ai" = (
/obj/structure/closet/crate/secure/phoron,
/obj/fiftyspawner/phoron,
/turf/simulated/floor/plating/sif/planetuse,
/area/submap/BoomBase)
"aj" = (
/obj/structure/closet/crate/secure/phoron,
/obj/fiftyspawner/phoron,
/turf/simulated/floor/tiled/steel,
/area/submap/BoomBase)
"al" = (
/obj/effect/decal/cleanable/dirt,
/obj/effect/decal/cleanable/ash,
/turf/simulated/floor/tiled/steel/sif/planetuse,
/area/submap/BoomBase)
"am" = (
/obj/effect/decal/cleanable/dirt,
/turf/simulated/floor/tiled/steel,
/area/submap/BoomBase)
"an" = (
/obj/effect/decal/cleanable/dirt,
/obj/effect/spider,
/obj/item/material/shard,
/turf/simulated/floor/tiled/steel/sif/planetuse,
/area/submap/BoomBase)
"ao" = (
/turf/simulated/floor/tiled/steel/sif/planetuse,
/area/submap/BoomBase)
"ap" = (
/mob/living/simple_mob/animal/giant_spider/phorogenic,
/turf/simulated/floor/tiled/steel/sif/planetuse,
/area/submap/BoomBase)
"aq" = (
/obj/machinery/portable_atmospherics/canister/empty/phoron,
/turf/simulated/floor/tiled/steel/sif/planetuse,
/area/submap/BoomBase)
"ar" = (
/obj/machinery/portable_atmospherics/canister/empty/phoron,
/obj/item/material/shard,
/turf/simulated/floor/tiled/steel/sif/planetuse,
/area/submap/BoomBase)
"as" = (
/obj/item/material/shard,
/turf/simulated/floor/plating/sif/planetuse,
/area/submap/BoomBase)
"at" = (
/obj/effect/spider/stickyweb,
/turf/simulated/floor/plating/sif/planetuse,
/area/submap/BoomBase)
"au" = (
/turf/simulated/floor/outdoors/dirt,
/area/submap/BoomBase)
"av" = (
/obj/effect/decal/cleanable/dirt,
/turf/simulated/floor/plating/sif/planetuse,
/area/submap/BoomBase)
"aw" = (
/obj/effect/decal/cleanable/dirt,
/obj/random/mob/spider/mutant,
/turf/simulated/floor/tiled/steel,
/area/submap/BoomBase)
"ay" = (
/obj/effect/decal/remains/human,
/turf/simulated/floor/tiled/steel/sif/planetuse,
/area/submap/BoomBase)
"aB" = (
/turf/simulated/floor/plating,
/area/submap/BoomBase)
"aC" = (
/obj/structure/flora/tree/dead,
/turf/simulated/floor/outdoors/dirt/sif/planetuse,
/area/submap/BoomBase)
"aD" = (
/obj/effect/decal/cleanable/dirt,
/turf/simulated/floor/outdoors/dirt/sif/planetuse,
/area/submap/BoomBase)
"aE" = (
/obj/effect/decal/cleanable/dirt,
/obj/effect/spider/stickyweb,
/turf/simulated/floor/tiled/steel/sif/planetuse,
/area/submap/BoomBase)
"aH" = (
/obj/effect/decal/cleanable/ash,
/turf/simulated/floor/outdoors/dirt/sif/planetuse,
/area/submap/BoomBase)
"aI" = (
/obj/random/mob/spider/mutant,
/turf/simulated/floor/outdoors/dirt/sif/planetuse,
/area/submap/BoomBase)
"aJ" = (
/obj/structure/table,
/turf/simulated/floor/tiled/steel/sif/planetuse,
/area/submap/BoomBase)
"aK" = (
/obj/effect/decal/cleanable/dirt,
/mob/living/simple_mob/animal/giant_spider/phorogenic,
/turf/simulated/floor/tiled/steel/sif/planetuse,
/area/submap/BoomBase)
"aM" = (
/turf/simulated/floor/outdoors/rocks/sif/planetuse,
/area/submap/BoomBase)
"aN" = (
/obj/effect/decal/cleanable/dirt,
/obj/structure/table/standard,
/obj/item/tank/phoron,
/obj/item/fuel_assembly/phoron,
/turf/simulated/floor/tiled/steel/sif/planetuse,
/area/submap/BoomBase)
"aO" = (
/obj/effect/decal/remains/human,
/obj/effect/decal/cleanable/ash,
/turf/simulated/floor/tiled/steel/sif/planetuse,
/area/submap/BoomBase)
"aP" = (
/obj/item/material/shard,
/turf/simulated/floor/tiled/steel/sif/planetuse,
/area/submap/BoomBase)
"aQ" = (
/obj/item/transfer_valve,
/turf/simulated/floor/outdoors/rocks/sif/planetuse,
/area/submap/BoomBase)
"aR" = (
/obj/item/material/shard,
/turf/template_noop,
/area/submap/BoomBase)
"aS" = (
/obj/effect/decal/cleanable/ash,
/turf/simulated/floor/plating/sif/planetuse,
/area/submap/BoomBase)
"aT" = (
/obj/effect/decal/cleanable/ash,
/turf/simulated/floor/tiled/steel/sif/planetuse,
/area/submap/BoomBase)
"aU" = (
/obj/effect/spider/stickyweb,
/obj/item/material/shard,
/turf/simulated/floor/tiled/steel/sif/planetuse,
/area/submap/BoomBase)
"aV" = (
/obj/effect/spider/stickyweb,
/obj/random/mob/spider/mutant,
/turf/simulated/floor/tiled/steel/sif/planetuse,
/area/submap/BoomBase)
"aW" = (
/obj/effect/spider/stickyweb,
/obj/effect/decal/cleanable/ash,
/turf/simulated/floor/tiled/steel/sif/planetuse,
/area/submap/BoomBase)
"aX" = (
/obj/effect/decal/remains/human,
/obj/effect/decal/cleanable/ash,
/turf/template_noop,
/area/submap/BoomBase)
"aY" = (
/obj/structure/flora/tree/dead,
/turf/template_noop,
/area/submap/BoomBase)
"aZ" = (
/turf/simulated/floor/outdoors/dirt/sif/planetuse,
/area/submap/BoomBase)
"ba" = (
/turf/simulated/floor/plating/sif/planetuse,
/area/submap/BoomBase)
"bb" = (
/obj/structure/girder,
/turf/simulated/floor/plating/sif/planetuse,
/area/submap/BoomBase)
"bc" = (
/obj/effect/decal/cleanable/dirt,
/turf/simulated/floor/tiled/steel/sif/planetuse,
/area/submap/BoomBase)

(1,1,1) = {"
aa
aa
aa
aa
aa
aa
aa
aa
aa
aa
aa
aa
aa
aa
aa
aa
aa
aa
aa
aa
"}
(2,1,1) = {"
aa
ab
ab
ab
ad
ab
ab
ab
ab
ab
ab
ab
ab
ad
ab
ab
ab
ab
ab
aa
"}
(3,1,1) = {"
aa
ac
ab
ab
ab
ab
ab
ab
ab
ab
ab
ab
ab
ab
ab
ab
ab
ab
aY
aa
"}
(4,1,1) = {"
aa
ab
ab
ab
ab
ad
ab
ab
ab
ab
ad
ab
ab
ab
ab
ab
ab
ab
ab
aa
"}
(5,1,1) = {"
aa
ab
ab
ab
ab
ab
ab
ab
ad
ab
ab
ab
aS
ab
ab
ab
ab
ab
ab
aa
"}
(6,1,1) = {"
aa
ad
ab
ah
ae
ae
ae
ae
ae
ae
ae
ae
ae
ae
af
ab
ab
ab
ab
aa
"}
(7,1,1) = {"
aa
ab
ae
ae
av
av
aE
bc
bc
aJ
aN
ao
aB
aT
ba
ab
ab
ab
ab
aa
"}
(8,1,1) = {"
aa
ab
ae
ai
av
av
av
bc
bc
aK
aO
aP
ao
ao
ag
ba
bb
ba
ab
aa
"}
(9,1,1) = {"
aa
ab
ae
aj
av
av
av
av
aD
aD
aZ
aZ
aZ
aZ
ab
ab
ba
bb
aY
aa
"}
(10,1,1) = {"
aa
ab
ae
bc
aw
am
av
bb
aD
ao
aZ
aZ
aZ
aZ
aZ
aZ
ab
ab
ab
aa
"}
(11,1,1) = {"
aa
ab
ae
al
bc
av
aD
bc
aD
aZ
aZ
aZ
aZ
aZ
aZ
aZ
ae
aZ
ab
aa
"}
(12,1,1) = {"
aa
ab
ae
bc
av
bb
aD
aD
aZ
aZ
aZ
aZ
aZ
aZ
aZ
aZ
ba
ae
ab
aa
"}
(13,1,1) = {"
aa
ab
ae
an
av
aD
aD
aZ
aZ
aZ
aM
au
au
au
aZ
aZ
ba
ae
ab
aa
"}
(14,1,1) = {"
aa
ab
ae
ao
ao
aZ
aZ
aZ
aZ
aZ
aM
aM
aM
aM
aZ
aZ
ba
ba
ab
aa
"}
(15,1,1) = {"
aa
ab
ae
ap
ay
aZ
aZ
aZ
aH
aM
aM
aM
aM
aZ
aZ
aZ
aZ
ab
ab
aa
"}
(16,1,1) = {"
aa
ad
ae
aq
ao
aZ
aZ
aZ
aZ
aM
aM
aQ
aM
aZ
aZ
aZ
aZ
aZ
aZ
aa
"}
(17,1,1) = {"
aa
ab
ae
ar
ao
aZ
aZ
aZ
aI
aZ
aM
aR
aM
aZ
aZ
aZ
aZ
aZ
aZ
aa
"}
(18,1,1) = {"
aa
ab
ae
as
ba
aZ
aZ
aZ
aZ
aZ
aZ
aZ
aZ
aZ
aZ
aZ
aZ
aZ
ab
aa
"}
(19,1,1) = {"
aa
ab
ae
at
aZ
aZ
aZ
aZ
aZ
aZ
aZ
aZ
aZ
aZ
aZ
aZ
ba
ba
ab
aa
"}
(20,1,1) = {"
aa
ab
ae
ag
aZ
aZ
aZ
aZ
aZ
aZ
aZ
aZ
aZ
aZ
aZ
ba
ba
ae
ab
aa
"}
(21,1,1) = {"
aa
ab
ae
ab
aZ
aZ
aZ
aZ
aZ
aZ
aZ
aZ
aZ
aZ
aZ
ba
aW
ae
ab
aa
"}
(22,1,1) = {"
aa
ab
bb
ab
ab
aZ
aZ
ae
ae
ae
ae
ae
ab
ab
ba
aV
aX
ah
ab
aa
"}
(23,1,1) = {"
aa
ab
ag
ab
aZ
aZ
aZ
ba
bb
bb
bb
bb
ab
ba
aU
ao
ae
ae
ab
aa
"}
(24,1,1) = {"
aa
ac
ab
au
aC
aZ
aZ
aZ
aC
aZ
bb
ba
ab
ab
ab
ab
ab
ab
ac
aa
"}
(25,1,1) = {"
aa
aa
aa
aa
aa
aa
aa
aa
aa
aa
aa
aa
aa
aa
aa
aa
aa
aa
aa
aa
"}
