//MAP CONVERTED BY dmm2tgm.py THIS HEADER COMMENT PREVENTS RECONVERSION, DO NOT REMOVE
"aB" = (
/obj/structure/table/steel,
/obj/random/projectile,
/obj/machinery/recharger,
/obj/item/gun/projectile/automatic/fal,
/obj/effect/floor_decal/corner/grey/diagonal,
/turf/simulated/floor/concrete,
/area/submap/BountyHunters)
"aF" = (
/obj/effect/floor_decal/corner/grey/diagonal,
/obj/effect/map_helper/no_phaseshift/area,
/turf/simulated/floor/concrete,
/area/submap/BountyHunters)
"be" = (
/mob/living/simple_mob/humanoid/merc/ranged/space/suppressor/elite{
	name = "elite bounty hunter"
	},
/obj/effect/floor_decal/corner/grey/diagonal,
/turf/simulated/floor/concrete,
/area/submap/BountyHunters)
"bw" = (
/obj/structure/railing,
/obj/machinery/light/small{
	dir = 8
	},
/obj/effect/floor_decal/corner/grey/diagonal,
/turf/simulated/floor/concrete,
/area/submap/BountyHunters)
"cI" = (
/obj/machinery/light/small{
	dir = 4;
	pixel_y = 0
	},
/obj/effect/floor_decal/corner/grey/diagonal,
/turf/simulated/floor/concrete,
/area/submap/BountyHunters)
"db" = (
/obj/structure/cable{
	d2 = 2;
	icon_state = "0-2"
	},
/obj/machinery/power/port_gen/pacman,
/obj/effect/floor_decal/corner/grey/diagonal,
/turf/simulated/floor/concrete,
/area/submap/BountyHunters)
"dI" = (
/obj/effect/floor_decal/industrial/warning{
	dir = 4
	},
/turf/simulated/floor/outdoors/dirt,
/area/submap/BountyHunters)
"eH" = (
/obj/structure/table/steel,
/obj/random/maintenance/medical,
/obj/item/storage/firstaid/clotting,
/obj/effect/floor_decal/corner/grey/diagonal,
/turf/simulated/floor/concrete,
/area/submap/BountyHunters)
"eY" = (
/obj/machinery/door/airlock,
/turf/simulated/floor/concrete,
/area/submap/BountyHunters)
"fY" = (
/obj/structure/grille,
/obj/structure/window/reinforced{
	dir = 8
	},
/obj/structure/window/reinforced{
	dir = 4
	},
/obj/structure/window/reinforced{
	dir = 1
	},
/obj/structure/window/reinforced,
/obj/machinery/door/blast/regular{
	id = "bountycellA"
	},
/turf/simulated/floor/concrete,
/area/submap/BountyHunters)
"gT" = (
/obj/structure/grille,
/obj/structure/grille,
/obj/structure/window/reinforced{
	dir = 8
	},
/obj/structure/window/reinforced{
	dir = 8
	},
/obj/structure/window/reinforced{
	dir = 1
	},
/obj/structure/window/reinforced,
/obj/machinery/door/blast/regular{
	id = "bountycellB"
	},
/turf/simulated/floor/concrete,
/area/submap/BountyHunters)
"hj" = (
/obj/machinery/door/blast/regular{
	id = "bountycellA"
	},
/obj/machinery/door/airlock,
/obj/effect/floor_decal/corner/grey/diagonal,
/obj/effect/floor_decal/corner/grey/diagonal,
/turf/simulated/floor/concrete,
/area/submap/BountyHunters)
"kn" = (
/obj/structure/toilet{
	dir = 1
	},
/obj/structure/toilet{
	dir = 1
	},
/obj/effect/floor_decal/corner/grey/diagonal,
/turf/simulated/floor/concrete,
/area/submap/BountyHunters)
"lf" = (
/obj/structure/sink{
	pixel_y = 16
	},
/obj/effect/floor_decal/corner/grey/diagonal,
/turf/simulated/floor/concrete,
/area/submap/BountyHunters)
"mf" = (
/turf/simulated/wall/r_concrete,
/area/submap/BountyHunters)
"mY" = (
/obj/structure/table/steel,
/obj/random/projectile,
/obj/machinery/recharger,
/obj/effect/floor_decal/corner/grey/diagonal,
/turf/simulated/floor/concrete,
/area/submap/BountyHunters)
"nD" = (
/obj/structure/table/sifwoodentable,
/obj/structure/table/sifwoodentable,
/obj/machinery/light/small{
	dir = 8
	},
/obj/random/maintenance/morestuff,
/obj/effect/floor_decal/corner/grey/diagonal,
/turf/simulated/floor/concrete,
/area/submap/BountyHunters)
"oX" = (
/obj/structure/grille,
/obj/structure/window/reinforced{
	dir = 8
	},
/obj/structure/window/reinforced{
	dir = 1
	},
/obj/structure/window/reinforced,
/obj/machinery/door/blast/regular{
	id = "bountycellA"
	},
/turf/simulated/floor/concrete,
/area/submap/BountyHunters)
"pF" = (
/obj/structure/table/steel,
/obj/random/maintenance/foodstuff,
/obj/machinery/light/small{
	dir = 4;
	pixel_y = 0
	},
/obj/effect/floor_decal/corner/grey/diagonal,
/turf/simulated/floor/concrete,
/area/submap/BountyHunters)
"pG" = (
/obj/structure/grille,
/obj/structure/grille,
/obj/structure/window/reinforced{
	dir = 1
	},
/obj/structure/window/reinforced,
/obj/machinery/door/blast/regular{
	id = "bountycellB"
	},
/turf/simulated/floor/concrete,
/area/submap/BountyHunters)
"qy" = (
/obj/structure/grille,
/obj/structure/window/reinforced{
	dir = 8
	},
/obj/structure/window/reinforced{
	dir = 1
	},
/obj/structure/window/reinforced,
/obj/structure/window/reinforced{
	dir = 4
	},
/obj/machinery/door/blast/regular{
	id = "bountycellB"
	},
/turf/simulated/floor/concrete,
/area/submap/BountyHunters)
"rC" = (
/obj/effect/floor_decal/corner/grey/diagonal,
/turf/simulated/floor/concrete,
/area/submap/BountyHunters)
"sM" = (
/obj/effect/floor_decal/industrial/warning{
	dir = 6
	},
/obj/effect/floor_decal/industrial/warning{
	dir = 6
	},
/turf/simulated/floor/outdoors/dirt,
/area/submap/BountyHunters)
"tE" = (
/obj/effect/floor_decal/corner/grey/diagonal,
/obj/effect/floor_decal/corner/grey/diagonal,
/turf/simulated/floor/concrete,
/area/submap/BountyHunters)
"tM" = (
/mob/living/simple_mob/humanoid/eclipse/solar/snipertesh,
/obj/effect/floor_decal/corner/grey/diagonal,
/turf/simulated/floor/concrete,
/area/submap/BountyHunters)
"uh" = (
/obj/structure/table/steel,
/obj/random/material/precious,
/obj/random/material/precious,
/obj/effect/floor_decal/corner/grey/diagonal,
/turf/simulated/floor/concrete,
/area/submap/BountyHunters)
"wa" = (
/obj/structure/grille,
/obj/structure/window/reinforced{
	dir = 4
	},
/obj/structure/window/reinforced{
	dir = 1
	},
/obj/structure/window/reinforced,
/obj/machinery/door/blast/regular{
	id = "bountycellA"
	},
/turf/simulated/floor/concrete,
/area/submap/BountyHunters)
"wu" = (
/obj/structure/table/steel,
/obj/random/material/precious,
/obj/effect/floor_decal/corner/grey/diagonal,
/turf/simulated/floor/concrete,
/area/submap/BountyHunters)
"xt" = (
/obj/structure/railing,
/obj/effect/floor_decal/corner/grey/diagonal,
/turf/simulated/floor/concrete,
/area/submap/BountyHunters)
"yz" = (
/obj/structure/table/steel,
/obj/random/maintenance/foodstuff,
/obj/effect/floor_decal/corner/grey/diagonal,
/turf/simulated/floor/concrete,
/area/submap/BountyHunters)
"zu" = (
/obj/machinery/power/apc{
	dir = 1;
	name = "PAPC";
	pixel_x = 0;
	pixel_y = 24
	},
/obj/structure/cable/green{
	d2 = 8;
	icon_state = "0-8"
	},
/obj/effect/floor_decal/corner/grey/diagonal,
/turf/simulated/floor/concrete,
/area/submap/BountyHunters)
"zM" = (
/obj/machinery/button/remote/blast_door{
	id = "bountycellB"
	},
/obj/structure/table/steel,
/obj/machinery/light/small{
	dir = 4
	},
/obj/machinery/light/small{
	dir = 4
	},
/obj/effect/floor_decal/corner/grey/diagonal,
/turf/simulated/floor/concrete,
/area/submap/BountyHunters)
"Bu" = (
/obj/machinery/button/remote/blast_door{
	id = "bountycellA"
	},
/obj/structure/table/steel,
/obj/machinery/light/small{
	dir = 8
	},
/obj/effect/floor_decal/corner/grey/diagonal,
/turf/simulated/floor/concrete,
/area/submap/BountyHunters)
"DA" = (
/mob/living/simple_mob/humanoid/eclipse/lunar/bulletstorm,
/obj/effect/floor_decal/corner/grey/diagonal,
/turf/simulated/floor/concrete,
/area/submap/BountyHunters)
"Ej" = (
/obj/structure/toilet{
	dir = 1
	},
/obj/effect/floor_decal/corner/grey/diagonal,
/turf/simulated/floor/concrete,
/area/submap/BountyHunters)
"EC" = (
/obj/effect/floor_decal/industrial/warning{
	dir = 9
	},
/turf/simulated/floor/outdoors/dirt,
/area/submap/BountyHunters)
"Gz" = (
/obj/structure/grille,
/obj/structure/window/reinforced{
	dir = 4
	},
/obj/structure/window/reinforced{
	dir = 8
	},
/obj/structure/window/reinforced{
	dir = 1
	},
/obj/structure/window/reinforced,
/obj/machinery/door/blast/regular{
	id = "bountycellB"
	},
/turf/simulated/floor/concrete,
/area/submap/BountyHunters)
"Hj" = (
/obj/effect/floor_decal/industrial/warning,
/turf/simulated/floor/outdoors/dirt,
/area/submap/BountyHunters)
"HF" = (
/obj/machinery/door/blast/regular{
	id = "bountycellA"
	},
/obj/machinery/door/airlock,
/obj/effect/floor_decal/corner/grey/diagonal,
/turf/simulated/floor/concrete,
/area/submap/BountyHunters)
"Ii" = (
/obj/structure/cable{
	d1 = 1;
	d2 = 8;
	icon_state = "1-8"
	},
/obj/effect/floor_decal/corner/grey/diagonal,
/turf/simulated/floor/concrete,
/area/submap/BountyHunters)
"IW" = (
/obj/machinery/power/terminal{
	dir = 1;
	icon_state = "term"
	},
/obj/structure/cable{
	d2 = 4;
	icon_state = "0-4"
	},
/obj/effect/floor_decal/corner/grey/diagonal,
/turf/simulated/floor/concrete,
/area/submap/BountyHunters)
"Jn" = (
/obj/structure/railing,
/obj/machinery/light/small{
	dir = 4;
	pixel_y = 0
	},
/obj/effect/floor_decal/corner/grey/diagonal,
/turf/simulated/floor/concrete,
/area/submap/BountyHunters)
"Kq" = (
/obj/effect/floor_decal/industrial/warning{
	dir = 8
	},
/turf/simulated/floor/outdoors/dirt,
/area/submap/BountyHunters)
"KF" = (
/obj/structure/table/steel,
/obj/random/maintenance/medical,
/obj/effect/floor_decal/corner/grey/diagonal,
/turf/simulated/floor/concrete,
/area/submap/BountyHunters)
"Ly" = (
/obj/structure/grille,
/obj/structure/grille,
/obj/structure/window/reinforced{
	dir = 4
	},
/obj/structure/window/reinforced{
	dir = 1
	},
/obj/structure/window/reinforced,
/obj/structure/window/reinforced,
/obj/machinery/door/blast/regular{
	id = "bountycellB"
	},
/turf/simulated/floor/concrete,
/area/submap/BountyHunters)
"MV" = (
/obj/effect/floor_decal/industrial/warning{
	dir = 10
	},
/turf/simulated/floor/outdoors/dirt,
/area/submap/BountyHunters)
"Nt" = (
/obj/machinery/light/small{
	dir = 8
	},
/obj/effect/floor_decal/corner/grey/diagonal,
/turf/simulated/floor/concrete,
/area/submap/BountyHunters)
"NM" = (
/obj/effect/floor_decal/industrial/warning{
	dir = 5
	},
/obj/effect/floor_decal/industrial/warning{
	dir = 5
	},
/turf/simulated/floor/outdoors/dirt,
/area/submap/BountyHunters)
"Pr" = (
/obj/structure/table/steel,
/obj/random/maintenance/foodstuff,
/obj/machinery/light/small{
	dir = 8
	},
/obj/effect/floor_decal/corner/grey/diagonal,
/turf/simulated/floor/concrete,
/area/submap/BountyHunters)
"PK" = (
/turf/template_noop,
/area/template_noop)
"PN" = (
/obj/machinery/power/smes/buildable/point_of_interest,
/obj/structure/cable/green{
	d2 = 4;
	icon_state = "0-4"
	},
/obj/structure/cable/green{
	d1 = 4;
	d2 = 8;
	icon_state = "4-8"
	},
/obj/effect/floor_decal/corner/grey/diagonal,
/turf/simulated/floor/concrete,
/area/submap/BountyHunters)
"Re" = (
/obj/effect/floor_decal/industrial/warning{
	dir = 1
	},
/turf/simulated/floor/outdoors/dirt,
/area/submap/BountyHunters)
"SL" = (
/obj/structure/table/sifwoodentable,
/obj/structure/table/sifwoodentable,
/obj/machinery/light/small{
	dir = 4;
	pixel_y = 0
	},
/obj/machinery/light/small{
	dir = 4;
	pixel_y = 0
	},
/obj/random/maintenance/morestuff,
/obj/effect/floor_decal/corner/grey/diagonal,
/turf/simulated/floor/concrete,
/area/submap/BountyHunters)
"Ur" = (
/turf/template_noop,
/area/submap/BountyHunters)
"Us" = (
/obj/machinery/light/small,
/turf/simulated/floor/outdoors/dirt,
/area/submap/BountyHunters)
"VQ" = (
/obj/structure/grille,
/obj/structure/window/reinforced{
	dir = 4
	},
/obj/structure/window/reinforced{
	dir = 8
	},
/obj/structure/window/reinforced{
	dir = 1
	},
/obj/structure/window/reinforced,
/obj/machinery/door/blast/regular{
	id = "bountycellA"
	},
/turf/simulated/floor/concrete,
/area/submap/BountyHunters)
"Wj" = (
/turf/simulated/floor/outdoors/dirt,
/area/submap/BountyHunters)
"WC" = (
/obj/machinery/light/small,
/obj/effect/floor_decal/corner/grey/diagonal,
/turf/simulated/floor/concrete,
/area/submap/BountyHunters)
"WF" = (
/obj/structure/cable{
	d1 = 4;
	d2 = 8;
	icon_state = "4-8";
	pixel_x = 0
	},
/mob/living/simple_mob/humanoid/merc/ranged/sniper{
	name = "bounty sniper"
	},
/obj/effect/floor_decal/corner/grey/diagonal,
/turf/simulated/floor/concrete,
/area/submap/BountyHunters)
"Yz" = (
/obj/item/bedsheet/purple,
/obj/effect/floor_decal/corner/grey/diagonal,
/obj/structure/bed/padded,
/turf/simulated/floor/concrete,
/area/submap/BountyHunters)
"ZK" = (
/obj/structure/grille,
/obj/structure/window/reinforced{
	dir = 1
	},
/obj/structure/window/reinforced,
/obj/machinery/door/blast/regular{
	id = "bountycellA"
	},
/turf/simulated/floor/concrete,
/area/submap/BountyHunters)
"ZM" = (
/obj/structure/railing,
/obj/structure/railing,
/obj/machinery/light/small{
	dir = 4;
	pixel_y = 0
	},
/obj/effect/floor_decal/corner/grey/diagonal,
/turf/simulated/floor/concrete,
/area/submap/BountyHunters)

(1,1,1) = {"
PK
PK
PK
PK
PK
PK
PK
PK
PK
PK
PK
PK
PK
PK
PK
PK
PK
PK
PK
PK
PK
PK
PK
PK
PK
"}
(2,1,1) = {"
PK
PK
PK
PK
PK
PK
PK
PK
PK
PK
PK
PK
PK
PK
PK
PK
PK
PK
PK
PK
PK
PK
PK
PK
PK
"}
(3,1,1) = {"
PK
PK
PK
PK
PK
PK
PK
PK
PK
PK
PK
PK
PK
PK
PK
PK
PK
PK
PK
PK
PK
PK
PK
PK
PK
"}
(4,1,1) = {"
PK
PK
Wj
Wj
Wj
Wj
Wj
Wj
Wj
mf
mf
mf
mf
mf
mf
mf
mf
mf
mf
mf
mf
PK
PK
PK
PK
"}
(5,1,1) = {"
PK
PK
Wj
EC
Kq
Kq
Kq
MV
Wj
mf
lf
Nt
kn
mf
Nt
rC
eY
rC
rC
rC
mf
PK
PK
PK
PK
"}
(6,1,1) = {"
PK
PK
Wj
Re
Wj
Wj
Wj
Hj
Wj
oX
rC
rC
rC
fY
rC
rC
mf
rC
rC
rC
bw
PK
PK
PK
PK
"}
(7,1,1) = {"
PK
PK
Wj
Re
Wj
Wj
Wj
Hj
Wj
ZK
rC
DA
rC
hj
rC
rC
mf
PN
IW
rC
xt
PK
PK
PK
PK
"}
(8,1,1) = {"
PK
PK
Wj
Re
Wj
Wj
Wj
Hj
Wj
wa
rC
rC
rC
VQ
rC
WC
mf
zu
WF
rC
xt
PK
PK
PK
PK
"}
(9,1,1) = {"
PK
PK
Wj
Re
Wj
Wj
Wj
Hj
Wj
mf
Yz
SL
rC
mf
rC
rC
mf
db
Ii
rC
Jn
PK
PK
PK
PK
"}
(10,1,1) = {"
PK
PK
Wj
Re
Wj
Wj
Wj
Hj
Us
mf
mf
mf
mf
mf
rC
rC
mf
mf
mf
mf
mf
PK
PK
PK
PK
"}
(11,1,1) = {"
PK
PK
Wj
Re
Wj
Wj
Wj
Hj
Wj
mf
yz
aB
KF
Pr
rC
rC
Bu
mf
Ur
Ur
Ur
PK
PK
PK
PK
"}
(12,1,1) = {"
PK
PK
Wj
Re
Wj
Wj
Wj
Hj
Wj
mf
rC
rC
rC
rC
rC
rC
wu
mf
Ur
Ur
Ur
PK
PK
PK
PK
"}
(13,1,1) = {"
PK
PK
Wj
Re
Wj
Wj
Wj
Hj
Wj
eY
rC
rC
rC
be
aF
rC
rC
eY
Ur
Ur
Ur
PK
PK
PK
PK
"}
(14,1,1) = {"
PK
PK
Wj
Re
Wj
Wj
Wj
Hj
Wj
mf
rC
rC
rC
rC
rC
rC
uh
mf
Ur
Ur
Ur
PK
PK
PK
PK
"}
(15,1,1) = {"
PK
PK
Wj
Re
Wj
Wj
Wj
Hj
Wj
mf
yz
eH
mY
pF
rC
rC
zM
mf
Ur
Ur
Ur
PK
PK
PK
PK
"}
(16,1,1) = {"
PK
PK
Wj
Re
Wj
Wj
Wj
Hj
Us
mf
mf
mf
mf
mf
rC
rC
mf
mf
mf
mf
mf
PK
PK
PK
PK
"}
(17,1,1) = {"
PK
PK
Wj
Re
Wj
Wj
Wj
Hj
Wj
mf
Yz
nD
rC
mf
rC
rC
mf
PN
IW
rC
bw
PK
PK
PK
PK
"}
(18,1,1) = {"
PK
PK
Wj
Re
Wj
Wj
Wj
Hj
Wj
gT
rC
rC
rC
qy
rC
WC
mf
zu
WF
rC
xt
PK
PK
PK
PK
"}
(19,1,1) = {"
PK
PK
Wj
Re
Wj
Wj
Wj
Hj
Wj
pG
rC
tM
rC
HF
rC
rC
mf
db
Ii
rC
xt
PK
PK
PK
PK
"}
(20,1,1) = {"
PK
PK
Wj
Re
Wj
Wj
Wj
Hj
Wj
Ly
rC
rC
rC
Gz
rC
rC
mf
rC
rC
rC
ZM
PK
PK
PK
PK
"}
(21,1,1) = {"
PK
PK
Wj
NM
dI
dI
dI
sM
Wj
mf
lf
cI
Ej
mf
cI
tE
eY
rC
rC
rC
mf
PK
PK
PK
PK
"}
(22,1,1) = {"
PK
PK
Wj
Wj
Wj
Wj
Wj
Wj
Wj
mf
mf
mf
mf
mf
mf
mf
mf
mf
mf
mf
mf
PK
PK
PK
PK
"}
(23,1,1) = {"
PK
PK
PK
PK
PK
PK
PK
PK
PK
PK
PK
PK
PK
PK
PK
PK
PK
PK
PK
PK
PK
PK
PK
PK
PK
"}
(24,1,1) = {"
PK
PK
PK
PK
PK
PK
PK
PK
PK
PK
PK
PK
PK
PK
PK
PK
PK
PK
PK
PK
PK
PK
PK
PK
PK
"}
(25,1,1) = {"
PK
PK
PK
PK
PK
PK
PK
PK
PK
PK
PK
PK
PK
PK
PK
PK
PK
PK
PK
PK
PK
PK
PK
PK
PK
"}
