//MAP CONVERTED BY dmm2tgm.py THIS HEADER COMMENT PREVENTS RECONVERSION, DO NOT REMOVE
"a" = (
/turf/template_noop,
/area/template_noop)
"c" = (
/obj/structure/loot_pile/surface/bones,
/turf/simulated/floor/outdoors/dirt{
	outdoors = 0
	},
/area/submap/CaveS)
"d" = (
/obj/structure/closet/crate,
/obj/random/contraband,
/obj/random/contraband,
/obj/random/energy,
/obj/random/energy,
/turf/simulated/floor,
/area/submap/CaveS)
"e" = (
/obj/effect/spider/stickyweb,
/obj/structure/loot_pile/surface/bones,
/turf/simulated/floor/outdoors/dirt{
	outdoors = 0
	},
/area/submap/CaveS)
"g" = (
/obj/structure/cable{
	d1 = 4;
	d2 = 8;
	icon_state = "4-8";
	pixel_x = 0
	},
/turf/simulated/floor,
/area/submap/CaveS)
"h" = (
/obj/effect/spider/stickyweb,
/obj/effect/spider/stickyweb,
/turf/simulated/floor/outdoors/dirt{
	outdoors = 0
	},
/area/submap/CaveS)
"k" = (
/turf/simulated/wall,
/area/submap/CaveS)
"o" = (
/mob/living/simple_mob/animal/giant_spider/phorogenic,
/turf/simulated/floor/outdoors/dirt{
	outdoors = 0
	},
/area/submap/CaveS)
"p" = (
/obj/item/ammo_casing/a45,
/turf/template_noop,
/area/template_noop)
"q" = (
/obj/structure/cable{
	d2 = 8;
	icon_state = "0-8"
	},
/obj/effect/decal/cleanable/ash,
/turf/simulated/floor,
/area/submap/CaveS)
"r" = (
/obj/effect/spider/stickyweb,
/turf/simulated/floor/outdoors/dirt{
	outdoors = 0
	},
/area/submap/CaveS)
"t" = (
/obj/structure/closet/crate,
/obj/random/firstaid,
/obj/random/firstaid,
/turf/simulated/floor,
/area/submap/CaveS)
"u" = (
/obj/machinery/power/port_gen/pacman,
/obj/structure/cable{
	d2 = 4;
	icon_state = "0-4"
	},
/turf/simulated/floor,
/area/submap/CaveS)
"x" = (
/obj/effect/spider/stickyweb,
/turf/simulated/floor/outdoors/dirt,
/area/submap/CaveS)
"z" = (
/turf/simulated/mineral/ignore_mapgen,
/area/submap/CaveS)
"D" = (
/obj/effect/decal/cleanable/cobweb,
/turf/simulated/floor/outdoors/dirt{
	outdoors = 0
	},
/area/submap/CaveS)
"H" = (
/turf/simulated/floor,
/area/submap/CaveS)
"I" = (
/mob/living/simple_mob/animal/giant_spider/phorogenic,
/obj/effect/spider/stickyweb,
/turf/simulated/floor/outdoors/dirt{
	outdoors = 0
	},
/area/submap/CaveS)
"J" = (
/turf/simulated/floor/outdoors/dirt,
/area/submap/CaveS)
"M" = (
/obj/effect/decal/cleanable/cobweb2,
/turf/simulated/floor/outdoors/dirt{
	outdoors = 0
	},
/area/submap/CaveS)
"P" = (
/turf/simulated/floor/outdoors/dirt{
	outdoors = 0
	},
/area/submap/CaveS)
"S" = (
/obj/structure/loot_pile/surface/bones,
/obj/item/rig/industrial,
/turf/simulated/floor/outdoors/dirt{
	outdoors = 0
	},
/area/submap/CaveS)
"V" = (
/obj/random/mob/spider/mutant,
/turf/simulated/floor/outdoors/dirt{
	outdoors = 0
	},
/area/submap/CaveS)
"X" = (
/obj/structure/closet/crate,
/obj/item/reagent_containers/pill/healing_nanites,
/obj/item/reagent_containers/pill/healing_nanites,
/obj/item/stack/material/phoron{
	amount = 25
	},
/obj/item/reagent_containers/chem_disp_cartridge/acidspit,
/obj/item/reagent_containers/chem_disp_cartridge/cola,
/obj/item/reagent_containers/chem_disp_cartridge/dexalin,
/obj/item/reagent_containers/chem_disp_cartridge/hot_coco,
/turf/simulated/floor/outdoors/dirt{
	outdoors = 0
	},
/area/submap/CaveS)
"Y" = (
/obj/structure/loot_pile/surface/bones,
/obj/item/kinetic_crusher,
/turf/simulated/floor/outdoors/dirt{
	outdoors = 0
	},
/area/submap/CaveS)

(1,1,1) = {"
a
a
a
a
a
a
a
a
a
a
a
a
a
a
a
a
a
a
a
a
a
a
a
a
a
a
a
a
a
a
a
a
a
a
a
a
a
a
a
a
"}
(2,1,1) = {"
a
a
a
a
a
a
a
a
a
a
a
a
a
a
a
a
a
a
a
a
a
a
a
a
a
a
a
a
a
a
a
a
a
a
a
a
a
a
a
a
"}
(3,1,1) = {"
a
a
a
a
a
a
a
a
a
a
a
a
a
a
a
a
a
a
z
z
z
z
z
z
z
z
z
z
z
z
z
z
z
a
a
a
a
a
a
a
"}
(4,1,1) = {"
a
a
a
a
a
a
a
a
a
a
a
a
a
a
z
z
z
z
z
z
z
z
z
z
z
z
z
z
z
z
z
z
z
z
z
z
a
a
a
a
"}
(5,1,1) = {"
a
a
a
a
a
a
a
a
a
a
a
z
z
z
z
z
z
z
z
z
z
z
z
z
r
r
z
z
r
r
z
z
z
z
z
z
z
z
z
a
"}
(6,1,1) = {"
a
a
a
a
a
a
a
a
a
z
z
z
z
z
z
z
z
z
z
z
z
z
z
P
P
P
P
P
P
r
I
z
z
z
z
z
z
z
z
a
"}
(7,1,1) = {"
a
a
a
a
a
a
a
a
a
z
z
z
z
z
z
V
r
z
z
z
z
z
z
P
S
P
P
P
P
P
r
z
z
z
z
z
z
z
a
a
"}
(8,1,1) = {"
a
a
a
a
a
a
a
a
a
z
z
z
z
z
z
P
P
r
z
z
z
z
P
P
P
P
P
V
P
P
P
r
z
z
z
z
z
z
a
a
"}
(9,1,1) = {"
a
a
a
a
a
a
a
a
a
z
z
z
z
z
r
P
P
r
z
z
z
z
I
P
P
r
r
r
r
P
P
h
z
z
z
z
z
a
a
a
"}
(10,1,1) = {"
a
a
a
a
a
a
a
a
a
z
z
z
z
z
z
r
Y
P
r
r
z
z
z
z
z
r
r
r
P
P
c
P
r
z
z
z
z
a
a
a
"}
(11,1,1) = {"
a
a
a
a
a
a
a
a
a
a
z
z
z
z
r
r
P
P
P
r
r
z
z
z
z
z
r
r
P
P
P
r
r
z
z
z
z
a
a
a
"}
(12,1,1) = {"
a
a
a
a
a
a
a
a
a
a
z
z
z
z
r
r
r
P
P
P
P
r
z
z
z
z
z
r
P
P
P
z
z
z
z
z
z
a
a
a
"}
(13,1,1) = {"
a
a
a
a
a
a
a
a
a
a
z
z
z
z
r
r
I
z
r
P
P
r
z
z
z
z
z
P
P
z
x
z
z
z
z
z
z
z
a
a
"}
(14,1,1) = {"
a
a
a
a
a
a
a
a
a
a
a
z
z
z
z
z
z
z
z
M
P
P
z
z
z
z
z
P
V
z
z
z
z
z
z
z
z
z
z
a
"}
(15,1,1) = {"
a
a
a
a
a
a
a
a
a
p
a
a
z
z
z
z
z
z
z
z
P
P
P
P
r
z
z
P
P
z
z
z
z
z
z
z
z
z
z
a
"}
(16,1,1) = {"
a
a
a
a
a
a
a
a
a
a
a
a
a
z
z
z
z
z
z
z
c
V
P
r
r
r
P
P
P
z
z
z
z
z
z
z
z
z
z
a
"}
(17,1,1) = {"
a
a
a
a
a
a
p
a
a
a
a
a
a
a
a
z
z
z
z
z
P
P
z
z
I
e
r
r
z
z
z
z
z
z
z
z
z
z
z
a
"}
(18,1,1) = {"
a
a
a
a
a
a
a
a
a
a
a
a
a
a
a
a
z
z
z
z
P
P
z
z
z
r
r
z
z
z
z
P
r
r
z
z
z
z
a
a
"}
(19,1,1) = {"
a
a
a
a
a
a
a
a
a
a
a
a
a
a
z
z
z
z
z
z
P
P
z
z
z
r
P
P
z
z
z
P
P
r
I
z
z
z
a
a
"}
(20,1,1) = {"
a
a
a
a
a
a
a
a
a
a
a
a
a
a
z
z
z
z
z
D
P
P
J
z
z
P
P
P
P
z
P
P
P
P
r
z
z
a
a
a
"}
(21,1,1) = {"
a
a
a
a
a
a
a
a
a
a
a
a
a
z
z
z
z
z
z
P
P
P
z
z
z
z
P
c
P
P
P
P
P
P
z
z
z
a
a
a
"}
(22,1,1) = {"
a
a
a
a
a
a
a
a
a
a
a
a
z
z
z
z
z
z
z
P
P
P
z
z
z
z
P
P
V
P
P
P
P
P
z
z
z
z
z
a
"}
(23,1,1) = {"
a
a
a
a
a
a
a
a
a
a
a
z
z
z
z
z
z
z
z
P
P
P
z
z
z
z
P
P
P
P
r
z
z
z
z
z
z
z
a
a
"}
(24,1,1) = {"
a
a
a
a
a
a
a
a
a
z
z
z
z
z
z
z
z
z
z
P
P
P
z
z
z
z
P
P
P
P
z
z
z
z
z
z
z
P
a
a
"}
(25,1,1) = {"
a
a
a
a
a
a
a
a
z
z
z
z
z
z
z
z
z
z
z
P
P
P
z
z
z
z
z
z
P
P
P
P
r
z
z
z
P
P
P
a
"}
(26,1,1) = {"
a
a
a
a
a
a
a
z
z
z
z
z
z
z
z
D
P
P
P
P
c
P
o
z
z
z
z
z
P
P
P
P
P
P
V
P
P
P
P
a
"}
(27,1,1) = {"
a
a
a
a
a
a
z
z
z
z
z
z
z
o
P
P
H
u
H
P
V
P
P
z
z
z
z
P
P
P
P
P
P
P
P
P
P
P
z
a
"}
(28,1,1) = {"
a
a
a
a
a
a
z
z
z
z
z
z
z
P
X
H
H
g
H
H
H
P
P
z
z
z
P
P
P
P
P
c
P
P
P
P
z
z
z
a
"}
(29,1,1) = {"
a
a
a
a
a
a
z
z
z
z
z
z
z
k
t
H
H
g
H
H
H
H
P
z
z
I
r
P
P
P
P
P
P
P
P
I
z
z
z
a
"}
(30,1,1) = {"
a
a
a
a
a
a
z
z
z
z
z
z
z
k
d
H
H
q
H
H
H
H
z
z
z
z
P
P
P
P
P
P
P
P
r
z
z
z
a
a
"}
(31,1,1) = {"
a
a
a
a
a
a
z
z
z
z
z
z
z
k
k
k
H
H
H
H
P
P
z
z
z
z
z
z
P
P
P
V
P
P
z
z
z
a
a
a
"}
(32,1,1) = {"
a
a
a
a
a
a
a
z
z
z
z
z
z
z
P
P
H
H
H
P
P
z
z
z
z
z
z
z
z
P
P
P
P
z
z
z
a
a
a
a
"}
(33,1,1) = {"
a
a
a
a
a
a
a
z
z
z
z
z
z
z
z
P
z
M
o
z
z
z
z
z
z
z
z
z
z
z
P
P
z
z
z
z
a
a
a
a
"}
(34,1,1) = {"
a
a
a
a
a
a
a
a
z
z
z
z
z
z
z
z
z
z
z
z
z
z
z
z
z
z
z
z
z
z
z
z
z
z
z
a
a
a
a
a
"}
(35,1,1) = {"
a
a
a
a
a
a
a
a
z
z
z
z
z
z
z
z
z
z
z
z
z
z
z
z
z
z
z
z
z
z
z
z
z
z
z
a
a
a
a
a
"}
(36,1,1) = {"
a
a
a
a
a
a
a
z
z
z
z
z
a
a
z
z
z
z
z
z
z
z
z
z
z
z
a
z
z
z
z
z
z
z
a
a
a
a
a
a
"}
(37,1,1) = {"
a
a
a
a
a
a
a
z
z
z
z
a
a
a
a
a
z
z
z
z
z
z
z
z
a
a
a
a
a
a
z
z
a
a
a
a
a
a
a
a
"}
(38,1,1) = {"
a
a
a
a
a
a
a
a
a
a
a
a
a
a
a
a
a
a
z
z
z
z
z
a
a
a
a
a
a
a
a
a
a
a
a
a
a
a
a
a
"}
(39,1,1) = {"
a
a
a
a
a
a
a
a
a
a
a
a
a
a
a
a
a
a
a
a
z
z
a
a
a
a
a
a
a
a
a
a
a
a
a
a
a
a
a
a
"}
(40,1,1) = {"
a
a
a
a
a
a
a
a
a
a
a
a
a
a
a
a
a
a
a
a
a
a
a
a
a
a
a
a
a
a
a
a
a
a
a
a
a
a
a
a
"}
