//MAP CONVERTED BY dmm2tgm.py THIS HEADER COMMENT PREVENTS RECONVERSION, DO NOT REMOVE
"aa" = (
/turf/template_noop,
/area/template_noop)
"ab" = (
/turf/simulated/floor/outdoors/rocks,
/area/template_noop)
"ac" = (
/turf/simulated/wall/log_sif,
/area/submap/Chapel1)
"ad" = (
/obj/structure/lightpost,
/turf/simulated/floor/outdoors/grass/sif/forest,
/area/submap/Chapel1)
"ae" = (
/obj/structure/closet/hydrant{
	pixel_y = 32
	},
/obj/item/book/tome,
/obj/item/telecube,
/turf/simulated/floor/wood/sif,
/area/submap/Chapel1)
"af" = (
/obj/item/flame/candle/everburn,
/turf/simulated/floor/outdoors/rocks,
/area/template_noop)
"ag" = (
/obj/structure/bookcase,
/turf/simulated/floor/wood/sif,
/area/submap/Chapel1)
"ah" = (
/turf/simulated/floor/outdoors/grass/sif,
/area/template_noop)
"ai" = (
/turf/simulated/floor/outdoors/grass/sif/forest,
/area/template_noop)
"aj" = (
/turf/simulated/floor/outdoors/dirt,
/area/template_noop)
"ak" = (
/obj/structure/closet/grave,
/obj/random/mob/spider{
	mob_faction = "neutral"
	},
/turf/simulated/floor/outdoors/rocks,
/area/template_noop)
"al" = (
/turf/simulated/floor/wood/sif,
/area/submap/Chapel1)
"am" = (
/obj/structure/loot_pile/maint/boxfort,
/turf/simulated/floor/wood/sif,
/area/submap/Chapel1)
"an" = (
/obj/item/material/knife/ritual,
/turf/simulated/floor/wood/sif,
/area/submap/Chapel1)
"ao" = (
/obj/structure/closet/grave,
/turf/simulated/floor/outdoors/dirt,
/area/template_noop)
"ap" = (
/obj/structure/loot_pile/surface/bones,
/obj/item/coin/diamond,
/obj/item/clothing/under/technomancer/master,
/turf/simulated/floor/wood/sif,
/area/submap/Chapel1)
"aq" = (
/obj/structure/closet/grave,
/turf/simulated/floor/outdoors/grass/sif/forest,
/area/template_noop)
"ar" = (
/obj/random/mob/spider/nurse{
	mob_faction = "neutral"
	},
/obj/structure/closet/grave,
/turf/simulated/floor/outdoors/dirt,
/area/template_noop)
"as" = (
/obj/item/scepter,
/turf/simulated/floor/wood/sif,
/area/submap/Chapel1)
"at" = (
/obj/structure/loot_pile/maint/trash,
/turf/simulated/floor/wood/sif,
/area/submap/Chapel1)
"au" = (
/obj/structure/table/sifwoodentable,
/obj/item/godfig,
/turf/simulated/floor/wood/sif/broken,
/area/submap/Chapel1)
"av" = (
/obj/structure/table/sifwoodentable,
/turf/simulated/floor/wood/sif,
/area/submap/Chapel1)
"aw" = (
/obj/structure/table/sifwoodentable,
/obj/item/flame/candle/candelabra/everburn,
/turf/simulated/floor/wood/sif,
/area/submap/Chapel1)
"ax" = (
/obj/structure/closet/crate/trashcart{
	starts_with = list(/obj/item/stock_parts/capacitor/omni = 5, /obj/item/stock_parts/manipulator/omni = 5, /obj/item/stock_parts/matter_bin/omni = 5, /obj/item/stock_parts/micro_laser/omni = 5, /obj/item/stock_parts/scanning_module/omni = 5)
	},
/turf/simulated/floor/wood/sif,
/area/submap/Chapel1)
"ay" = (
/obj/machinery/washing_machine,
/turf/simulated/floor/wood/sif,
/area/submap/Chapel1)
"az" = (
/obj/machinery/vending/event/uniform{
	desc = "A vendor using compressed matter cartridges to store large amounts of clothing.";
	name = "Morgue Wear";
	product_ads = "...";
	products = list(/obj/item/clothing/under/color/black = 50, /obj/item/clothing/under/gentlesuit = 50, /obj/item/clothing/under/color/blackjumpskirt = 50, /obj/item/clothing/under/gentlesuit/skirt = 50, /obj/item/clothing/shoes/black = 100, /obj/item/clothing/shoes/dress = 100)
	},
/turf/simulated/floor/wood/sif/broken,
/area/submap/Chapel1)
"aA" = (
/obj/random/junk,
/turf/simulated/floor/wood/sif,
/area/submap/Chapel1)
"aB" = (
/obj/machinery/vending/hydroseeds{
	dir = 4
	},
/turf/simulated/floor/wood/sif,
/area/submap/Chapel1)
"aC" = (
/turf/simulated/floor/wood/sif/broken,
/area/submap/Chapel1)
"aD" = (
/obj/structure/cable/cyan{
	icon_state = "0-8"
	},
/obj/machinery/power/rtg/advanced{
	component_parts = list(/obj/item/stack/cable_coil = 5, /obj/item/stock_parts/capacitor/omni = 1, /obj/item/stock_parts/micro_laser/omni = 1, /obj/item/stack/material/uranium = 10, /obj/item/stack/material/phoron = 5)
	},
/obj/effect/floor_decal/industrial/warning/dust{
	dir = 9
	},
/turf/simulated/floor/wood/sif,
/area/submap/Chapel1)
"aE" = (
/obj/structure/closet/coffin,
/obj/random/maintenance/clean,
/obj/effect/decal/remains/human,
/turf/simulated/floor/wood/sif,
/area/submap/Chapel1)
"aF" = (
/obj/structure/table/bench/sifwooden/padded,
/turf/simulated/floor/wood/sif,
/area/submap/Chapel1)
"aG" = (
/obj/structure/table/sifwoodentable,
/turf/simulated/floor/wood/sif/broken,
/area/submap/Chapel1)
"aH" = (
/obj/structure/table/bench/sifwooden/padded,
/turf/simulated/floor/wood/sif/broken,
/area/submap/Chapel1)
"aI" = (
/obj/structure/ghost_pod/automatic/gravekeeper_drone,
/obj/effect/floor_decal/industrial/warning/dust,
/obj/item/gps/internal/poi{
	desc = "A safe haven in a harsh place.";
	gps_tag = "Wilderness Chapel Signal"
	},
/turf/simulated/floor/wood/sif,
/area/submap/Chapel1)
"aJ" = (
/obj/structure/closet/coffin,
/obj/random/medical,
/obj/effect/decal/remains/human,
/turf/simulated/floor/wood/sif,
/area/submap/Chapel1)
"aK" = (
/obj/structure/closet/coffin,
/obj/random/meat,
/obj/random/meat,
/obj/effect/decal/remains/xeno,
/turf/simulated/floor/wood/sif,
/area/submap/Chapel1)
"aL" = (
/obj/structure/table/sifwoodentable,
/obj/item/flame/candle/everburn,
/turf/simulated/floor/wood/sif,
/area/submap/Chapel1)
"aM" = (
/obj/random/trash,
/turf/simulated/floor/wood/sif,
/area/submap/Chapel1)
"aN" = (
/obj/structure/table/sifwoodentable,
/obj/random/multiple/gun/projectile/handgun,
/obj/structure/safe/floor,
/obj/random/medical/pillbottle,
/obj/random/cash,
/obj/random/drinkbottle,
/turf/simulated/floor/wood/sif,
/area/submap/Chapel1)
"aO" = (
/obj/structure/table/sifwoodentable,
/obj/machinery/recharger,
/turf/simulated/floor/wood/sif,
/area/submap/Chapel1)
"aP" = (
/obj/structure/closet/coffin,
/obj/random/maintenance/clean,
/obj/effect/decal/remains/deer,
/turf/simulated/floor/wood/sif,
/area/submap/Chapel1)
"aQ" = (
/obj/random/junk,
/turf/simulated/floor/wood/sif/broken,
/area/submap/Chapel1)
"aR" = (
/obj/random/mouseremains,
/turf/simulated/floor/wood/sif,
/area/submap/Chapel1)
"aS" = (
/obj/structure/table/sifwoodentable,
/obj/machinery/cell_charger,
/turf/simulated/floor/wood/sif,
/area/submap/Chapel1)
"aT" = (
/obj/structure/closet/coffin,
/obj/random/drinkbottle,
/obj/item/ectoplasm,
/obj/effect/decal/remains/human,
/turf/simulated/floor/wood/sif,
/area/submap/Chapel1)
"aU" = (
/obj/structure/closet/coffin,
/obj/random/junk,
/obj/effect/decal/remains/human,
/turf/simulated/floor/wood/sif/broken,
/area/submap/Chapel1)
"aV" = (
/obj/item/flame/candle/candelabra,
/obj/structure/table/sifwoodentable,
/turf/simulated/floor/wood/sif/broken,
/area/submap/Chapel1)
"aW" = (
/obj/structure/table/sifwoodentable,
/obj/item/flame/candle/candelabra,
/turf/simulated/floor/wood/sif,
/area/submap/Chapel1)
"aX" = (
/obj/structure/table/sifwoodentable,
/obj/item/glass_jar,
/turf/simulated/floor/wood/sif,
/area/submap/Chapel1)
"aY" = (
/obj/structure/closet/coffin,
/obj/random/maintenance/cargo,
/obj/effect/decal/remains/human,
/obj/random/projectile/scrapped_gun,
/turf/simulated/floor/wood/sif,
/area/submap/Chapel1)
"aZ" = (
/obj/structure/simple_door/sifwood,
/turf/simulated/floor/wood/sif,
/area/submap/Chapel1)
"ba" = (
/obj/structure/bed/padded,
/turf/simulated/floor/wood/sif,
/area/submap/Chapel1)
"bb" = (
/obj/structure/closet/coffin,
/obj/random/cash,
/obj/effect/decal/remains/xeno,
/turf/simulated/floor/wood/sif,
/area/submap/Chapel1)
"bc" = (
/obj/item/flame/candle/candelabra,
/obj/structure/table/sifwoodentable,
/turf/simulated/floor/wood/sif,
/area/submap/Chapel1)
"bd" = (
/obj/structure/table/sifwoodentable,
/obj/structure/bedsheetbin,
/turf/simulated/floor/wood/sif,
/area/submap/Chapel1)
"be" = (
/obj/structure/closet/coffin,
/obj/random/maintenance/clean,
/obj/effect/decal/remains/ribcage,
/turf/simulated/floor/wood/sif,
/area/submap/Chapel1)
"bf" = (
/obj/structure/closet/coffin,
/obj/effect/decal/remains/mouse,
/obj/effect/decal/remains/unathi,
/turf/simulated/floor/wood/sif,
/area/submap/Chapel1)
"bg" = (
/obj/random/trash,
/turf/simulated/floor/wood/sif/broken,
/area/submap/Chapel1)
"bh" = (
/obj/structure/table/sifwoodentable,
/obj/fiftyspawner/sifwood,
/obj/fiftyspawner/sifwood,
/obj/fiftyspawner/glass,
/obj/fiftyspawner/steel,
/turf/simulated/floor/wood/sif,
/area/submap/Chapel1)
"bi" = (
/obj/structure/closet/coffin,
/obj/random/cash,
/obj/effect/decal/remains/ribcage,
/turf/simulated/floor/wood/sif,
/area/submap/Chapel1)
"bj" = (
/obj/structure/table/sifwoodentable,
/obj/random/toolbox,
/obj/item/flame/candle/everburn,
/turf/simulated/floor/wood/sif,
/area/submap/Chapel1)
"bk" = (
/obj/structure/table/sifwoodentable,
/obj/item/chainsaw,
/obj/random/tool/powermaint,
/turf/simulated/floor/wood/sif,
/area/submap/Chapel1)
"bl" = (
/obj/machinery/portable_atmospherics/hydroponics/soil,
/turf/simulated/floor/outdoors/grass/sif,
/area/template_noop)
"bm" = (
/obj/machinery/portable_atmospherics/hydroponics/soil,
/turf/simulated/floor/outdoors/grass/sif/forest,
/area/template_noop)
"bn" = (
/obj/structure/sink/puddle,
/turf/simulated/floor/outdoors/grass/sif/forest,
/area/template_noop)
"bo" = (
/obj/item/flame/candle/everburn,
/turf/simulated/floor/outdoors/dirt,
/area/template_noop)
"bp" = (
/obj/machinery/portable_atmospherics/hydroponics/soil,
/turf/simulated/floor/outdoors/rocks,
/area/template_noop)
"bq" = (
/obj/machinery/vending/food{
	dir = 8
	},
/turf/simulated/floor/wood/sif,
/area/submap/Chapel1)
"br" = (
/obj/structure/loot_pile/maint/technical,
/turf/simulated/floor/wood/sif,
/area/submap/Chapel1)
"bs" = (
/obj/item/ore,
/obj/item/ore,
/obj/item/ore,
/obj/item/ore,
/obj/item/ore/gold,
/obj/item/ore/diamond,
/obj/item/ore/silver,
/obj/item/ore/uranium,
/obj/item/ore,
/obj/item/ore,
/obj/item/ore,
/obj/item/ore/coal,
/obj/item/ore/coal,
/obj/item/ore/coal,
/obj/item/pickaxe/hand,
/obj/structure/table/sifwoodentable,
/turf/simulated/floor/wood/sif,
/area/submap/Chapel1)
"bt" = (
/obj/machinery/vending/sovietsoda{
	dir = 8
	},
/turf/simulated/floor/wood/sif,
/area/submap/Chapel1)
"bu" = (
/obj/machinery/autolathe,
/turf/simulated/floor/wood/sif,
/area/submap/Chapel1)
"bv" = (
/obj/random/obstruction,
/turf/simulated/floor/outdoors/rocks,
/area/template_noop)
"bw" = (
/obj/structure/closet/coffin,
/obj/random/maintenance/cargo,
/obj/item/ectoplasm,
/obj/effect/decal/remains/xeno,
/turf/simulated/floor/wood/sif,
/area/submap/Chapel1)
"bx" = (
/obj/structure/closet/coffin,
/obj/random/junk,
/obj/effect/decal/remains/tajaran,
/turf/simulated/floor/wood/sif,
/area/submap/Chapel1)
"by" = (
/obj/structure/closet/coffin,
/obj/random/junk,
/obj/effect/decal/remains/human,
/turf/simulated/floor/wood/sif,
/area/submap/Chapel1)
"bz" = (
/obj/structure/closet/coffin,
/obj/random/maintenance/clean,
/obj/effect/decal/remains/xeno,
/turf/simulated/floor/wood/sif/broken,
/area/submap/Chapel1)
"bA" = (
/obj/structure/closet/coffin,
/obj/random/cash,
/obj/effect/decal/remains/human,
/turf/simulated/floor/wood/sif,
/area/submap/Chapel1)
"bB" = (
/obj/structure/cable/cyan{
	icon_state = "0-4"
	},
/obj/machinery/power/port_gen/pacman{
	anchored = 1
	},
/obj/effect/floor_decal/industrial/warning/dust{
	dir = 1
	},
/turf/simulated/floor/wood/sif,
/area/submap/Chapel1)
"bC" = (
/obj/structure/cable/cyan{
	icon_state = "4-8"
	},
/obj/effect/floor_decal/industrial/warning/dust{
	dir = 1
	},
/turf/simulated/floor/wood/sif,
/area/submap/Chapel1)
"cA" = (
/obj/random/mob/spider{
	mob_faction = "neutral"
	},
/turf/simulated/floor/outdoors/rocks,
/area/template_noop)
"cD" = (
/obj/machinery/space_heater,
/turf/simulated/floor/wood/sif,
/area/submap/Chapel1)
"cQ" = (
/obj/structure/cable/cyan{
	icon_state = "1-8"
	},
/obj/structure/cable/cyan{
	icon_state = "1-4"
	},
/turf/simulated/floor/wood/sif,
/area/submap/Chapel1)
"gk" = (
/obj/structure/fence/door,
/turf/simulated/floor/outdoors/grass/sif/forest,
/area/submap/Chapel1)
"ih" = (
/obj/machinery/vending/hydronutrients{
	dir = 4
	},
/turf/simulated/floor/wood/sif,
/area/submap/Chapel1)
"iB" = (
/obj/structure/sign/department/chapel,
/turf/simulated/wall/log_sif,
/area/submap/Chapel1)
"mK" = (
/obj/structure/sink{
	dir = 4;
	pixel_x = 11
	},
/obj/structure/mirror{
	pixel_x = 28
	},
/turf/simulated/floor/wood/sif,
/area/submap/Chapel1)
"nu" = (
/obj/structure/table/rack/shelf/steel,
/obj/fiftyspawner/phoron,
/obj/fiftyspawner/phoron,
/obj/item/storage/toolbox/syndicate/powertools,
/obj/item/stack/cable_coil/cyan,
/obj/item/stack/cable_coil/cyan,
/turf/simulated/floor/wood/sif,
/area/submap/Chapel1)
"om" = (
/obj/random/junk,
/obj/structure/table/sifwoodentable,
/obj/random/soap,
/turf/simulated/floor/wood/sif,
/area/submap/Chapel1)
"oO" = (
/obj/structure/table/sifwoodentable,
/obj/item/material/fishing_net,
/obj/item/material/harpoon,
/obj/item/material/harpoon,
/turf/simulated/floor/wood/sif,
/area/submap/Chapel1)
"pp" = (
/obj/structure/cable/cyan{
	icon_state = "1-2"
	},
/turf/simulated/wall/log_sif,
/area/submap/Chapel1)
"qO" = (
/obj/structure/cable/cyan{
	icon_state = "0-4"
	},
/obj/machinery/power/rtg/advanced{
	component_parts = list(/obj/item/stack/cable_coil = 5, /obj/item/stock_parts/capacitor/omni = 1, /obj/item/stock_parts/micro_laser/omni = 1, /obj/item/stack/material/uranium = 10, /obj/item/stack/material/phoron = 5)
	},
/obj/effect/floor_decal/industrial/warning/dust{
	dir = 5
	},
/obj/structure/cable/cyan{
	icon_state = "1-4"
	},
/turf/simulated/floor/wood/sif,
/area/submap/Chapel1)
"rm" = (
/obj/structure/cable/cyan{
	icon_state = "0-8"
	},
/obj/machinery/power/rtg/advanced{
	component_parts = list(/obj/item/stack/cable_coil = 5, /obj/item/stock_parts/capacitor/omni = 1, /obj/item/stock_parts/micro_laser/omni = 1, /obj/item/stack/material/uranium = 10, /obj/item/stack/material/phoron = 5)
	},
/obj/effect/floor_decal/industrial/warning/dust{
	dir = 10
	},
/turf/simulated/floor/wood/sif,
/area/submap/Chapel1)
"sH" = (
/obj/random/mob/spider{
	mob_faction = "neutral"
	},
/obj/structure/closet/grave,
/turf/simulated/floor/outdoors/rocks,
/area/template_noop)
"uK" = (
/obj/structure/closet/body_bag/large,
/turf/simulated/floor/wood/sif,
/area/submap/Chapel1)
"vU" = (
/obj/structure/sign/electricshock,
/turf/simulated/wall/log_sif,
/area/submap/Chapel1)
"yx" = (
/obj/machinery/floodlight{
	dir = 4
	},
/turf/simulated/floor/wood/sif,
/area/submap/Chapel1)
"CX" = (
/obj/vehicle/boat/dragon/sifwood,
/obj/item/oar/sifwood,
/turf/simulated/floor/wood/sif,
/area/submap/Chapel1)
"Dz" = (
/obj/structure/simple_door/sifwood,
/obj/machinery/power/terminal{
	dir = 4
	},
/obj/structure/cable/cyan{
	icon_state = "0-2"
	},
/obj/structure/cable/cyan{
	icon_state = "2-8"
	},
/obj/effect/floor_decal/industrial/warning/dust/corner{
	dir = 1
	},
/turf/simulated/floor/wood/sif,
/area/submap/Chapel1)
"Eq" = (
/obj/structure/cable/cyan{
	icon_state = "0-4"
	},
/obj/machinery/power/rtg/advanced{
	component_parts = list(/obj/item/stack/cable_coil = 5, /obj/item/stock_parts/capacitor/omni = 1, /obj/item/stock_parts/micro_laser/omni = 1, /obj/item/stack/material/uranium = 10, /obj/item/stack/material/phoron = 5)
	},
/obj/effect/floor_decal/industrial/warning/dust{
	dir = 6
	},
/turf/simulated/floor/wood/sif,
/area/submap/Chapel1)
"Gr" = (
/obj/structure/closet/grave,
/turf/simulated/floor/outdoors/rocks,
/area/template_noop)
"JO" = (
/obj/machinery/microwave,
/obj/structure/table/sifwoodentable,
/turf/simulated/floor/wood/sif,
/area/submap/Chapel1)
"Kb" = (
/obj/structure/table/sifwoodentable,
/obj/item/storage/firstaid,
/turf/simulated/floor/wood/sif,
/area/submap/Chapel1)
"Rf" = (
/obj/effect/floor_decal/industrial/warning/dust{
	dir = 10
	},
/obj/effect/floor_decal/industrial/warning/dust{
	dir = 5
	},
/obj/machinery/power/smes/buildable{
	charge = 2e+006;
	input_attempt = 1;
	input_level = 250000;
	input_level_max = 250000
	},
/obj/structure/cable/cyan{
	icon_state = "0-2"
	},
/turf/simulated/floor,
/area/submap/Chapel1)
"Tv" = (
/turf/simulated/floor/outdoors/grass/sif/forest,
/area/submap/Chapel1)
"TE" = (
/obj/structure/fence{
	dir = 4
	},
/turf/simulated/floor/outdoors/grass/sif/forest,
/area/submap/Chapel1)
"TH" = (
/obj/structure/cable/cyan{
	icon_state = "2-8"
	},
/obj/machinery/power/apc/hyper{
	dir = 1;
	pixel_y = 24;
	req_access = list(511)
	},
/obj/structure/cable/cyan{
	icon_state = "2-4"
	},
/obj/structure/cable/cyan,
/turf/simulated/floor/wood/sif/broken,
/area/submap/Chapel1)

(1,1,1) = {"
aa
aa
aa
aa
aa
aa
aa
ai
ai
aa
aa
aa
aa
aa
aa
aa
ai
ai
aa
aa
aa
aa
aa
aa
aa
aa
aa
aa
aa
aa
aa
"}
(2,1,1) = {"
aa
af
ab
aa
aa
aa
ai
ad
ac
ac
ac
ac
ac
ac
ac
ac
ac
ad
ai
aa
aa
aa
aa
ab
ab
aa
aa
aa
aa
ab
aa
"}
(3,1,1) = {"
aa
ab
aa
aa
aa
aa
ai
ac
ac
aJ
aP
aU
bb
bf
bw
by
ac
ac
ai
aa
aa
aa
ab
ab
aa
aa
aa
aa
aa
ab
ab
"}
(4,1,1) = {"
ab
ab
aa
aa
ab
aa
ac
ac
aE
aK
aT
aY
be
bi
bx
bz
bA
ac
ac
aa
aa
aa
aa
aj
aj
aj
aj
aj
aa
aa
aa
"}
(5,1,1) = {"
aa
aa
aa
sH
ac
ac
ac
ay
al
al
aQ
al
al
al
al
aM
al
JO
ac
bl
ah
ah
bo
aj
aj
aj
aj
aj
ai
ab
aa
"}
(6,1,1) = {"
aa
aa
aa
ab
ac
nu
ac
ay
aC
al
aR
aV
al
bc
mK
mK
aC
om
ac
ai
ai
aj
ao
aj
ao
aj
ar
aj
ao
ab
ab
"}
(7,1,1) = {"
aa
aa
aa
ab
ac
aZ
ac
az
uK
ac
ac
ac
aZ
ac
ac
ac
bq
bt
ac
bm
aj
aj
aj
aj
aj
aj
aj
aj
aj
aj
ab
"}
(8,1,1) = {"
aa
aa
aa
aa
gk
al
ac
ac
ac
ac
at
av
al
av
al
ac
ac
ac
ac
ai
aj
aj
ao
aj
ar
aj
ao
aj
ao
ai
ai
"}
(9,1,1) = {"
aa
aa
aa
ab
TE
ax
ac
ac
av
av
al
al
al
al
al
av
br
ac
ac
bm
ai
ab
aj
aj
aj
aj
aj
ai
ai
ai
ai
"}
(10,1,1) = {"
aa
aa
aa
Tv
TE
ac
ac
al
aF
aL
al
al
al
al
bg
bj
aF
al
ac
ac
ah
ah
ab
ab
ab
ai
ai
ai
ab
ai
ai
"}
(11,1,1) = {"
aa
ab
aa
ad
ac
ac
ag
al
aG
av
al
al
aA
al
al
av
av
al
al
ac
ac
ah
ai
ai
ai
ai
ai
ah
ab
ai
ai
"}
(12,1,1) = {"
ab
ab
aa
aa
ac
am
al
al
al
al
al
al
al
al
al
al
al
al
al
am
ac
bn
ah
ai
ai
ai
ah
ah
ab
ab
ai
"}
(13,1,1) = {"
ak
aa
aa
ac
ac
ag
al
al
aF
aM
aF
al
aF
al
aH
al
aF
al
aC
al
ac
ac
ai
ai
ai
ai
ai
ah
ah
ab
ai
"}
(14,1,1) = {"
ab
ab
aa
ac
ae
al
al
al
aF
al
aF
aC
aF
al
aF
al
aF
al
al
ag
ag
ac
ad
ab
bm
ai
bm
ai
bl
ab
ad
"}
(15,1,1) = {"
aa
ab
aa
ac
ag
an
au
al
aF
al
aF
al
aF
al
aF
al
aF
aM
al
al
al
aZ
bv
ab
ab
ai
ai
ai
ai
ab
ab
"}
(16,1,1) = {"
aa
ab
aa
ac
ag
ap
av
aA
al
al
al
al
al
al
al
al
al
al
aC
ag
ag
iB
ab
ab
ai
ai
ai
ai
ai
ai
ab
"}
(17,1,1) = {"
aa
ab
aa
ac
ag
as
aw
al
aF
al
aF
aC
aF
al
aF
al
aF
al
al
al
al
aZ
ab
ab
ai
ah
ai
ai
ai
ai
ai
"}
(18,1,1) = {"
aa
af
aa
ac
CX
al
al
al
aF
al
aF
al
aF
al
aF
al
aF
aA
al
ag
ag
ac
ad
ai
bm
ah
bm
ai
bp
ai
ad
"}
(19,1,1) = {"
aa
aa
aa
ac
ac
ag
al
al
aH
al
aF
al
aF
al
aF
aC
aF
al
aC
al
ac
ac
ai
ai
ah
ah
ai
ai
ab
ai
ai
"}
(20,1,1) = {"
aa
aa
aa
aa
ac
at
al
al
al
al
al
al
al
al
al
al
al
al
al
al
ac
bn
ai
ai
ah
ai
ai
ai
ab
ab
ai
"}
(21,1,1) = {"
aa
aa
aa
ad
ac
ac
ag
al
av
aN
al
aC
al
al
al
aG
av
al
al
ac
ac
ai
ai
ai
ai
ab
ab
ai
ab
ab
ai
"}
(22,1,1) = {"
aa
ab
aa
Tv
TE
ac
ac
al
aF
aL
aM
al
al
al
al
aL
aF
al
ac
ac
ai
ai
ai
ai
ab
ab
ai
ai
ai
ab
ai
"}
(23,1,1) = {"
aa
ab
aa
ab
TE
bB
ac
ac
Kb
av
al
al
aA
al
al
av
br
ac
ac
bm
ai
ai
ai
ab
ab
ai
ai
ai
ai
ab
ai
"}
(24,1,1) = {"
aa
ab
aa
aa
gk
bC
ac
ac
ac
ac
at
av
al
av
al
ac
ac
ac
ac
ai
ai
ah
aq
ab
aq
aj
aq
ai
aq
ab
ah
"}
(25,1,1) = {"
aa
ak
aa
ab
vU
Dz
pp
qO
Eq
ac
ac
ac
aZ
ac
ac
ac
aB
ih
ac
bm
ah
ah
aj
aj
aj
aj
aj
ai
ai
ah
ah
"}
(26,1,1) = {"
aa
ab
ab
ab
ac
Rf
pp
TH
cQ
al
yx
aW
al
aW
cD
aA
aC
al
ac
ah
aj
aj
ar
aj
ao
aj
ao
aj
ar
ah
ai
"}
(27,1,1) = {"
aa
aa
ab
Gr
ac
ac
ac
aD
rm
al
aA
al
al
al
al
aR
al
bu
ac
bm
aj
aj
aj
aj
aj
aj
bo
aj
aj
ah
aa
"}
(28,1,1) = {"
aa
aa
aa
aa
aa
ai
ac
ac
aI
aC
aC
al
al
aA
aC
oO
bs
ac
ac
ab
aa
aa
aa
aj
aj
aj
aj
aj
aa
aa
aa
"}
(29,1,1) = {"
aa
aa
aa
ab
aa
ai
ai
ac
ac
aO
aS
aX
ba
bd
bh
bk
ac
ac
ab
ab
aa
aa
aa
aa
aa
aa
aa
aa
aa
aa
aa
"}
(30,1,1) = {"
aa
aa
aa
af
ab
cA
ai
ad
ac
ac
ac
ac
ac
ac
ac
ac
ac
ad
ab
aa
aa
aa
aa
ab
ab
aa
aa
aa
aa
ab
ab
"}
(31,1,1) = {"
aa
aa
aa
aa
aa
aa
aa
ai
ai
aa
aa
aa
aa
aa
aa
ai
ai
ai
aa
aa
aa
aa
ab
ab
aa
aa
aa
aa
aa
ab
aa
"}
