//MAP CONVERTED BY dmm2tgm.py THIS HEADER COMMENT PREVENTS RECONVERSION, DO NOT REMOVE
"aj" = (
/obj/item/stool/padded,
/obj/item/clothing/suit/storage/fluff/techpriestrobes,
/turf/simulated/floor/wood/sif{
	oxygen = 0
	},
/area/submap/DeathDen)
"as" = (
/obj/structure/table/bench/wooden,
/obj/effect/floor_decal/carpet{
	dir = 1
	},
/turf/simulated/floor/wood/sif{
	oxygen = 0
	},
/area/submap/DeathDen)
"av" = (
/obj/structure/table/fancyblack,
/obj/item/deadringer,
/obj/item/reagent_containers/food/snacks/bearstew,
/obj/effect/floor_decal/carpet,
/obj/effect/floor_decal/carpet{
	dir = 4
	},
/obj/effect/floor_decal/carpet{
	dir = 6
	},
/turf/simulated/floor/wood/sif{
	oxygen = 0
	},
/area/submap/DeathDen)
"bK" = (
/obj/effect/decal/cleanable/dirt,
/turf/simulated/wall/sifwood,
/area/submap/DeathDen)
"cQ" = (
/mob/living/simple_mob/vore/aggressive/deathclaw{
	health = 100;
	maxHealth = 100;
	melee_damage_upper = 15;
	name = "young deathclaw"
	},
/turf/simulated/floor/wood/sif,
/area/submap/DeathDen)
"dx" = (
/obj/item/ammo_magazine/ammo_box/b12g/pellet,
/obj/item/ammo_magazine/ammo_box/b12g/pellet,
/turf/simulated/floor/wood/sif{
	oxygen = 0
	},
/area/submap/DeathDen)
"ex" = (
/obj/item/reagent_containers/food/snacks/candy_corn{
	pixel_x = 6;
	pixel_y = 4
	},
/obj/effect/decal/cleanable/dirt,
/turf/simulated/floor/wood/sif,
/area/submap/DeathDen)
"gG" = (
/obj/structure/bed/chair/wood{
	dir = 1
	},
/turf/simulated/floor/wood/sif,
/area/submap/DeathDen)
"he" = (
/obj/effect/gibspawner/human,
/turf/simulated/floor/wood/sif{
	oxygen = 0
	},
/area/submap/DeathDen)
"hq" = (
/obj/structure/window/plastitanium/full,
/obj/structure/grille/rustic,
/turf/simulated/floor/tiled/asteroid_steel,
/area/submap/DeathDen)
"hz" = (
/obj/effect/decal/cleanable/dirt,
/obj/effect/gibspawner/human,
/turf/simulated/floor/wood/sif,
/area/submap/DeathDen)
"hJ" = (
/mob/living/simple_mob/humanoid/clown,
/obj/effect/gibspawner/human,
/turf/simulated/floor/tiled/freezer,
/area/submap/DeathDen)
"hL" = (
/obj/structure/table/wooden_reinforced,
/obj/item/shreddedp,
/turf/simulated/floor/wood/sif/broken,
/area/submap/DeathDen)
"ii" = (
/obj/structure/table/wooden_reinforced,
/obj/item/pizzabox/meat,
/obj/random/junk,
/obj/effect/decal/cleanable/dirt,
/turf/simulated/floor/wood/sif,
/area/submap/DeathDen)
"im" = (
/obj/random/trash,
/turf/simulated/floor/wood/sif/broken,
/area/submap/DeathDen)
"ix" = (
/obj/effect/gibspawner/human,
/obj/random/junk,
/obj/effect/decal/cleanable/dirt,
/turf/simulated/floor/wood/sif,
/area/submap/DeathDen)
"jM" = (
/obj/structure/table/bench/wooden,
/obj/effect/floor_decal/carpet,
/obj/effect/floor_decal/carpet{
	dir = 8
	},
/obj/effect/floor_decal/carpet{
	dir = 10
	},
/turf/simulated/floor/wood/sif{
	oxygen = 0
	},
/area/submap/DeathDen)
"jW" = (
/obj/effect/floor_decal/carpet{
	dir = 1
	},
/turf/simulated/floor/wood/sif{
	oxygen = 0
	},
/area/submap/DeathDen)
"lx" = (
/obj/structure/sink{
	dir = 8;
	pixel_x = -12;
	pixel_y = 2
	},
/turf/simulated/floor/tiled/freezer,
/area/submap/DeathDen)
"mC" = (
/obj/structure/table/fancyblack,
/obj/item/flame/candle/candelabra/everburn{
	pixel_y = 10
	},
/obj/effect/floor_decal/carpet{
	dir = 1
	},
/obj/effect/floor_decal/carpet{
	dir = 4
	},
/obj/effect/floor_decal/carpet{
	dir = 5
	},
/obj/item/storage/bible,
/turf/simulated/floor/wood/sif{
	oxygen = 0
	},
/area/submap/DeathDen)
"mR" = (
/obj/effect/decal/cleanable/dirt,
/obj/item/reagent_containers/food/snacks/candy_corn{
	pixel_x = 6;
	pixel_y = 4
	},
/obj/effect/map_helper/no_phaseshift/area,
/turf/simulated/floor/wood/sif,
/area/submap/DeathDen)
"nl" = (
/obj/effect/decal/cleanable/dirt,
/turf/simulated/floor/wood/sif/broken,
/area/submap/DeathDen)
"no" = (
/obj/structure/table/bench/wooden,
/obj/effect/floor_decal/carpet{
	dir = 1
	},
/obj/effect/floor_decal/carpet{
	dir = 8
	},
/obj/effect/floor_decal/carpet{
	dir = 9
	},
/obj/effect/decal/cleanable/dirt,
/turf/simulated/floor/wood/sif{
	oxygen = 0
	},
/area/submap/DeathDen)
"nG" = (
/obj/structure/windoor_assembly,
/obj/random/trash,
/turf/simulated/floor/tiled/freezer,
/area/submap/DeathDen)
"pz" = (
/obj/item/reagent_containers/food/snacks/candy_corn{
	pixel_x = 6;
	pixel_y = 4
	},
/turf/simulated/floor/wood/sif{
	oxygen = 0
	},
/area/submap/DeathDen)
"pE" = (
/obj/effect/decal/cleanable/dirt,
/obj/random/maintenance/engineering,
/turf/simulated/floor/wood/sif,
/area/submap/DeathDen)
"pQ" = (
/obj/random/maintenance/medical,
/turf/simulated/floor/wood/sif,
/area/submap/DeathDen)
"rn" = (
/obj/structure/simple_door/sifwood,
/turf/simulated/floor/wood/sif,
/area/submap/DeathDen)
"rO" = (
/obj/effect/decal/cleanable/dirt,
/turf/simulated/floor/outdoors/dirt{
	outdoors = 0
	},
/area/template_noop)
"si" = (
/turf/simulated/floor/outdoors/dirt,
/area/template_noop)
"td" = (
/obj/structure/gravemarker,
/obj/structure/closet/grave{
	opened = 0
	},
/obj/random/humanoidremains,
/obj/item/clothing/suit/cultrobes/alt{
	pixel_x = 4;
	pixel_y = 3
	},
/obj/item/gun/projectile/shotgun/pump/rifle/ceremonial,
/turf/template_noop,
/area/template_noop)
"ua" = (
/obj/effect/decal/cleanable/dirt,
/obj/structure/table/wooden_reinforced,
/obj/item/flame/candle/everburn,
/turf/simulated/floor/wood/sif,
/area/submap/DeathDen)
"uy" = (
/obj/structure/bed/chair/wood{
	dir = 8
	},
/mob/living/simple_mob/vore/aggressive/deathclaw{
	health = 100;
	maxHealth = 100;
	melee_damage_upper = 15;
	name = "young deathclaw"
	},
/turf/simulated/floor/wood/sif,
/area/submap/DeathDen)
"uL" = (
/obj/item/material/shard/plastitaniumglass{
	pixel_x = -5;
	pixel_y = -6
	},
/obj/item/material/shard/plastitaniumglass{
	pixel_x = 7;
	pixel_y = 8
	},
/obj/random/maintenance/engineering,
/obj/random/junk,
/obj/structure/bed/chair/wood,
/turf/simulated/floor/wood/sif,
/area/submap/DeathDen)
"wa" = (
/obj/effect/floor_decal/carpet{
	dir = 1
	},
/obj/effect/decal/cleanable/dirt,
/turf/simulated/floor/wood/sif{
	oxygen = 0
	},
/area/submap/DeathDen)
"xh" = (
/mob/living/simple_mob/vore/aggressive/deathclaw{
	health = 100;
	maxHealth = 100;
	melee_damage_upper = 15;
	name = "young deathclaw"
	},
/obj/effect/decal/cleanable/dirt,
/turf/simulated/floor/outdoors/dirt{
	outdoors = 0
	},
/area/template_noop)
"xw" = (
/obj/structure/table/wooden_reinforced,
/obj/item/shreddedp,
/turf/simulated/floor/wood/sif,
/area/submap/DeathDen)
"xF" = (
/obj/structure/window/reinforced/tinted/frosted{
	dir = 1
	},
/obj/structure/table/wooden_reinforced,
/obj/random/soap,
/obj/item/flame/candle/everburn,
/turf/simulated/floor/tiled/freezer,
/area/submap/DeathDen)
"yA" = (
/obj/item/reagent_containers/food/snacks/candy_corn,
/obj/item/reagent_containers/food/snacks/candy_corn{
	pixel_y = 6
	},
/obj/effect/floor_decal/carpet,
/obj/effect/gibspawner/human,
/obj/effect/decal/cleanable/dirt,
/turf/simulated/floor/wood/sif{
	oxygen = 0
	},
/area/submap/DeathDen)
"zd" = (
/turf/simulated/floor/wood/sif,
/area/submap/DeathDen)
"zS" = (
/obj/random/soap,
/obj/effect/decal/cleanable/dirt,
/turf/simulated/floor/tiled/freezer,
/area/submap/DeathDen)
"Ay" = (
/obj/structure/table/wooden_reinforced,
/obj/item/clothing/suit/cultrobes/alt,
/obj/item/clothing/suit/cultrobes/alt{
	pixel_x = 4;
	pixel_y = 3
	},
/turf/simulated/floor/wood/sif,
/area/submap/DeathDen)
"AQ" = (
/obj/item/reagent_containers/food/snacks/candy_corn{
	pixel_x = -6;
	pixel_y = 6
	},
/turf/simulated/floor/wood/sif{
	oxygen = 0
	},
/area/submap/DeathDen)
"AS" = (
/obj/item/reagent_containers/food/snacks/candy_corn,
/turf/simulated/floor/wood/sif{
	oxygen = 0
	},
/area/submap/DeathDen)
"Bx" = (
/obj/effect/decal/cleanable/dirt,
/obj/random/trash,
/turf/simulated/floor/wood/sif/broken,
/area/submap/DeathDen)
"Cp" = (
/obj/random/trash,
/obj/effect/decal/cleanable/dirt,
/turf/simulated/floor/wood/sif,
/area/submap/DeathDen)
"Ct" = (
/turf/simulated/mineral/ignore_mapgen,
/area/template_noop)
"Cv" = (
/obj/structure/table/bench/wooden,
/obj/effect/floor_decal/carpet,
/obj/random/maintenance/engineering,
/obj/random/junk,
/obj/effect/decal/cleanable/dirt,
/turf/simulated/floor/wood/sif{
	oxygen = 0
	},
/area/submap/DeathDen)
"CJ" = (
/obj/random/junk,
/obj/effect/decal/cleanable/dirt,
/obj/random/maintenance/engineering,
/turf/simulated/floor/wood/sif,
/area/submap/DeathDen)
"CZ" = (
/turf/simulated/floor/tiled/freezer,
/area/submap/DeathDen)
"Dt" = (
/obj/structure/grille/broken/rustic,
/turf/simulated/floor/wood/sif{
	oxygen = 0
	},
/area/submap/DeathDen)
"EJ" = (
/turf/simulated/floor/wood/sif{
	oxygen = 0
	},
/area/submap/DeathDen)
"Fe" = (
/obj/item/reagent_containers/food/snacks/candy_corn{
	pixel_x = 6;
	pixel_y = 4
	},
/obj/effect/floor_decal/carpet{
	dir = 8
	},
/obj/random/maintenance/engineering,
/obj/effect/decal/cleanable/dirt,
/turf/simulated/floor/wood/sif{
	oxygen = 0
	},
/area/submap/DeathDen)
"FN" = (
/obj/effect/decal/cleanable/dirt,
/turf/simulated/floor/outdoors/dirt,
/area/template_noop)
"Gc" = (
/obj/structure/table/bench/wooden,
/obj/effect/decal/cleanable/dirt,
/turf/simulated/floor/wood/sif{
	oxygen = 0
	},
/area/submap/DeathDen)
"Gr" = (
/obj/item/clothing/head/psy_crown/gluttony,
/obj/random/junk,
/turf/simulated/floor/wood/sif{
	oxygen = 0
	},
/area/submap/DeathDen)
"GT" = (
/obj/effect/decal/cleanable/dirt,
/obj/item/reagent_containers/food/snacks/candy_corn{
	pixel_x = 6;
	pixel_y = 4
	},
/turf/simulated/floor/wood/sif/broken,
/area/submap/DeathDen)
"GU" = (
/obj/random/maintenance/cargo,
/obj/effect/decal/cleanable/dirt,
/turf/simulated/floor/wood/sif,
/area/submap/DeathDen)
"Is" = (
/turf/template_noop,
/area/template_noop)
"Iw" = (
/obj/structure/bed/chair/wood{
	dir = 4
	},
/obj/effect/decal/cleanable/dirt,
/turf/simulated/floor/wood/sif,
/area/submap/DeathDen)
"IE" = (
/obj/effect/floor_decal/carpet,
/obj/random/maintenance/engineering,
/turf/simulated/floor/wood/sif{
	oxygen = 0
	},
/area/submap/DeathDen)
"JE" = (
/obj/random/trash,
/obj/effect/decal/cleanable/dirt,
/obj/item/reagent_containers/food/snacks/candy_corn{
	pixel_x = 6;
	pixel_y = 4
	},
/obj/item/reagent_containers/food/snacks/candy_corn{
	pixel_x = 6;
	pixel_y = 4
	},
/turf/simulated/floor/wood/sif,
/area/submap/DeathDen)
"Kg" = (
/obj/item/reagent_containers/food/snacks/candy_corn{
	pixel_x = 6;
	pixel_y = 4
	},
/obj/random/trash,
/obj/effect/decal/cleanable/dirt,
/turf/simulated/floor/wood/sif{
	oxygen = 0
	},
/area/submap/DeathDen)
"KP" = (
/turf/simulated/floor/outdoors/dirt{
	outdoors = 0
	},
/area/template_noop)
"KS" = (
/obj/structure/table/fancyblack,
/obj/effect/floor_decal/carpet{
	dir = 4
	},
/obj/item/scrying,
/turf/simulated/floor/wood/sif{
	oxygen = 0
	},
/area/submap/DeathDen)
"Lb" = (
/obj/structure/table/wooden_reinforced,
/obj/item/clothing/suit/cultrobes/alt,
/obj/item/clothing/suit/cultrobes/alt{
	pixel_x = 4;
	pixel_y = 3
	},
/obj/item/flame/candle/everburn,
/turf/simulated/floor/wood/sif/broken,
/area/submap/DeathDen)
"Mn" = (
/obj/structure/urinal{
	pixel_y = 32
	},
/obj/structure/window/reinforced/tinted/frosted{
	dir = 8
	},
/turf/simulated/floor/tiled/freezer,
/area/submap/DeathDen)
"MI" = (
/obj/structure/windoor_assembly,
/obj/effect/decal/cleanable/dirt,
/turf/simulated/floor/tiled/freezer,
/area/submap/DeathDen)
"MV" = (
/turf/simulated/wall/sifwood,
/area/submap/DeathDen)
"OB" = (
/obj/item/flame/lighter/zippo/gonzo,
/obj/random/trash,
/obj/random/junk,
/turf/simulated/floor/wood/sif{
	oxygen = 0
	},
/area/submap/DeathDen)
"Pj" = (
/obj/structure/simple_door/sifwood,
/obj/effect/decal/cleanable/dirt,
/turf/simulated/floor/plating,
/area/submap/DeathDen)
"Ps" = (
/obj/effect/decal/cleanable/dirt,
/obj/item/reagent_containers/food/snacks/candy_corn{
	pixel_x = 6;
	pixel_y = 4
	},
/turf/simulated/floor/wood/sif,
/area/submap/DeathDen)
"Qa" = (
/obj/structure/table/bench/wooden,
/turf/simulated/floor/wood/sif{
	oxygen = 0
	},
/area/submap/DeathDen)
"QF" = (
/obj/structure/gravemarker,
/obj/random/humanoidremains,
/obj/item/clothing/suit/cultrobes/alt{
	pixel_x = 4;
	pixel_y = 3
	},
/obj/item/material/knife/machete,
/obj/structure/closet/grave{
	opened = 0
	},
/turf/template_noop,
/area/template_noop)
"QS" = (
/obj/structure/gravemarker,
/obj/random/humanoidremains,
/obj/item/clothing/suit/cultrobes/alt{
	pixel_x = 4;
	pixel_y = 3
	},
/obj/item/material/knife/hook,
/obj/structure/closet/grave{
	opened = 0
	},
/turf/template_noop,
/area/template_noop)
"Rc" = (
/obj/structure/closet/cabinet,
/obj/item/material/kitchen/utensil/fork,
/obj/item/material/kitchen/utensil/fork,
/obj/item/material/kitchen/utensil/spoon{
	pixel_x = 2
	},
/obj/item/material/kitchen/utensil/spoon{
	pixel_x = 2
	},
/obj/item/trash/plate,
/obj/item/trash/plate,
/obj/item/storage/box/cups,
/obj/item/storage/box/donut,
/turf/simulated/floor/wood/sif,
/area/submap/DeathDen)
"RZ" = (
/obj/effect/decal/cleanable/dirt,
/turf/simulated/floor/wood/sif{
	oxygen = 0
	},
/area/submap/DeathDen)
"Sf" = (
/obj/structure/table/wooden_reinforced,
/obj/item/flame/candle/everburn,
/turf/simulated/floor/wood/sif,
/area/submap/DeathDen)
"Sy" = (
/obj/structure/gravemarker,
/obj/random/humanoidremains,
/obj/item/clothing/suit/cultrobes/alt{
	pixel_x = 4;
	pixel_y = 3
	},
/obj/item/material/knife/ritual,
/obj/structure/closet/grave{
	opened = 0
	},
/turf/template_noop,
/area/template_noop)
"Tb" = (
/obj/structure/toilet{
	dir = 4
	},
/turf/simulated/floor/tiled/freezer,
/area/submap/DeathDen)
"Tm" = (
/turf/simulated/wall/cult,
/area/submap/DeathDen)
"Tx" = (
/obj/machinery/power/supermatter/shard,
/turf/simulated/floor/wood/sif{
	oxygen = 0
	},
/area/submap/DeathDen)
"Xy" = (
/obj/effect/decal/cleanable/dirt,
/obj/item/reagent_containers/food/snacks/candy_corn{
	pixel_x = 6;
	pixel_y = 4
	},
/mob/living/simple_mob/vore/aggressive/deathclaw/den{
	move_speed = 7;
	name = "Alpha deathclaw"
	},
/turf/simulated/floor/wood/sif,
/area/submap/DeathDen)
"Yr" = (
/obj/effect/decal/cleanable/dirt,
/obj/effect/map_helper/no_phaseshift,
/turf/simulated/floor/wood/sif,
/area/submap/DeathDen)
"YA" = (
/obj/effect/decal/cleanable/dirt,
/turf/simulated/floor/wood/sif,
/area/submap/DeathDen)
"ZG" = (
/obj/item/reagent_containers/food/snacks/candy_corn,
/obj/item/reagent_containers/food/snacks/candy_corn{
	pixel_x = 6;
	pixel_y = 4
	},
/obj/item/gun/projectile/deagle,
/turf/simulated/floor/wood/sif{
	oxygen = 0
	},
/area/submap/DeathDen)

(1,1,1) = {"
Is
Is
Is
Is
Is
Is
Is
Is
Is
Is
Is
Is
Is
Is
Is
Is
Is
Is
"}
(2,1,1) = {"
Is
Is
Is
Is
Is
Is
Is
Is
Is
Is
Is
Is
Is
Is
si
si
Ct
Ct
"}
(3,1,1) = {"
Is
Is
MV
MV
hq
hq
hq
MV
MV
td
QS
Sy
QF
si
FN
rO
Ct
Ct
"}
(4,1,1) = {"
Is
Is
MV
Iw
uL
ii
hL
gG
MV
MV
MV
MV
MV
Ct
KP
rO
xh
Ct
"}
(5,1,1) = {"
Is
Is
hq
xw
YA
nl
cQ
zd
MV
Tb
xF
lx
MV
Ct
Ct
rO
rO
FN
"}
(6,1,1) = {"
Is
Is
hq
Sf
nl
ix
Cp
Cp
MV
CZ
nG
hJ
MV
Ct
Ct
KP
si
Is
"}
(7,1,1) = {"
Is
Is
MV
uy
YA
im
pQ
Rc
MV
Mn
MI
zS
bK
Ct
Ct
Ct
si
Is
"}
(8,1,1) = {"
Is
MV
MV
MV
MV
MV
rn
MV
MV
MV
rn
MV
MV
MV
MV
MV
Ct
Is
"}
(9,1,1) = {"
Is
MV
Sf
Ps
JE
ex
mR
GU
YA
MV
pz
Kg
RZ
pz
AQ
MV
Ct
Is
"}
(10,1,1) = {"
Is
rn
Yr
Ps
Xy
Ps
Cp
GT
CJ
Pj
Qa
no
Fe
jM
Qa
MV
Ct
Is
"}
(11,1,1) = {"
Is
MV
ua
Ps
pE
hz
Ps
Bx
YA
MV
OB
wa
RZ
yA
AS
MV
Ct
Is
"}
(12,1,1) = {"
Is
MV
MV
hq
MV
MV
MV
Lb
Ay
MV
Qa
as
AS
Cv
Gc
MV
Ct
Ct
"}
(13,1,1) = {"
Is
Is
si
rO
KP
Ct
MV
MV
MV
MV
he
jW
EJ
IE
dx
MV
Ct
Ct
"}
(14,1,1) = {"
Is
si
si
KP
rO
Ct
Ct
Ct
Ct
MV
EJ
mC
KS
av
EJ
MV
Ct
Ct
"}
(15,1,1) = {"
Is
Is
Ct
Ct
rO
xh
Ct
Ct
Ct
MV
ZG
AS
aj
Gr
EJ
MV
Ct
Ct
"}
(16,1,1) = {"
Is
Ct
Ct
Ct
KP
rO
Ct
Ct
Ct
MV
MV
Tm
Dt
Tm
MV
MV
Ct
Ct
"}
(17,1,1) = {"
Is
Ct
Ct
Ct
KP
si
si
Ct
Ct
Ct
Ct
Tm
Tx
Tm
Ct
Ct
Ct
Is
"}
(18,1,1) = {"
Is
Is
Is
Is
si
Is
Is
Is
Is
Ct
Ct
Tm
Tm
Tm
Ct
Ct
Is
Is
"}
(19,1,1) = {"
Is
Is
Is
Is
Is
Is
Is
Is
Is
Is
Ct
Ct
Ct
Ct
Is
Is
Is
Is
"}
