//MAP CONVERTED BY dmm2tgm.py THIS HEADER COMMENT PREVENTS RECONVERSION, DO NOT REMOVE
"ao" = (
/obj/effect/floor_decal/borderfloor/corner{
	dir = 8
	},
/turf/simulated/floor/tiled/dark,
/area/submap/DogBase)
"aB" = (
/obj/structure/closet/crate/secure/lootsafe/numberlock,
/obj/effect/floor_decal/borderfloor{
	dir = 5
	},
/turf/simulated/floor/tiled/dark,
/area/submap/DogBase)
"bb" = (
/obj/structure/table/woodentable,
/turf/simulated/floor/tiled/dark,
/area/submap/DogBase)
"bg" = (
/obj/structure/closet/crate/trashcart,
/obj/effect/floor_decal/corner/purple/diagonal,
/turf/simulated/floor/tiled/dark,
/area/submap/DogBase)
"bl" = (
/obj/structure/dogbed,
/obj/effect/decal/remains/deer,
/obj/effect/decal/cleanable/dirt,
/obj/random/contraband,
/turf/simulated/floor/outdoors/dirt/sif/planetuse,
/area/submap/DogBase)
"bF" = (
/obj/structure/cable/green{
	icon_state = "1-4"
	},
/mob/living/simple_mob/mechanical/viscerator/mercenary,
/turf/simulated/floor/plating,
/area/submap/DogBase)
"bG" = (
/obj/structure/table/rack/shelf/steel,
/obj/effect/floor_decal/corner/purple/diagonal,
/turf/simulated/floor/tiled/dark,
/area/submap/DogBase)
"bX" = (
/mob/living/bot/cleanbot{
	faction = "syndicate"
	},
/obj/effect/floor_decal/corner/purple/diagonal,
/turf/simulated/floor/tiled/dark,
/area/submap/DogBase)
"cK" = (
/mob/living/simple_mob/animal/giant_spider/tunneler{
	name = "trained giant spider";
	faction = "syndicate"
	},
/obj/effect/floor_decal/borderfloor{
	dir = 1
	},
/turf/simulated/floor/tiled/dark,
/area/submap/DogBase)
"dn" = (
/obj/machinery/light{
	dir = 8;
	icon_state = "tube1"
	},
/obj/machinery/vending/security,
/obj/effect/floor_decal/corner/red/border{
	dir = 9;
	icon_state = "bordercolor"
	},
/turf/simulated/floor/tiled/dark,
/area/submap/DogBase)
"dp" = (
/obj/effect/floor_decal/corner/red/border{
	dir = 8;
	icon_state = "bordercolor"
	},
/turf/simulated/floor/tiled/dark,
/area/submap/DogBase)
"dE" = (
/obj/effect/floor_decal/corner/red/border{
	dir = 4;
	icon_state = "bordercolor"
	},
/turf/simulated/floor/tiled/dark,
/area/submap/DogBase)
"ec" = (
/mob/living/simple_mob/animal/giant_spider/nurse{
	faction = "syndicate";
	name = "trained giant spider"
	},
/obj/effect/decal/cleanable/dirt,
/turf/simulated/floor/outdoors/dirt/sif/planetuse,
/area/submap/DogBase)
"ew" = (
/obj/structure/dogbed,
/obj/effect/decal/remains/human,
/obj/effect/decal/cleanable/filth,
/obj/effect/decal/cleanable/dirt,
/obj/item/bone/ribs,
/obj/random/maintenance/research,
/turf/simulated/floor/outdoors/dirt/sif/planetuse,
/area/submap/DogBase)
"eQ" = (
/obj/structure/janitorialcart,
/obj/item/storage/bag/trash,
/obj/effect/floor_decal/corner/purple/diagonal,
/turf/simulated/floor/tiled/dark,
/area/submap/DogBase)
"fz" = (
/obj/machinery/light{
	dir = 4;
	icon_state = "tube1";
	pixel_x = 0
	},
/obj/effect/floor_decal/corner/red/border{
	dir = 6
	},
/turf/simulated/floor/tiled/dark,
/area/submap/DogBase)
"fJ" = (
/obj/machinery/door/airlock/engineering,
/turf/simulated/floor/tiled,
/area/submap/DogBase)
"fP" = (
/obj/effect/floor_decal/borderfloor{
	dir = 1
	},
/turf/simulated/floor/tiled/dark,
/area/submap/DogBase)
"gh" = (
/obj/structure/closet/l3closet/janitor,
/obj/effect/floor_decal/corner/purple/diagonal,
/turf/simulated/floor/tiled/dark,
/area/submap/DogBase)
"gi" = (
/mob/living/simple_mob/animal/giant_spider/pepper{
	faction = "syndicate";
	name = "trained giant spider"
	},
/obj/effect/decal/cleanable/dirt,
/turf/simulated/floor/outdoors/dirt/sif/planetuse,
/area/template_noop)
"gx" = (
/obj/machinery/power/smes/buildable/point_of_interest,
/obj/structure/cable/green{
	icon_state = "0-2"
	},
/turf/simulated/floor/plating,
/area/submap/DogBase)
"gy" = (
/obj/item/modular_computer/laptop/preset/custom_loadout/cheap,
/obj/structure/table/woodentable,
/obj/effect/floor_decal/corner/red/border{
	dir = 1;
	icon_state = "bordercolor"
	},
/turf/simulated/floor/tiled/dark,
/area/submap/DogBase)
"gW" = (
/turf/simulated/floor/plating/sif/planetuse,
/area/submap/DogBase)
"hV" = (
/obj/effect/decal/cleanable/dirt,
/obj/item/bone/leg,
/mob/living/simple_mob/animal/giant_spider/nurse{
	faction = "syndicate";
	name = "trained giant spider"
	},
/turf/simulated/floor/outdoors/dirt/sif/planetuse,
/area/submap/DogBase)
"hW" = (
/obj/effect/decal/cleanable/dirt,
/turf/simulated/floor/outdoors/dirt/sif/planetuse,
/area/submap/DogBase)
"ir" = (
/obj/structure/table/woodentable,
/obj/item/gun/projectile/pistol,
/turf/simulated/floor/tiled/dark,
/area/submap/DogBase)
"iW" = (
/obj/structure/dogbed,
/obj/effect/decal/remains/deer,
/obj/effect/decal/cleanable/dirt,
/turf/simulated/floor/outdoors/dirt/sif/planetuse,
/area/submap/DogBase)
"ja" = (
/turf/simulated/floor/tiled/dark,
/area/submap/DogBase)
"jH" = (
/obj/structure/dogbed,
/obj/effect/decal/cleanable/dirt,
/obj/random/maintenance/security,
/turf/simulated/floor/outdoors/dirt/sif/planetuse,
/area/submap/DogBase)
"kl" = (
/obj/random/mob/merc/all,
/obj/structure/bed/chair,
/turf/simulated/floor/tiled/dark,
/area/submap/DogBase)
"kn" = (
/obj/machinery/power/smes/buildable/point_of_interest,
/obj/structure/cable/green,
/turf/simulated/floor/plating,
/area/submap/DogBase)
"ky" = (
/mob/living/simple_mob/animal/giant_spider/pepper{
	faction = "syndicate";
	name = "trained giant spider"
	},
/obj/effect/floor_decal/borderfloor{
	dir = 8
	},
/turf/simulated/floor/tiled/dark,
/area/submap/DogBase)
"kL" = (
/obj/structure/bed/chair,
/turf/simulated/floor/tiled/dark,
/area/submap/DogBase)
"lt" = (
/obj/structure/closet/secure_closet/guncabinet,
/obj/effect/floor_decal/corner/red/border{
	dir = 1;
	icon_state = "bordercolor"
	},
/turf/simulated/floor/tiled/dark,
/area/submap/DogBase)
"lJ" = (
/obj/structure/bed,
/obj/item/bedsheet,
/turf/simulated/floor/tiled/dark,
/area/submap/DogBase)
"md" = (
/obj/machinery/door/airlock,
/turf/simulated/floor/tiled/dark,
/area/submap/DogBase)
"mF" = (
/turf/simulated/floor/outdoors/dirt/sif/planetuse,
/area/template_noop)
"nd" = (
/obj/machinery/light{
	dir = 8;
	icon_state = "tube1"
	},
/obj/effect/floor_decal/borderfloor{
	dir = 8
	},
/turf/simulated/floor/tiled/dark,
/area/submap/DogBase)
"nT" = (
/obj/machinery/vending/cigarette,
/obj/effect/floor_decal/borderfloor{
	dir = 6
	},
/turf/simulated/floor/tiled/dark,
/area/submap/DogBase)
"nV" = (
/obj/effect/decal/remains/unathi,
/obj/effect/decal/cleanable/dirt,
/turf/simulated/floor/outdoors/dirt/sif/planetuse,
/area/submap/DogBase)
"oa" = (
/obj/structure/bed,
/obj/item/bedsheet,
/obj/effect/floor_decal/borderfloor{
	dir = 9
	},
/turf/simulated/floor/tiled/dark,
/area/submap/DogBase)
"pe" = (
/obj/structure/cable{
	icon_state = "2-4"
	},
/mob/living/simple_mob/mechanical/viscerator/mercenary,
/obj/structure/table/rack/shelf/steel,
/obj/item/stack/material/phoron{
	amount = 10
	},
/obj/item/stack/material/phoron{
	amount = 10;
	pixel_x = 1;
	pixel_y = 6
	},
/turf/simulated/floor/plating,
/area/submap/DogBase)
"pT" = (
/obj/machinery/light{
	dir = 1
	},
/obj/effect/floor_decal/borderfloor{
	dir = 1
	},
/turf/simulated/floor/tiled/dark,
/area/submap/DogBase)
"qn" = (
/obj/structure/dogbed,
/obj/effect/decal/remains/tajaran,
/obj/effect/decal/cleanable/filth,
/obj/effect/decal/cleanable/dirt,
/obj/item/bone,
/obj/random/maintenance/security,
/turf/simulated/floor/outdoors/dirt/sif/planetuse,
/area/submap/DogBase)
"qo" = (
/obj/effect/floor_decal/industrial/danger{
	dir = 1
	},
/turf/simulated/floor/plating/sif/planetuse,
/area/submap/DogBase)
"rX" = (
/mob/living/simple_mob/animal/giant_spider/tunneler{
	name = "trained giant spider";
	faction = "syndicate"
	},
/obj/effect/floor_decal/industrial/danger{
	dir = 1
	},
/turf/simulated/floor/plating/sif/planetuse,
/area/submap/DogBase)
"sm" = (
/obj/structure/closet/secure_closet/guncabinet,
/obj/random/projectile,
/obj/effect/floor_decal/corner/red/border{
	dir = 1;
	icon_state = "bordercolor"
	},
/turf/simulated/floor/tiled/dark,
/area/submap/DogBase)
"sw" = (
/obj/machinery/light{
	dir = 1
	},
/obj/effect/floor_decal/corner/purple/diagonal,
/turf/simulated/floor/tiled/dark,
/area/submap/DogBase)
"sB" = (
/obj/machinery/light{
	dir = 8
	},
/obj/effect/floor_decal/borderfloor{
	dir = 8
	},
/turf/simulated/floor/tiled/dark,
/area/submap/DogBase)
"sX" = (
/obj/effect/floor_decal/borderfloor{
	dir = 6
	},
/turf/simulated/floor/tiled/dark,
/area/submap/DogBase)
"to" = (
/obj/effect/floor_decal/borderfloor{
	dir = 9
	},
/turf/simulated/floor/tiled/dark,
/area/submap/DogBase)
"tE" = (
/turf/simulated/wall/r_wall,
/area/submap/DogBase)
"vq" = (
/obj/structure/cable/green{
	icon_state = "4-8"
	},
/mob/living/simple_mob/mechanical/viscerator/mercenary,
/turf/simulated/floor/plating,
/area/submap/DogBase)
"vt" = (
/obj/effect/decal/cleanable/dirt,
/obj/random/maintenance/cargo,
/turf/simulated/floor/outdoors/dirt/sif/planetuse,
/area/submap/DogBase)
"vI" = (
/obj/effect/floor_decal/borderfloor/corner{
	dir = 4
	},
/turf/simulated/floor/tiled/dark,
/area/submap/DogBase)
"xf" = (
/mob/living/simple_mob/animal/giant_spider/tunneler{
	name = "trained giant spider";
	faction = "syndicate"
	},
/turf/simulated/floor/tiled/dark,
/area/submap/DogBase)
"xC" = (
/obj/structure/dogbed,
/obj/effect/decal/cleanable/dirt,
/obj/item/bone,
/obj/random/maintenance/security,
/turf/simulated/floor/outdoors/dirt/sif/planetuse,
/area/submap/DogBase)
"yq" = (
/obj/machinery/porta_turret/poi{
	faction = "syndicate"
	},
/obj/effect/floor_decal/borderfloor{
	dir = 4
	},
/turf/simulated/floor/tiled/dark,
/area/submap/DogBase)
"yr" = (
/obj/effect/floor_decal/borderfloor{
	dir = 10
	},
/turf/simulated/floor/tiled/dark,
/area/submap/DogBase)
"yS" = (
/obj/structure/bed,
/obj/item/bedsheet,
/obj/effect/floor_decal/borderfloor{
	dir = 8
	},
/turf/simulated/floor/tiled/dark,
/area/submap/DogBase)
"za" = (
/obj/structure/cable{
	icon_state = "4-8"
	},
/obj/structure/cable{
	icon_state = "1-8"
	},
/mob/living/simple_mob/mechanical/viscerator/mercenary,
/turf/simulated/floor/plating,
/area/submap/DogBase)
"AN" = (
/mob/living/simple_mob/animal/giant_spider/pepper{
	faction = "syndicate";
	name = "trained giant spider"
	},
/turf/template_noop,
/area/template_noop)
"BX" = (
/mob/living/simple_mob/animal/giant_spider/pepper{
	faction = "syndicate";
	name = "trained giant spider"
	},
/obj/effect/floor_decal/borderfloor{
	dir = 6
	},
/turf/simulated/floor/tiled/dark,
/area/submap/DogBase)
"CP" = (
/obj/machinery/porta_turret/poi{
	faction = "syndicate"
	},
/turf/simulated/floor,
/area/submap/DogBase)
"Dz" = (
/obj/effect/floor_decal/corner/red/border{
	dir = 1;
	icon_state = "bordercolor"
	},
/turf/simulated/floor/tiled/dark,
/area/submap/DogBase)
"DD" = (
/obj/effect/floor_decal/corner/purple/diagonal,
/turf/simulated/floor/tiled/dark,
/area/submap/DogBase)
"Ed" = (
/obj/effect/decal/cleanable/dirt,
/turf/simulated/floor/outdoors/dirt/sif/planetuse,
/area/template_noop)
"Ek" = (
/obj/machinery/power/port_gen/pacman,
/obj/structure/cable{
	icon_state = "0-4"
	},
/turf/simulated/floor/plating,
/area/submap/DogBase)
"Eo" = (
/obj/machinery/light{
	dir = 4;
	icon_state = "tube1";
	pixel_x = 0
	},
/obj/machinery/vending/coffee,
/obj/effect/floor_decal/corner/red/border{
	dir = 5;
	icon_state = "bordercolor"
	},
/turf/simulated/floor/tiled/dark,
/area/submap/DogBase)
"Ep" = (
/obj/structure/fence,
/obj/effect/decal/cleanable/dirt,
/turf/simulated/floor/outdoors/dirt/sif/planetuse,
/area/submap/DogBase)
"Ey" = (
/obj/machinery/vending/cola,
/obj/effect/floor_decal/borderfloor{
	dir = 10
	},
/turf/simulated/floor/tiled/dark,
/area/submap/DogBase)
"EK" = (
/obj/effect/decal/remains/ribcage,
/turf/template_noop,
/area/template_noop)
"Ge" = (
/turf/template_noop,
/area/template_noop)
"GP" = (
/obj/item/storage/belt/janitor,
/obj/effect/floor_decal/corner/purple/diagonal,
/turf/simulated/floor/tiled/dark,
/area/submap/DogBase)
"Hh" = (
/obj/machinery/power/apc{
	cell_type = /obj/item/cell/super;
	dir = 8;
	name = "Unknown APC";
	pixel_x = -24
	},
/obj/structure/cable/green{
	icon_state = "0-2"
	},
/mob/living/simple_mob/mechanical/viscerator/mercenary,
/turf/simulated/floor/plating,
/area/submap/DogBase)
"Hv" = (
/obj/random/mob/merc/all,
/turf/simulated/floor/tiled/dark,
/area/submap/DogBase)
"HX" = (
/obj/structure/table/woodentable,
/obj/random/projectile/scrapped_pistol,
/turf/simulated/floor/tiled/dark,
/area/submap/DogBase)
"Io" = (
/obj/machinery/light,
/obj/effect/floor_decal/borderfloor,
/turf/simulated/floor/tiled/dark,
/area/submap/DogBase)
"Ju" = (
/mob/living/simple_mob/mechanical/viscerator/mercenary,
/turf/template_noop,
/area/template_noop)
"JD" = (
/obj/effect/floor_decal/borderfloor{
	dir = 8
	},
/turf/simulated/floor/tiled/dark,
/area/submap/DogBase)
"JV" = (
/obj/random/mob/merc/all,
/turf/simulated/floor/plating/sif/planetuse,
/area/submap/DogBase)
"Ka" = (
/obj/effect/floor_decal/borderfloor/corner{
	dir = 1
	},
/turf/simulated/floor/tiled/dark,
/area/submap/DogBase)
"Ks" = (
/obj/structure/closet/secure_closet/guncabinet,
/obj/random/projectile/scrapped_smg,
/obj/random/projectile/scrapped_smg,
/obj/random/projectile/scrapped_smg,
/obj/random/projectile/scrapped_shotgun,
/obj/effect/floor_decal/corner/red/border{
	dir = 1;
	icon_state = "bordercolor"
	},
/turf/simulated/floor/tiled/dark,
/area/submap/DogBase)
"KH" = (
/obj/structure/table/woodentable,
/obj/random/contraband,
/turf/simulated/floor/tiled/dark,
/area/submap/DogBase)
"KW" = (
/obj/effect/landmark/loot_spawn,
/obj/effect/floor_decal/borderfloor{
	dir = 5
	},
/turf/simulated/floor/tiled/dark,
/area/submap/DogBase)
"Lb" = (
/obj/structure/fence/corner{
	dir = 1
	},
/obj/effect/decal/cleanable/dirt,
/turf/simulated/floor/outdoors/dirt/sif/planetuse,
/area/submap/DogBase)
"MF" = (
/obj/structure/dogbed,
/obj/effect/decal/cleanable/dirt,
/obj/item/bone,
/obj/random/contraband,
/turf/simulated/floor/outdoors/dirt/sif/planetuse,
/area/submap/DogBase)
"MW" = (
/obj/structure/dogbed,
/obj/effect/decal/remains/unathi,
/obj/effect/decal/cleanable/dirt,
/obj/random/maintenance/security,
/turf/simulated/floor/outdoors/dirt/sif/planetuse,
/area/submap/DogBase)
"Ns" = (
/obj/machinery/door/blast/gate/thin,
/obj/effect/decal/cleanable/dirt,
/turf/simulated/floor/outdoors/dirt/sif/planetuse,
/area/submap/DogBase)
"NA" = (
/obj/structure/table/woodentable,
/obj/effect/floor_decal/borderfloor{
	dir = 1
	},
/turf/simulated/floor/tiled/dark,
/area/submap/DogBase)
"NK" = (
/obj/machinery/porta_turret/poi{
	faction = "syndicate"
	},
/obj/effect/floor_decal/borderfloor{
	dir = 8
	},
/turf/simulated/floor/tiled/dark,
/area/submap/DogBase)
"Oj" = (
/obj/structure/dogbed,
/obj/effect/decal/cleanable/dirt,
/obj/effect/decal/remains/tajaran,
/obj/random/maintenance/medical,
/turf/simulated/floor/outdoors/dirt/sif/planetuse,
/area/submap/DogBase)
"PI" = (
/obj/structure/bed,
/obj/item/bedsheet,
/obj/effect/floor_decal/borderfloor{
	dir = 1
	},
/turf/simulated/floor/tiled/dark,
/area/submap/DogBase)
"PL" = (
/obj/effect/floor_decal/borderfloor{
	dir = 4
	},
/turf/simulated/floor/tiled/dark,
/area/submap/DogBase)
"PW" = (
/obj/structure/dogbed,
/obj/effect/decal/cleanable/dirt,
/obj/effect/decal/remains/human,
/obj/random/contraband,
/turf/simulated/floor/outdoors/dirt/sif/planetuse,
/area/submap/DogBase)
"Qj" = (
/obj/structure/fence{
	dir = 4
	},
/obj/effect/decal/cleanable/dirt,
/turf/simulated/floor/outdoors/dirt/sif/planetuse,
/area/submap/DogBase)
"QF" = (
/obj/machinery/light{
	dir = 4;
	icon_state = "tube1";
	pixel_x = 0
	},
/obj/effect/floor_decal/borderfloor{
	dir = 4
	},
/turf/simulated/floor/tiled/dark,
/area/submap/DogBase)
"Rk" = (
/obj/structure/cable/green{
	icon_state = "1-8"
	},
/obj/structure/cable/green{
	icon_state = "2-8"
	},
/obj/machinery/light{
	dir = 4;
	icon_state = "tube1";
	pixel_x = 0
	},
/mob/living/simple_mob/mechanical/viscerator/mercenary,
/turf/simulated/floor/plating,
/area/submap/DogBase)
"Ry" = (
/obj/effect/decal/remains/human,
/obj/effect/decal/cleanable/filth,
/obj/effect/decal/cleanable/dirt,
/obj/random/maintenance/cargo,
/turf/simulated/floor/outdoors/dirt/sif/planetuse,
/area/submap/DogBase)
"RB" = (
/obj/effect/decal/remains/human,
/turf/template_noop,
/area/template_noop)
"RO" = (
/obj/structure/bed/chair{
	dir = 1
	},
/turf/simulated/floor/tiled/dark,
/area/submap/DogBase)
"Sc" = (
/obj/effect/floor_decal/borderfloor,
/turf/simulated/floor/tiled/dark,
/area/submap/DogBase)
"Sj" = (
/obj/structure/dogbed,
/obj/effect/decal/cleanable/dirt,
/obj/random/maintenance/research,
/turf/simulated/floor/outdoors/dirt/sif/planetuse,
/area/submap/DogBase)
"Sn" = (
/obj/effect/decal/remains/human,
/obj/effect/decal/cleanable/dirt,
/obj/random/maintenance/cargo,
/turf/simulated/floor/outdoors/dirt/sif/planetuse,
/area/submap/DogBase)
"Sz" = (
/obj/structure/table/woodentable,
/obj/effect/floor_decal/corner/red/border{
	dir = 1;
	icon_state = "bordercolor"
	},
/obj/random/curseditem,
/turf/simulated/floor/tiled/dark,
/area/submap/DogBase)
"SB" = (
/obj/machinery/power/terminal{
	dir = 4
	},
/obj/structure/cable{
	icon_state = "0-8"
	},
/mob/living/simple_mob/mechanical/viscerator/mercenary,
/turf/simulated/floor/plating,
/area/submap/DogBase)
"SO" = (
/obj/machinery/light{
	dir = 1
	},
/obj/effect/floor_decal/industrial/danger{
	dir = 1
	},
/turf/simulated/floor/plating/sif/planetuse,
/area/submap/DogBase)
"TB" = (
/obj/effect/decal/cleanable/dirt,
/turf/simulated/floor/plating/sif/planetuse,
/area/submap/DogBase)
"TQ" = (
/obj/structure/table/woodentable,
/obj/effect/floor_decal/corner/red/border{
	dir = 1;
	icon_state = "bordercolor"
	},
/obj/random/cash,
/turf/simulated/floor/tiled/dark,
/area/submap/DogBase)
"UM" = (
/obj/effect/decal/cleanable/dirt,
/turf/template_noop,
/area/template_noop)
"UN" = (
/obj/structure/table/woodentable,
/obj/effect/floor_decal/borderfloor{
	dir = 1
	},
/obj/random/cash,
/turf/simulated/floor/tiled/dark,
/area/submap/DogBase)
"Vi" = (
/obj/machinery/light{
	dir = 8;
	icon_state = "tube1"
	},
/obj/effect/floor_decal/corner/red/border{
	dir = 10;
	icon_state = "bordercolor"
	},
/turf/simulated/floor/tiled/dark,
/area/submap/DogBase)
"Vn" = (
/obj/machinery/door/airlock,
/turf/simulated/floor/tiled,
/area/submap/DogBase)
"Vw" = (
/obj/effect/floor_decal/borderfloor{
	dir = 5
	},
/turf/simulated/floor/tiled/dark,
/area/submap/DogBase)
"Vz" = (
/obj/effect/floor_decal/borderfloor/corner,
/turf/simulated/floor/tiled/dark,
/area/submap/DogBase)
"Wx" = (
/obj/machinery/door/airlock/external,
/turf/simulated/floor/tiled/dark,
/area/submap/DogBase)
"WC" = (
/obj/structure/sign/securearea,
/turf/simulated/wall/r_wall,
/area/submap/DogBase)
"XA" = (
/obj/effect/floor_decal/corner/red/border,
/turf/simulated/floor/tiled/dark,
/area/submap/DogBase)
"XC" = (
/obj/machinery/porta_turret/poi{
	faction = "syndicate"
	},
/turf/simulated/floor/plating/sif/planetuse,
/area/submap/DogBase)
"XR" = (
/obj/random/mob/merc/all,
/turf/template_noop,
/area/template_noop)
"YI" = (
/obj/structure/table/woodentable,
/obj/random/cash,
/turf/simulated/floor/tiled/dark,
/area/submap/DogBase)
"YK" = (
/obj/structure/cable/green{
	icon_state = "4-8"
	},
/obj/structure/cable{
	icon_state = "1-2";
	pixel_y = 0
	},
/mob/living/simple_mob/mechanical/viscerator/mercenary,
/turf/simulated/floor/plating,
/area/submap/DogBase)
"Zk" = (
/obj/structure/loot_pile/maint/technical,
/obj/effect/floor_decal/corner/purple/diagonal,
/turf/simulated/floor/tiled/dark,
/area/submap/DogBase)
"Zn" = (
/obj/structure/table/woodentable,
/obj/item/radio/phone,
/turf/simulated/floor/tiled/dark,
/area/submap/DogBase)
"ZC" = (
/obj/effect/decal/remains/tajaran,
/turf/template_noop,
/area/template_noop)

(1,1,1) = {"
Ge
Ge
Ge
Ge
Ge
Ge
Ge
Ge
RB
Ge
Ge
Ge
Ge
Ge
Ge
Ge
Ge
Ge
Ge
Ge
Ge
Ge
Ge
Ge
Ge
Ge
Ge
Ge
RB
Ge
"}
(2,1,1) = {"
Ge
Ge
Ge
Ge
Ge
Ge
Ge
Ge
Ge
Ge
Ge
Ge
Ge
Ge
Ge
Ge
Ge
Ge
Ge
Ge
Ge
Ge
Ge
Ge
Ge
Ge
Ge
Ge
Ge
Ge
"}
(3,1,1) = {"
Ge
RB
Ge
Ge
Ge
Ge
Ge
Ge
Ge
Ge
Ge
Ge
Ge
Ge
Ge
Ge
Ge
Ge
Ge
Ju
Ge
Ge
Ge
Ge
Ge
Ge
Ge
Ge
Ge
Ge
"}
(4,1,1) = {"
Ge
Ge
Ge
Ge
Ge
Ge
Ge
XC
gW
Ge
Ge
Ge
gW
XC
Ge
Ge
Ge
Ge
Ge
Ge
Ge
Ge
Ge
Ge
Ge
Ge
Ge
Ge
Ge
Ge
"}
(5,1,1) = {"
Ge
Ge
Ge
Ge
Ge
Ge
Ge
gW
tE
tE
tE
tE
tE
Ep
Ep
Ep
Ep
Ep
Lb
UM
Ge
Ge
Ge
Ge
Ed
Ge
Ge
RB
Ge
Ge
"}
(6,1,1) = {"
Ge
Ge
Ge
Ge
Ge
Ge
Ge
Ge
tE
gh
bX
Zk
tE
ew
bl
iW
xC
MW
Qj
UM
ZC
Ge
Ge
Ed
Ed
Ju
Ge
mF
Ge
Ge
"}
(7,1,1) = {"
Ge
Ge
Ge
Ge
Ge
XR
AN
Ge
tE
bG
DD
Zk
tE
jH
Ry
hV
nV
vt
Ns
Ed
Ed
Ed
Ed
Ed
Ge
mF
Ge
Ge
Ge
Ge
"}
(8,1,1) = {"
Ge
Ge
Ge
Ge
Ge
Ge
Ge
Ge
tE
sw
DD
GP
tE
qn
hW
ec
Sn
hW
Ns
Ed
Ed
gi
Ed
Ge
Ge
Ge
Ge
mF
Ge
Ge
"}
(9,1,1) = {"
Ge
Ge
CP
gW
Ge
Ge
Ge
Ge
tE
bg
DD
eQ
tE
Sj
PW
Oj
MF
iW
Qj
ZC
Ge
Ge
UM
UM
TB
XC
Ge
Ge
Ge
Ge
"}
(10,1,1) = {"
Ge
Ge
gW
tE
tE
tE
tE
tE
tE
tE
Vn
tE
tE
tE
tE
tE
tE
tE
tE
tE
tE
tE
tE
tE
tE
gW
Ge
RB
Ge
Ge
"}
(11,1,1) = {"
Ge
Ge
Ge
tE
oa
sB
yS
yr
tE
dn
dp
Vi
tE
to
JD
JD
ky
sB
yr
tE
to
JD
NK
yr
tE
gW
gW
Ge
Ge
Ge
"}
(12,1,1) = {"
RB
Ge
Ju
tE
UN
ja
HX
Sc
tE
lt
Hv
XA
tE
fP
kL
KH
RO
ja
Sc
tE
cK
ja
ja
Sc
tE
qo
gW
Ge
Ge
mF
"}
(13,1,1) = {"
Ge
Ju
Ge
tE
PI
ja
lJ
Sc
tE
sm
ja
XA
tE
fP
kl
Zn
RO
ja
ao
nd
Ka
Vz
PL
nT
tE
rX
gW
mF
mF
Ge
"}
(14,1,1) = {"
Ge
gW
gW
tE
NA
ja
bb
Sc
tE
Ks
ja
XA
tE
pT
kL
KH
RO
ja
Vz
PL
vI
Io
tE
tE
WC
SO
gW
mF
Ge
Ge
"}
(15,1,1) = {"
Ge
XC
gW
tE
PI
Hv
lJ
Sc
md
Dz
ja
XA
md
fP
kL
Zn
RO
xf
Sc
tE
fP
Sc
Wx
ja
Wx
qo
JV
mF
mF
mF
"}
(16,1,1) = {"
Ge
gW
gW
tE
NA
ja
YI
Sc
tE
Sz
ja
XA
tE
pT
kL
ir
RO
ja
ao
JD
Ka
Io
tE
tE
WC
SO
gW
mF
mF
Ge
"}
(17,1,1) = {"
Ge
Ju
Ge
tE
PI
ja
lJ
Sc
tE
gy
RO
XA
tE
fP
kL
KH
RO
Hv
Vz
QF
vI
ao
JD
Ey
tE
rX
gW
mF
mF
Ge
"}
(18,1,1) = {"
Ge
Ge
Ju
tE
NA
ja
bb
Sc
tE
TQ
Hv
XA
tE
fP
kL
KH
RO
ja
Sc
tE
fP
ja
ja
Sc
tE
qo
gW
Ge
mF
Ge
"}
(19,1,1) = {"
RB
Ge
Ge
tE
aB
QF
PL
sX
tE
Eo
dE
fz
tE
KW
PL
PL
PL
QF
BX
tE
Vw
PL
yq
sX
tE
gW
gW
Ge
Ge
Ge
"}
(20,1,1) = {"
Ge
Ge
gW
tE
tE
tE
tE
tE
tE
tE
fJ
tE
tE
tE
tE
tE
tE
tE
tE
tE
tE
tE
tE
tE
tE
gW
Ge
Ge
Ge
Ge
"}
(21,1,1) = {"
Ge
Ge
XC
gW
Ge
Ge
Ge
Ge
tE
Hh
bF
Ek
tE
Ge
Ge
Ge
Ge
Ge
Ge
Ge
Ge
Ge
Ge
Ge
gW
XC
Ge
Ge
Ge
RB
"}
(22,1,1) = {"
Ge
Ge
Ge
Ge
Ge
Ge
Ju
Ge
tE
pe
YK
za
tE
Ge
Ge
Ge
Ge
Ge
Ge
Ge
Ge
AN
Ge
Ge
Ge
Ge
Ge
Ge
Ge
Ge
"}
(23,1,1) = {"
Ge
Ge
Ge
Ge
Ge
Ge
AN
Ge
tE
SB
vq
SB
tE
Ge
Ge
Ge
Ge
Ge
Ge
Ge
Ge
Ge
Ge
Ge
Ge
Ju
Ge
Ge
Ge
Ge
"}
(24,1,1) = {"
Ge
Ge
Ge
Ge
Ge
XR
Ge
Ge
tE
gx
Rk
kn
tE
Ge
Ge
RB
Ge
Ge
RB
Ge
Ge
Ge
RB
Ge
Ge
Ge
Ge
Ge
RB
Ge
"}
(25,1,1) = {"
Ge
Ge
RB
Ge
Ge
Ge
Ge
gW
tE
tE
tE
tE
tE
gW
Ge
Ge
Ge
Ju
Ge
Ge
EK
Ge
Ge
Ge
Ge
Ge
Ge
Ge
Ge
Ge
"}
(26,1,1) = {"
Ge
Ge
Ge
Ge
Ge
Ge
Ge
XC
gW
Ge
Ge
Ge
gW
XC
Ge
Ge
Ge
Ge
Ge
Ge
Ge
Ge
Ge
Ge
Ge
Ge
Ge
Ge
Ge
Ge
"}
(27,1,1) = {"
Ge
Ge
Ge
Ge
Ge
Ge
Ge
Ge
Ge
Ge
Ge
Ge
Ge
Ge
Ge
Ge
Ge
Ge
Ge
Ge
Ju
Ge
Ge
Ge
RB
Ge
Ge
RB
Ge
Ge
"}
(28,1,1) = {"
Ge
Ge
Ge
Ge
Ge
Ge
Ge
Ge
Ge
Ge
Ge
Ge
Ge
Ge
Ge
RB
Ge
Ge
Ge
Ge
Ge
Ge
Ge
Ge
Ge
Ge
Ge
Ge
Ge
Ge
"}
(29,1,1) = {"
Ge
Ge
Ge
Ge
Ge
Ge
Ge
Ge
Ge
Ge
Ge
RB
Ge
Ge
Ge
Ge
Ge
Ge
Ge
Ge
Ge
Ge
Ge
Ge
Ge
Ge
Ge
Ge
Ge
Ge
"}
(30,1,1) = {"
Ge
Ge
Ge
Ge
Ge
Ge
Ge
Ge
RB
Ge
Ge
Ge
Ge
Ge
Ge
Ge
Ge
Ge
Ge
Ge
Ge
Ge
Ge
Ge
Ge
Ge
Ge
Ge
Ge
Ge
"}
