//MAP CONVERTED BY dmm2tgm.py THIS HEADER COMMENT PREVENTS RECONVERSION, DO NOT REMOVE
"a" = (
/turf/simulated/floor/outdoors/dirt,
/area/submap/drgnplateu)
"b" = (
/mob/living/simple_mob/vore/bigdragon,
/turf/simulated/floor/outdoors/dirt,
/area/submap/drgnplateu)
"c" = (
/obj/item/digestion_remains/skull/unathi,
/obj/item/digestion_remains,
/obj/item/digestion_remains{
	pixel_x = 8;
	pixel_y = 7
	},
/obj/effect/decal/cleanable/filth,
/turf/simulated/floor/outdoors/dirt,
/area/submap/drgnplateu)
"d" = (
/obj/structure/flora/grass/brown{
	pixel_x = 11;
	pixel_y = -9
	},
/obj/structure/flora/grass/green,
/obj/fiftyspawner/gold,
/obj/item/slime_extract/gold,
/obj/item/toy/plushie/carp/gold{
	pixel_x = 18;
	pixel_y = -6
	},
/turf/simulated/floor/outdoors/grass/sif/forest,
/area/submap/drgnplateu)
"e" = (
/obj/item/digestion_remains/skull/nevrean,
/obj/effect/decal/cleanable/filth,
/turf/simulated/floor/outdoors/dirt,
/area/submap/drgnplateu)
"f" = (
/obj/item/digestion_remains/skull/unknown/anthro,
/obj/item/digestion_remains{
	pixel_x = 8;
	pixel_y = 7
	},
/obj/item/digestion_remains{
	pixel_x = 19;
	pixel_y = -2
	},
/obj/item/digestion_remains{
	pixel_x = 19;
	pixel_y = -11
	},
/obj/item/digestion_remains{
	pixel_x = 19;
	pixel_y = 1
	},
/obj/effect/decal/cleanable/blood,
/turf/simulated/floor/outdoors/dirt,
/area/submap/drgnplateu)
"g" = (
/obj/structure/table/gold,
/turf/simulated/floor/outdoors/dirt,
/area/submap/drgnplateu)
"h" = (
/obj/structure/cliff/automatic/ramp,
/turf/simulated/floor/outdoors/dirt,
/area/submap/drgnplateu)
"i" = (
/obj/structure/cliff/automatic{
	dir = 9
	},
/turf/simulated/floor/outdoors/dirt,
/area/submap/drgnplateu)
"j" = (
/obj/item/digestion_remains{
	pixel_x = 8
	},
/obj/item/digestion_remains{
	pixel_x = 8;
	pixel_y = 7
	},
/obj/item/digestion_remains{
	pixel_x = 19;
	pixel_y = 1
	},
/obj/effect/decal/cleanable/filth,
/turf/simulated/floor/outdoors/dirt,
/area/submap/drgnplateu)
"k" = (
/obj/item/digestion_remains/skull/tajaran,
/obj/item/digestion_remains{
	pixel_x = 19;
	pixel_y = 1
	},
/obj/item/digestion_remains{
	pixel_x = 8;
	pixel_y = 1
	},
/obj/item/digestion_remains,
/obj/item/clothing/accessory/collar/holo/indigestible,
/turf/simulated/floor/outdoors/dirt,
/area/submap/drgnplateu)
"l" = (
/obj/effect/decal/cleanable/ash,
/turf/simulated/floor/outdoors/dirt,
/area/submap/drgnplateu)
"m" = (
/obj/effect/decal/cleanable/molten_item,
/obj/effect/decal/cleanable/filth,
/turf/simulated/floor/outdoors/dirt,
/area/submap/drgnplateu)
"n" = (
/obj/structure/flora/grass/brown{
	pixel_x = -8;
	pixel_y = 9
	},
/obj/structure/flora/grass/green,
/obj/item/clothing/accessory/medal/solgov/gold/sun,
/obj/item/pickaxe/gold{
	pixel_x = -12;
	pixel_y = 9
	},
/obj/item/reagent_containers/food/drinks/golden_cup{
	pixel_x = -10;
	pixel_y = -5
	},
/turf/simulated/floor/outdoors/grass/sif/forest,
/area/submap/drgnplateu)
"o" = (
/obj/item/digestion_remains/ribcage,
/obj/item/digestion_remains{
	pixel_x = 8;
	pixel_y = 7
	},
/obj/effect/decal/cleanable/filth,
/turf/simulated/floor/outdoors/dirt,
/area/submap/drgnplateu)
"p" = (
/obj/structure/cliff/automatic{
	dir = 2
	},
/turf/simulated/floor/outdoors/dirt,
/area/submap/drgnplateu)
"q" = (
/turf/simulated/floor/lava{
	nitrogen = 93.7835;
	oxygen = 20.7263;
	temperature = 243.15
	},
/area/submap/drgnplateu)
"r" = (
/obj/item/digestion_remains/ribcage,
/obj/item/digestion_remains/ribcage{
	pixel_x = 9;
	pixel_y = 14
	},
/turf/simulated/floor/outdoors/dirt,
/area/submap/drgnplateu)
"s" = (
/obj/item/digestion_remains/ribcage,
/obj/item/digestion_remains{
	pixel_x = 19;
	pixel_y = 1
	},
/obj/effect/decal/cleanable/filth,
/turf/simulated/floor/outdoors/dirt,
/area/submap/drgnplateu)
"t" = (
/obj/effect/decal/remains,
/obj/effect/decal/cleanable/blood,
/obj/effect/decal/cleanable/filth,
/turf/simulated/floor/outdoors/dirt,
/area/submap/drgnplateu)
"u" = (
/obj/structure/cliff/automatic{
	dir = 8
	},
/turf/simulated/floor/outdoors/dirt,
/area/submap/drgnplateu)
"v" = (
/obj/effect/decal/remains,
/turf/template_noop,
/area/template_noop)
"x" = (
/obj/structure/flora/grass/brown{
	pixel_x = -10;
	pixel_y = 5
	},
/obj/structure/flora/grass/green{
	pixel_y = -11
	},
/obj/structure/flora/grass/green{
	pixel_x = -8
	},
/obj/item/clothing/gloves/ring/material/gold,
/obj/item/clothing/ears/earring/stud/gold,
/obj/item/gun/projectile/deagle/gold{
	pixel_x = -11;
	pixel_y = -22
	},
/turf/simulated/floor/outdoors/grass/sif/forest,
/area/submap/drgnplateu)
"y" = (
/obj/item/digestion_remains/skull/unknown/anthro,
/turf/simulated/floor/outdoors/dirt,
/area/submap/drgnplateu)
"z" = (
/turf/simulated/floor/outdoors/grass/sif/forest,
/area/submap/drgnplateu)
"A" = (
/obj/structure/flora/grass/brown{
	pixel_y = 13
	},
/obj/structure/flora/grass/green,
/obj/item/clothing/accessory/bracelet/material/gold{
	pixel_x = -7;
	pixel_y = 20
	},
/obj/item/clothing/ears/earring/dangle/gold,
/obj/item/instrument/violin/golden{
	pixel_x = 7
	},
/obj/item/flame/lighter/zippo/gold,
/turf/simulated/floor/outdoors/grass/sif/forest,
/area/submap/drgnplateu)
"B" = (
/obj/item/digestion_remains,
/obj/effect/decal/cleanable/filth,
/turf/simulated/floor/outdoors/dirt,
/area/submap/drgnplateu)
"C" = (
/obj/effect/gibspawner/human,
/turf/simulated/floor/outdoors/dirt,
/area/submap/drgnplateu)
"D" = (
/obj/structure/cliff/automatic{
	dir = 4
	},
/turf/simulated/floor/outdoors/dirt,
/area/submap/drgnplateu)
"E" = (
/obj/item/material/twohanded/baseballbat/gold,
/turf/simulated/floor/outdoors/grass/sif/forest,
/area/submap/drgnplateu)
"F" = (
/obj/structure/cliff/automatic{
	dir = 6
	},
/turf/simulated/floor/outdoors/dirt,
/area/submap/drgnplateu)
"G" = (
/obj/effect/landmark/loot_spawn,
/turf/simulated/floor/outdoors/dirt,
/area/submap/drgnplateu)
"H" = (
/obj/structure/cliff/automatic{
	dir = 10
	},
/turf/simulated/floor/outdoors/dirt,
/area/submap/drgnplateu)
"J" = (
/obj/structure/cliff/automatic/corner{
	dir = 9
	},
/turf/simulated/floor/outdoors/dirt,
/area/submap/drgnplateu)
"K" = (
/obj/structure/outcrop/gold,
/turf/simulated/floor/outdoors/dirt,
/area/submap/drgnplateu)
"L" = (
/turf/template_noop,
/area/template_noop)
"M" = (
/obj/effect/landmark/loot_spawn,
/obj/effect/decal/cleanable/blood,
/turf/simulated/floor/outdoors/dirt,
/area/submap/drgnplateu)
"N" = (
/obj/effect/decal/remains,
/obj/effect/decal/cleanable/blood/tracks{
	color = "red";
	desc = "Your instincts say you shouldn't be following these.";
	dir = 4;
	icon = 'icons/effects/blood.dmi';
	icon_state = "tracks"
	},
/turf/simulated/floor/outdoors/dirt,
/area/submap/drgnplateu)
"O" = (
/obj/item/clothing/accessory/collar/fluff/goldenstring,
/obj/effect/decal/cleanable/liquid_fuel,
/turf/simulated/floor/outdoors/dirt,
/area/submap/drgnplateu)
"P" = (
/obj/effect/decal/cleanable/blood,
/turf/simulated/floor/outdoors/dirt,
/area/submap/drgnplateu)
"Q" = (
/obj/effect/decal/remains,
/obj/effect/decal/cleanable/blood,
/obj/effect/decal/cleanable/ash,
/turf/simulated/floor/outdoors/dirt,
/area/submap/drgnplateu)
"S" = (
/turf/simulated/mineral/ignore_mapgen,
/area/submap/drgnplateu)
"T" = (
/obj/item/digestion_remains/skull/zorren,
/obj/item/clothing/accessory/collar/holo/indigestible,
/turf/simulated/floor/outdoors/dirt,
/area/submap/drgnplateu)
"U" = (
/obj/item/digestion_remains/skull/unknown/anthro,
/obj/item/digestion_remains/ribcage,
/obj/effect/decal/cleanable/liquid_fuel,
/turf/simulated/floor/outdoors/dirt,
/area/submap/drgnplateu)
"V" = (
/obj/effect/decal/cleanable/liquid_fuel,
/turf/simulated/floor/outdoors/dirt,
/area/submap/drgnplateu)
"W" = (
/obj/structure/cliff/automatic/ramp{
	dir = 9
	},
/turf/simulated/floor/outdoors/dirt,
/area/submap/drgnplateu)
"X" = (
/obj/effect/decal/cleanable/filth,
/turf/simulated/floor/outdoors/dirt,
/area/submap/drgnplateu)
"Y" = (
/obj/effect/landmark/loot_spawn/low,
/turf/simulated/floor/outdoors/dirt,
/area/submap/drgnplateu)
"Z" = (
/obj/item/digestion_remains/skull/akula,
/obj/effect/decal/cleanable/liquid_fuel,
/turf/simulated/floor/outdoors/dirt,
/area/submap/drgnplateu)

(1,1,1) = {"
L
L
L
L
L
L
L
L
L
L
L
L
L
L
L
L
L
L
L
L
L
L
L
L
L
L
L
L
L
L
L
L
L
L
L
L
L
L
L
L
L
L
L
L
L
L
L
"}
(2,1,1) = {"
L
L
L
L
L
L
L
L
L
L
L
L
L
L
L
L
L
L
L
L
L
L
L
L
L
L
L
L
L
L
L
L
L
L
L
L
L
L
L
L
L
L
L
L
L
L
L
"}
(3,1,1) = {"
L
L
L
L
L
L
L
L
L
L
L
L
L
L
L
L
L
L
L
L
L
L
L
L
L
L
L
L
L
L
L
L
L
L
L
L
L
L
L
L
L
L
L
L
L
L
L
"}
(4,1,1) = {"
L
L
L
L
L
L
L
L
L
L
L
L
L
q
q
q
q
q
q
q
q
q
q
q
q
q
q
q
q
q
q
q
q
q
q
q
q
q
q
q
q
L
L
L
L
L
L
"}
(5,1,1) = {"
L
L
L
L
L
L
L
L
L
q
q
q
q
q
q
q
q
q
q
q
q
q
q
q
q
q
q
q
q
q
q
q
q
q
q
q
q
q
q
q
q
q
L
L
L
L
L
"}
(6,1,1) = {"
L
L
L
L
L
L
L
L
L
q
q
q
q
q
q
q
q
q
q
q
q
q
q
q
q
q
q
q
q
q
q
q
q
q
q
q
q
q
q
q
q
q
q
q
q
q
q
"}
(7,1,1) = {"
L
L
L
L
L
L
L
L
L
q
q
q
q
q
q
q
a
a
a
a
a
a
a
a
a
a
a
a
a
a
a
a
a
a
a
a
a
a
q
q
q
q
q
q
q
q
q
"}
(8,1,1) = {"
L
L
L
L
L
L
L
L
L
q
q
q
a
a
a
a
a
a
a
a
a
a
a
a
a
a
a
a
a
a
a
a
a
a
a
a
a
a
a
q
q
q
q
q
q
q
q
"}
(9,1,1) = {"
L
L
L
L
L
L
L
L
L
q
q
q
a
a
a
a
a
a
S
S
a
a
a
a
a
a
S
S
S
a
a
a
a
a
a
a
a
a
a
a
a
a
a
a
q
q
q
"}
(10,1,1) = {"
L
L
L
L
L
L
q
q
q
q
q
q
a
a
a
a
a
S
S
S
S
a
a
a
a
S
S
S
S
S
S
a
a
a
a
a
a
a
a
a
a
a
a
a
q
q
q
"}
(11,1,1) = {"
L
L
L
L
L
L
q
q
q
q
q
a
a
a
a
a
a
S
S
S
S
a
a
a
a
a
S
S
S
S
S
a
a
a
a
a
a
a
a
a
a
a
a
a
q
q
q
"}
(12,1,1) = {"
L
L
L
L
L
L
q
q
q
q
a
a
a
a
a
a
a
a
S
S
a
l
a
a
a
a
a
S
S
S
G
a
a
a
a
S
a
a
a
a
a
a
a
a
q
q
q
"}
(13,1,1) = {"
L
L
L
L
L
L
q
q
q
a
a
a
a
a
a
a
a
a
a
a
k
a
Y
a
a
a
l
a
a
a
a
a
a
a
S
S
S
a
a
a
a
a
a
a
q
q
q
"}
(14,1,1) = {"
L
L
L
L
L
L
q
a
a
a
a
a
a
a
a
a
a
a
a
a
a
a
a
O
a
a
a
a
a
a
a
a
a
S
S
S
S
S
a
a
a
a
a
a
q
q
q
"}
(15,1,1) = {"
L
L
L
L
L
L
a
a
a
a
a
S
a
a
a
r
a
a
m
l
a
V
t
a
l
K
X
a
l
a
a
a
a
S
S
S
S
S
S
a
a
a
a
a
q
q
q
"}
(16,1,1) = {"
L
L
L
L
L
a
a
a
a
S
S
S
S
a
y
a
a
a
a
Z
a
a
a
a
a
a
a
a
a
K
a
a
a
a
S
S
S
S
S
S
a
a
a
a
q
q
q
"}
(17,1,1) = {"
L
L
L
L
a
a
a
a
a
S
S
S
S
a
a
a
f
a
B
V
U
a
a
K
a
i
u
u
H
a
a
a
a
a
a
a
S
S
S
S
a
a
a
a
q
q
q
"}
(18,1,1) = {"
L
L
L
L
a
a
a
a
a
a
S
S
S
S
a
a
a
V
a
a
b
t
V
W
u
J
d
A
p
a
Y
a
K
a
a
a
a
S
S
a
a
a
a
a
q
q
q
"}
(19,1,1) = {"
L
L
L
L
L
a
a
a
a
a
S
S
S
S
a
a
a
a
a
V
a
j
a
a
z
E
x
n
p
a
a
K
a
a
a
a
a
a
a
a
a
a
a
a
q
q
q
"}
(20,1,1) = {"
L
L
L
L
L
L
a
a
a
a
a
S
S
a
a
a
a
c
a
C
a
a
a
h
D
D
D
D
F
a
a
a
a
a
a
a
a
a
a
a
a
a
a
a
q
q
q
"}
(21,1,1) = {"
L
L
L
L
L
L
q
a
a
a
a
a
a
a
a
a
a
a
a
a
y
V
a
a
K
K
a
a
a
a
a
Y
a
a
a
a
a
a
a
a
a
a
a
a
q
q
q
"}
(22,1,1) = {"
L
L
L
L
L
L
q
q
a
a
a
a
a
a
a
a
e
a
a
a
a
a
V
a
a
a
K
K
a
P
a
K
a
a
a
a
a
a
a
a
a
a
a
a
q
q
q
"}
(23,1,1) = {"
L
L
L
L
L
L
q
q
a
a
a
a
a
a
a
P
a
a
T
X
a
a
s
a
a
a
Q
a
a
N
a
a
a
a
a
a
a
a
a
a
a
a
a
q
q
q
q
"}
(24,1,1) = {"
L
L
L
L
L
L
q
q
q
a
a
a
a
a
a
S
S
a
a
a
M
a
a
a
o
a
l
Q
a
a
a
a
a
a
a
a
a
a
a
a
a
a
q
q
q
q
q
"}
(25,1,1) = {"
L
L
L
L
L
L
q
q
q
a
a
a
a
a
a
S
S
S
a
a
a
a
a
X
a
a
a
l
a
a
l
a
G
a
a
a
a
a
a
a
a
q
q
q
q
q
q
"}
(26,1,1) = {"
L
L
L
L
L
L
q
q
q
q
a
a
a
a
S
S
S
S
S
a
a
a
a
a
a
a
X
a
g
a
S
S
S
a
a
a
a
a
a
a
a
q
q
q
q
L
L
"}
(27,1,1) = {"
L
L
L
L
L
L
q
q
q
q
q
a
a
a
S
S
S
S
S
S
a
a
a
a
a
a
a
P
a
S
S
S
S
a
a
a
a
a
a
q
q
q
q
q
L
L
L
"}
(28,1,1) = {"
L
L
L
L
L
L
q
q
q
q
q
q
a
a
a
S
S
S
S
S
a
a
a
a
a
a
a
a
S
S
S
S
S
a
a
a
a
a
q
q
q
q
q
q
L
L
L
"}
(29,1,1) = {"
L
L
L
L
L
L
L
L
L
q
q
q
a
a
a
a
S
S
S
S
S
a
a
a
a
a
a
S
S
S
S
S
a
a
a
a
a
q
q
q
q
q
q
q
L
L
L
"}
(30,1,1) = {"
L
L
L
L
L
L
L
L
L
q
q
q
a
a
a
a
a
S
S
a
a
a
a
a
a
a
S
S
S
S
a
a
a
a
a
a
a
q
q
q
L
L
L
L
L
L
L
"}
(31,1,1) = {"
L
L
L
L
L
L
L
L
L
q
q
q
a
a
a
a
a
a
a
a
a
a
a
a
a
a
S
S
S
a
a
a
a
a
a
a
a
q
q
q
L
L
L
L
L
L
L
"}
(32,1,1) = {"
L
L
L
L
L
L
L
L
L
q
q
q
q
a
a
a
a
a
a
a
a
a
a
a
a
a
a
a
a
a
a
a
a
a
a
a
a
q
q
q
L
L
L
v
L
L
L
"}
(33,1,1) = {"
L
L
L
L
L
L
L
L
L
q
q
q
q
q
a
a
a
a
a
a
a
a
a
a
a
a
a
a
a
a
a
a
q
q
q
q
q
q
q
q
L
L
L
L
L
L
L
"}
(34,1,1) = {"
L
L
L
L
L
L
L
L
L
q
q
q
q
q
a
a
a
a
a
a
a
a
a
a
a
a
a
a
a
a
q
q
q
q
q
q
q
q
q
q
L
L
L
L
L
L
L
"}
(35,1,1) = {"
L
L
L
L
L
L
L
L
L
L
L
L
q
q
q
a
a
a
a
a
a
a
a
a
a
a
a
a
a
q
q
q
q
q
q
q
q
q
q
q
L
L
L
L
L
L
L
"}
(36,1,1) = {"
L
L
L
L
L
L
L
L
L
L
L
L
q
q
q
q
q
q
q
q
q
q
q
q
q
q
q
q
q
q
q
q
L
L
L
L
L
L
L
L
L
L
L
L
L
L
L
"}
(37,1,1) = {"
L
L
L
L
L
L
L
L
L
L
L
L
q
q
q
q
q
q
q
q
q
q
q
q
q
q
q
q
q
q
q
q
L
L
L
L
L
L
L
L
L
L
L
L
L
L
L
"}
(38,1,1) = {"
L
L
L
L
L
L
L
L
L
L
L
L
q
q
q
q
q
q
q
q
q
q
q
q
q
q
q
q
q
q
q
q
L
L
L
L
L
L
L
L
L
L
L
L
L
L
L
"}
