//MAP CONVERTED BY dmm2tgm.py THIS HEADER COMMENT PREVENTS RECONVERSION, DO NOT REMOVE
"a" = (
/turf/template_noop,
/area/template_noop)
"c" = (
/obj/effect/floor_decal/rust,
/turf/simulated/floor{
	nitrogen = 93.7835;
	oxygen = 20.7263;
	temperature = 243.15
	},
/area/submap/Hadzardzone)
"d" = (
/obj/structure/safe,
/obj/item/spacecash/c1000,
/obj/item/spacecash/c1000,
/obj/item/spacecash/c1000,
/obj/item/storage/pill_bottle/healing_nanites,
/obj/item/storage/pill_bottle/rezadone,
/obj/item/storage/firstaid/experimental,
/obj/random/firstaid,
/turf/simulated/floor{
	nitrogen = 93.7835;
	oxygen = 20.7263;
	temperature = 243.15
	},
/area/submap/Hadzardzone)
"e" = (
/obj/effect/map_effect/interval/effect_emitter/smoke/fire,
/turf/simulated/floor/lava{
	nitrogen = 93.7835;
	oxygen = 20.7263;
	temperature = 243.15
	},
/area/submap/Hadzardzone)
"f" = (
/turf/simulated/wall/r_wall,
/area/submap/Hadzardzone)
"i" = (
/obj/machinery/door/airlock/external,
/turf/simulated/floor,
/area/submap/Hadzardzone)
"k" = (
/obj/effect/map_helper/no_phaseshift/area,
/turf/simulated/floor{
	nitrogen = 93.7835;
	oxygen = 20.7263;
	temperature = 243.15
	},
/area/submap/Hadzardzone)
"l" = (
/obj/effect/landmark/loot_spawn,
/obj/effect/landmark/loot_spawn,
/turf/simulated/floor{
	nitrogen = 93.7835;
	oxygen = 20.7263;
	temperature = 243.15
	},
/area/submap/Hadzardzone)
"o" = (
/obj/structure/largecrate/animal/guardmutant,
/turf/simulated/floor{
	nitrogen = 93.7835;
	oxygen = 20.7263;
	temperature = 243.15
	},
/area/submap/Hadzardzone)
"p" = (
/turf/simulated/wall/dungeon{
	blocks_nonghost_incorporeal = 1
	},
/area/submap/Hadzardzone)
"s" = (
/turf/simulated/floor/lava{
	nitrogen = 93.7835;
	oxygen = 20.7263;
	temperature = 243.15
	},
/area/submap/Hadzardzone)
"u" = (
/obj/structure/table/glass,
/obj/item/paper{
	info = "Daniel, I am done waiting. If your stuff gets stolen despite my security measures, it's on you. And you still better give me my dam money.";
	name = "Notice"
	},
/turf/simulated/floor{
	nitrogen = 93.7835;
	oxygen = 20.7263;
	temperature = 243.15
	},
/area/submap/Hadzardzone)
"w" = (
/turf/template_noop,
/area/submap/Hadzardzone)
"y" = (
/turf/simulated/mineral/ignore_mapgen,
/area/template_noop)
"z" = (
/obj/structure/prop/lock/projectile{
	pixel_y = 6
	},
/turf/simulated/floor{
	nitrogen = 93.7835;
	oxygen = 20.7263;
	temperature = 243.15
	},
/area/submap/Hadzardzone)
"B" = (
/obj/structure/largecrate/animal/teppi,
/turf/simulated/floor{
	nitrogen = 93.7835;
	oxygen = 20.7263;
	temperature = 243.15
	},
/area/submap/Hadzardzone)
"C" = (
/obj/effect/floor_decal/rust,
/obj/effect/floor_decal/rust,
/turf/simulated/floor{
	nitrogen = 93.7835;
	oxygen = 20.7263;
	temperature = 243.15
	},
/area/submap/Hadzardzone)
"G" = (
/turf/simulated/mineral/ignore_mapgen,
/area/submap/Hadzardzone)
"I" = (
/obj/structure/cable/green{
	d1 = 1;
	d2 = 2;
	icon_state = "1-2"
	},
/turf/simulated/floor{
	nitrogen = 93.7835;
	oxygen = 20.7263;
	temperature = 243.15
	},
/area/submap/Hadzardzone)
"J" = (
/obj/structure/closet/crate/secure/loot,
/turf/simulated/floor{
	nitrogen = 93.7835;
	oxygen = 20.7263;
	temperature = 243.15
	},
/area/submap/Hadzardzone)
"L" = (
/obj/structure/safe,
/obj/item/spacecash/c1000,
/obj/item/spacecash/c1000,
/obj/item/clothing/suit/space/void/merc/fire,
/obj/item/clothing/suit/space/void/altevian_heartbreaker,
/obj/item/clothing/head/helmet/space/void/merc/fire,
/obj/item/clothing/head/helmet/space/void/altevian_heartbreaker,
/obj/item/clothing/suit/space/void/merc,
/obj/item/clothing/head/helmet/space/void/merc,
/turf/simulated/floor{
	nitrogen = 93.7835;
	oxygen = 20.7263;
	temperature = 243.15
	},
/area/submap/Hadzardzone)
"M" = (
/obj/machinery/door/airlock/external,
/obj/machinery/door/blast/puzzle{
	checkrange_mult = 3;
	dir = 4;
	layer = 3.3;
	name = "Blast Door";
	open_layer = 3.3
	},
/turf/simulated/floor{
	nitrogen = 93.7835;
	oxygen = 20.7263;
	temperature = 243.15
	},
/area/submap/Hadzardzone)
"P" = (
/obj/machinery/power/rtg/advanced{
	component_parts = list(/obj/item/stack/cable_coil=5,/obj/item/stock_parts/capacitor/omni=1,/obj/item/stock_parts/micro_laser/omni=1,/obj/item/stack/material/uranium=10,/obj/item/stack/material/phoron=5)
	},
/obj/structure/cable/green{
	d2 = 2;
	icon_state = "0-2"
	},
/turf/simulated/floor{
	nitrogen = 93.7835;
	oxygen = 20.7263;
	temperature = 243.15
	},
/area/submap/Hadzardzone)
"U" = (
/obj/machinery/power/emitter{
	anchored = 1;
	dir = 1;
	state = 1
	},
/obj/structure/cable/green{
	d2 = 2;
	icon_state = "0-2"
	},
/turf/simulated/floor{
	nitrogen = 93.7835;
	oxygen = 20.7263;
	temperature = 243.15
	},
/area/submap/Hadzardzone)
"W" = (
/turf/simulated/floor{
	nitrogen = 93.7835;
	oxygen = 20.7263;
	temperature = 243.15
	},
/area/submap/Hadzardzone)
"X" = (
/obj/structure/cable/green{
	d1 = 1;
	d2 = 4;
	icon_state = "1-4"
	},
/obj/structure/cable/green{
	d1 = 1;
	d2 = 8;
	icon_state = "1-8"
	},
/turf/simulated/floor{
	nitrogen = 93.7835;
	oxygen = 20.7263;
	temperature = 243.15
	},
/area/submap/Hadzardzone)
"Z" = (
/obj/effect/landmark/loot_spawn,
/turf/simulated/floor{
	nitrogen = 93.7835;
	oxygen = 20.7263;
	temperature = 243.15
	},
/area/submap/Hadzardzone)

(1,1,1) = {"
a
a
a
a
a
a
a
a
a
a
y
y
y
y
y
y
a
a
a
a
a
a
a
a
a
a
a
a
a
a
a
a
a
a
a
"}
(2,1,1) = {"
a
a
a
a
a
a
a
a
a
y
y
y
y
y
y
y
y
a
a
a
y
y
y
y
y
a
a
a
a
a
a
a
a
a
a
"}
(3,1,1) = {"
a
a
a
a
a
a
a
y
y
y
y
y
y
y
y
y
y
y
y
y
y
y
y
y
y
y
a
a
a
a
a
a
a
a
a
"}
(4,1,1) = {"
a
a
a
a
a
a
G
G
G
G
G
G
G
G
G
G
G
G
G
G
G
G
G
G
G
G
G
w
a
a
a
a
a
a
a
"}
(5,1,1) = {"
a
a
a
a
a
a
G
G
G
G
G
G
G
G
G
G
G
G
G
G
G
G
G
G
G
G
G
G
a
a
a
a
a
a
a
"}
(6,1,1) = {"
a
a
a
a
a
y
G
G
G
G
G
G
p
p
p
p
p
p
p
G
G
G
G
G
G
G
G
G
y
a
a
a
a
a
a
"}
(7,1,1) = {"
a
a
a
a
a
y
G
G
G
G
G
G
p
d
W
W
W
Z
p
G
G
G
G
G
G
G
G
G
y
a
a
a
a
a
a
"}
(8,1,1) = {"
a
a
a
a
a
y
G
G
G
G
G
G
p
Z
W
W
W
J
p
G
G
G
G
G
G
G
G
G
y
y
a
a
a
a
a
"}
(9,1,1) = {"
a
a
a
a
a
y
G
G
G
G
G
G
p
B
W
W
W
l
p
G
G
G
G
G
G
G
G
G
y
y
y
a
a
a
a
"}
(10,1,1) = {"
a
a
a
a
a
y
G
G
G
G
G
G
p
p
p
M
p
p
p
G
G
G
G
G
G
G
G
G
y
y
y
a
a
a
a
"}
(11,1,1) = {"
a
a
a
a
a
a
G
G
G
G
G
f
f
s
W
W
c
s
f
f
G
G
G
G
G
G
G
G
y
y
y
a
a
a
a
"}
(12,1,1) = {"
a
a
a
a
a
a
G
G
G
G
f
f
s
s
W
W
W
s
s
f
f
G
G
G
G
G
G
G
y
y
a
a
a
a
a
"}
(13,1,1) = {"
a
a
a
a
a
a
G
G
G
f
f
s
s
c
W
W
W
s
s
s
f
f
G
G
G
G
G
G
y
a
a
a
a
a
a
"}
(14,1,1) = {"
a
a
a
a
a
a
G
G
f
f
s
s
s
W
W
c
W
W
s
s
e
f
f
G
G
G
G
G
a
a
a
a
a
a
a
"}
(15,1,1) = {"
a
a
a
a
a
a
G
f
f
s
s
s
c
W
W
W
W
W
W
s
s
s
f
f
G
G
G
w
a
a
a
a
a
a
a
"}
(16,1,1) = {"
a
a
a
a
a
a
G
f
s
s
s
s
W
c
W
W
W
c
W
c
s
s
s
f
G
G
W
w
a
a
a
a
a
a
a
"}
(17,1,1) = {"
a
a
a
a
a
y
G
f
s
s
s
s
W
W
W
s
W
W
W
W
W
W
c
f
G
W
W
W
a
a
a
a
a
a
a
"}
(18,1,1) = {"
a
a
a
a
a
y
G
f
z
e
s
s
U
X
s
s
s
f
P
I
W
W
W
i
W
W
W
W
a
a
a
a
a
a
a
"}
(19,1,1) = {"
a
a
a
a
y
y
G
f
s
s
s
s
W
W
W
s
W
W
W
W
c
W
W
f
W
W
W
W
a
a
a
a
a
a
a
"}
(20,1,1) = {"
a
a
a
a
y
y
G
f
s
s
s
s
c
W
k
W
W
W
c
W
s
s
s
f
G
u
W
w
a
a
a
a
a
a
a
"}
(21,1,1) = {"
a
a
a
a
a
y
G
f
f
s
s
s
W
c
W
W
c
W
W
s
s
s
f
f
G
W
W
w
a
a
a
a
a
a
a
"}
(22,1,1) = {"
a
a
a
a
a
y
G
G
f
f
s
s
s
W
W
W
k
W
s
s
e
f
f
G
G
G
w
w
a
a
a
a
a
a
a
"}
(23,1,1) = {"
a
a
a
a
y
y
G
G
G
f
f
s
s
W
W
W
c
s
s
s
f
f
G
G
G
G
G
G
a
a
a
a
a
a
a
"}
(24,1,1) = {"
a
a
a
a
y
y
G
G
G
G
f
f
s
s
C
W
W
s
s
f
f
G
G
G
G
G
G
G
y
a
a
a
a
a
a
"}
(25,1,1) = {"
a
a
a
a
y
y
G
G
G
G
G
f
f
s
W
W
c
s
f
f
G
G
G
G
G
G
G
G
y
y
a
a
a
a
a
"}
(26,1,1) = {"
a
a
a
a
y
y
G
G
G
G
G
G
p
p
p
M
p
p
p
G
G
G
G
G
G
G
G
G
y
y
y
a
a
a
a
"}
(27,1,1) = {"
a
a
a
a
a
y
G
G
G
G
G
G
p
Z
W
W
W
o
p
G
G
G
G
G
G
G
G
G
y
y
y
a
a
a
a
"}
(28,1,1) = {"
a
a
a
a
a
y
G
G
G
G
G
G
p
J
W
W
W
Z
p
G
G
G
G
G
G
G
G
G
y
y
y
a
a
a
a
"}
(29,1,1) = {"
a
a
a
a
a
a
G
G
G
G
G
G
p
Z
W
W
W
L
p
G
G
G
G
G
G
G
G
G
y
y
y
a
a
a
a
"}
(30,1,1) = {"
a
a
a
a
a
a
G
G
G
G
G
G
p
p
p
p
p
p
p
G
G
G
G
G
G
G
G
G
y
y
y
a
a
a
a
"}
(31,1,1) = {"
a
a
a
a
a
a
G
G
G
G
G
G
G
G
G
G
G
G
G
G
G
G
G
G
G
G
G
G
y
y
a
a
a
a
a
"}
(32,1,1) = {"
a
a
a
a
a
a
G
G
G
G
G
G
G
G
G
G
G
G
G
G
G
G
G
G
G
G
G
G
y
a
a
a
a
a
a
"}
(33,1,1) = {"
a
a
a
a
a
a
a
y
y
y
y
y
y
y
y
y
y
y
y
y
y
y
y
y
y
y
y
y
y
a
a
a
a
a
a
"}
(34,1,1) = {"
a
a
a
a
a
a
a
a
y
y
y
y
y
y
y
a
a
a
y
y
y
y
y
y
y
y
y
y
a
a
a
a
a
a
a
"}
(35,1,1) = {"
a
a
a
a
a
a
a
a
y
y
y
y
a
a
a
a
a
a
a
a
a
y
y
y
y
y
a
a
a
a
a
a
a
a
a
"}
