//MAP CONVERTED BY dmm2tgm.py THIS HEADER COMMENT PREVENTS RECONVERSION, DO NOT REMOVE
"a" = (
/turf/template_noop,
/area/template_noop)
"c" = (
/obj/structure/table/woodentable,
/turf/simulated/floor/wood/turfpack/sif,
/area/submap/PirateLake)
"d" = (
/obj/structure/table/woodentable{
	dir = 4;
	flipped = 1;
	icon_state = "wood_flip0"
	},
/turf/simulated/floor/wood/turfpack/sif,
/area/submap/PirateLake)
"i" = (
/turf/simulated/floor/wood/turfpack/sif,
/area/submap/PirateLake)
"l" = (
/obj/structure/table/woodentable,
/obj/item/storage/fancy/candle_box,
/turf/simulated/floor/wood/turfpack/sif,
/area/submap/PirateLake)
"n" = (
/obj/structure/curtain/open/bed,
/turf/simulated/floor/wood/turfpack/sif,
/area/submap/PirateLake)
"o" = (
/obj/structure/table/bench/sifwooden,
/mob/living/simple_mob/humanoid/pirate/mate/ranged/rifle,
/turf/simulated/floor/wood/turfpack/sif,
/area/submap/PirateLake)
"p" = (
/obj/structure/closet,
/obj/item/contraband,
/obj/random/maintenance/foodstuff,
/obj/random/maintenance/foodstuff,
/obj/random/maintenance/foodstuff,
/obj/random/maintenance/foodstuff,
/obj/random/maintenance/foodstuff,
/obj/random/maintenance/foodstuff,
/obj/random/maintenance/foodstuff,
/turf/simulated/floor/wood/turfpack/sif,
/area/submap/PirateLake)
"s" = (
/obj/structure/table/woodentable,
/obj/item/flame/candle/candelabra,
/turf/simulated/floor/wood/turfpack/sif,
/area/submap/PirateLake)
"t" = (
/obj/structure/table/woodentable{
	dir = 8;
	flipped = 1;
	icon_state = "wood_flip0"
	},
/turf/simulated/floor/wood/turfpack/sif,
/area/submap/PirateLake)
"u" = (
/obj/structure/loot_pile/mecha/ripley/pirate,
/turf/simulated/floor/wood/turfpack/sif,
/area/submap/PirateLake)
"v" = (
/obj/structure/table/bench/sifwooden,
/mob/living/simple_mob/humanoid/pirate/ranged,
/turf/simulated/floor/wood/turfpack/sif,
/area/submap/PirateLake)
"x" = (
/turf/simulated/floor/outdoors/rocks/sif/planetuse,
/area/submap/PirateLake)
"z" = (
/turf/template_noop,
/area/submap/PirateLake)
"C" = (
/obj/structure/table/woodentable{
	flipped = 1;
	icon_state = "wood_flip0"
	},
/turf/simulated/floor/wood/turfpack/sif,
/area/submap/PirateLake)
"D" = (
/obj/structure/table/bench/sifwooden,
/mob/living/simple_mob/humanoid/pirate/las,
/turf/simulated/floor/wood/turfpack/sif,
/area/submap/PirateLake)
"I" = (
/turf/simulated/floor/water/deep,
/area/submap/PirateLake)
"J" = (
/turf/simulated/floor/outdoors/grass/sif/forest,
/area/submap/PirateLake)
"K" = (
/turf/simulated/wall/wood,
/area/submap/PirateLake)
"L" = (
/obj/structure/closet,
/obj/item/clothing/suit/space/pirate,
/obj/item/clothing/suit/space/pirate,
/obj/item/clothing/head/helmet/space/pirate,
/obj/item/clothing/head/helmet/space/pirate,
/turf/simulated/floor/wood/turfpack/sif,
/area/submap/PirateLake)
"N" = (
/obj/structure/table/woodentable,
/obj/structure/safe/floor,
/obj/item/gun/projectile/deagle/gold,
/obj/item/soap/golden_soap,
/obj/item/reagent_containers/food/drinks/golden_cup,
/obj/item/toy/plushie/dragon/gold_east,
/obj/item/slime_extract/gold,
/turf/simulated/floor/wood/turfpack/sif,
/area/submap/PirateLake)
"Q" = (
/obj/structure/closet/crate/secure/loot,
/turf/simulated/floor/wood/turfpack/sif,
/area/submap/PirateLake)
"R" = (
/obj/structure/table/woodentable{
	dir = 1;
	flipped = 1;
	icon_state = "wood_flip0"
	},
/turf/simulated/floor/wood/turfpack/sif,
/area/submap/PirateLake)
"T" = (
/turf/simulated/floor/water,
/area/submap/PirateLake)
"X" = (
/obj/structure/table/bench/sifwooden,
/turf/simulated/floor/wood/turfpack/sif,
/area/submap/PirateLake)

(1,1,1) = {"
a
a
a
a
a
a
a
a
a
a
a
a
a
a
a
a
a
a
a
a
a
a
a
a
a
a
a
a
a
a
a
a
a
a
a
a
a
a
a
a
"}
(2,1,1) = {"
a
z
z
z
z
z
z
z
z
z
z
z
x
x
x
x
x
x
x
x
z
z
z
z
z
z
z
z
z
z
z
z
z
z
z
z
z
z
z
a
"}
(3,1,1) = {"
a
z
z
z
z
z
z
z
x
x
x
x
x
T
T
T
T
T
T
x
x
z
z
z
z
z
z
z
z
z
z
z
z
z
z
z
z
z
z
a
"}
(4,1,1) = {"
a
z
z
z
z
z
z
x
x
T
T
T
T
T
T
T
T
T
T
T
x
x
x
x
x
x
z
z
z
z
z
z
z
z
z
z
z
z
z
a
"}
(5,1,1) = {"
a
z
z
z
z
z
x
x
T
T
T
T
T
T
T
T
T
T
T
T
T
T
T
T
T
x
x
x
z
z
z
z
z
z
z
z
z
z
z
a
"}
(6,1,1) = {"
a
z
z
z
x
x
x
T
T
T
T
T
T
I
I
I
I
I
I
T
T
T
T
T
T
T
T
x
x
x
z
z
z
z
z
z
z
z
z
a
"}
(7,1,1) = {"
a
z
z
x
x
T
T
T
T
I
I
I
I
I
I
I
I
I
I
I
T
T
T
T
T
T
T
T
T
x
x
x
x
z
z
z
z
z
z
a
"}
(8,1,1) = {"
a
z
z
x
T
T
T
T
I
I
I
I
I
I
I
I
I
I
I
I
I
I
I
I
I
T
T
T
T
T
T
T
x
x
z
z
z
z
z
a
"}
(9,1,1) = {"
a
z
z
x
T
T
T
I
I
I
I
I
I
I
I
I
I
I
I
I
I
I
I
I
I
I
I
T
T
T
T
T
T
x
x
z
z
z
z
a
"}
(10,1,1) = {"
a
z
x
x
T
T
T
I
I
I
I
I
I
T
T
T
T
T
T
I
I
I
I
I
I
I
I
I
I
T
T
T
T
T
x
x
z
z
z
a
"}
(11,1,1) = {"
a
z
x
T
T
T
I
I
I
I
I
T
T
T
T
T
T
T
T
T
I
I
I
I
I
I
I
I
I
I
I
I
T
T
T
x
z
z
z
a
"}
(12,1,1) = {"
a
z
x
T
T
T
I
I
I
I
T
T
T
x
x
x
x
x
x
T
T
T
I
I
I
I
I
I
I
I
I
I
T
T
T
x
x
z
z
a
"}
(13,1,1) = {"
a
x
x
T
T
T
I
I
I
T
T
x
x
x
J
J
J
J
x
x
T
T
T
T
I
I
I
I
I
I
I
I
I
T
T
T
x
x
z
a
"}
(14,1,1) = {"
a
x
T
T
T
I
I
I
T
T
x
x
J
K
t
t
t
t
K
x
x
x
T
T
T
T
I
I
I
I
I
I
I
I
T
T
T
x
z
a
"}
(15,1,1) = {"
a
x
T
T
T
I
I
I
T
T
x
J
J
K
i
v
i
i
K
J
J
x
x
x
T
T
T
I
I
I
I
I
I
I
T
T
T
x
x
a
"}
(16,1,1) = {"
a
x
T
T
I
I
I
T
T
x
x
J
J
K
i
i
i
i
K
J
J
J
J
x
x
x
T
T
T
I
I
I
I
I
I
T
T
T
x
a
"}
(17,1,1) = {"
a
x
T
T
I
I
T
T
x
x
J
J
K
K
K
n
n
K
K
K
K
K
K
K
K
K
x
T
T
T
I
I
I
I
I
T
T
T
x
a
"}
(18,1,1) = {"
a
x
T
T
I
I
T
T
x
K
K
K
K
u
i
i
i
i
i
i
i
Q
K
i
i
C
x
x
x
T
T
I
I
I
I
T
T
T
x
a
"}
(19,1,1) = {"
a
x
T
T
I
I
T
T
x
R
i
i
K
i
i
i
D
i
i
i
i
i
n
i
v
C
J
J
x
T
T
I
I
I
I
T
T
T
x
a
"}
(20,1,1) = {"
a
x
T
T
I
I
T
T
x
R
v
i
n
i
i
s
c
c
i
i
i
i
n
i
i
C
J
J
x
x
T
T
I
I
I
T
T
T
x
a
"}
(21,1,1) = {"
a
x
T
T
I
I
T
T
x
R
i
i
n
i
X
c
N
c
D
i
i
Q
K
i
i
C
J
J
J
x
T
T
I
I
I
T
T
T
x
a
"}
(22,1,1) = {"
a
x
T
T
I
I
T
T
x
R
i
i
K
Q
i
c
c
l
i
i
K
K
K
K
K
K
J
J
J
x
T
T
I
I
I
T
T
T
x
a
"}
(23,1,1) = {"
a
x
T
T
I
I
T
T
x
K
K
K
K
p
i
i
X
i
i
i
n
i
i
i
i
K
J
J
x
x
T
T
I
I
I
T
T
T
x
a
"}
(24,1,1) = {"
a
x
T
T
I
I
I
T
T
x
J
J
K
p
i
i
i
i
i
i
K
c
c
c
i
K
J
J
x
T
T
I
I
I
I
T
T
T
x
a
"}
(25,1,1) = {"
a
x
T
T
I
I
I
T
T
x
x
J
K
K
K
n
n
K
K
K
K
i
o
c
i
K
J
J
x
T
T
I
I
I
I
T
T
T
x
a
"}
(26,1,1) = {"
a
x
T
T
T
I
I
I
T
T
x
J
J
K
i
i
i
i
K
K
K
L
i
i
i
K
x
x
x
T
T
I
I
I
I
T
T
T
x
a
"}
(27,1,1) = {"
a
x
T
T
T
I
I
I
T
T
x
J
J
K
i
i
v
i
K
K
K
K
K
K
K
K
x
T
T
T
I
I
I
I
T
T
T
x
x
a
"}
(28,1,1) = {"
a
x
x
T
T
T
I
I
T
T
x
x
J
K
d
d
d
d
K
K
J
J
x
x
x
T
T
T
T
I
I
I
I
I
T
T
T
x
z
a
"}
(29,1,1) = {"
a
z
x
T
T
T
I
I
I
T
T
x
J
J
J
J
J
J
J
x
x
x
x
T
T
T
T
I
I
I
I
I
T
T
T
x
x
x
z
a
"}
(30,1,1) = {"
a
z
x
x
T
T
T
I
I
T
T
x
x
x
x
x
J
J
x
x
T
T
T
T
T
I
I
I
I
I
I
I
T
T
T
x
z
z
z
a
"}
(31,1,1) = {"
a
z
z
x
x
T
T
T
I
I
T
T
T
T
T
x
x
x
x
T
T
T
T
I
I
I
I
I
I
I
I
T
T
T
x
x
z
z
z
a
"}
(32,1,1) = {"
a
z
z
z
x
T
T
T
I
I
I
T
T
T
T
T
T
T
T
T
I
I
I
I
I
I
I
I
I
I
T
T
T
x
x
z
z
z
z
a
"}
(33,1,1) = {"
a
z
z
z
x
x
T
T
T
I
I
I
I
I
I
T
T
T
T
I
I
I
I
I
I
I
I
I
I
I
T
T
T
x
z
z
z
z
z
a
"}
(34,1,1) = {"
a
z
z
z
z
x
T
T
T
I
I
I
I
I
I
I
I
I
I
I
I
I
I
I
I
I
I
T
T
T
T
T
T
x
z
z
z
z
z
a
"}
(35,1,1) = {"
a
z
z
z
z
x
x
T
T
T
T
I
I
T
T
T
T
T
T
T
T
I
I
I
T
T
T
T
T
T
T
T
x
x
z
z
z
z
z
a
"}
(36,1,1) = {"
a
z
z
z
z
z
x
x
T
T
T
T
T
T
T
T
T
T
T
T
T
T
T
T
T
T
T
T
T
T
x
x
x
z
z
z
z
z
z
a
"}
(37,1,1) = {"
a
z
z
z
z
z
z
x
x
T
T
T
T
T
T
T
T
T
T
T
T
T
T
T
T
T
T
x
x
x
x
z
z
z
z
z
z
z
z
a
"}
(38,1,1) = {"
a
z
z
z
z
z
z
z
x
x
x
T
T
x
x
x
x
x
x
x
x
T
T
T
x
x
x
x
z
z
z
z
z
z
z
z
z
z
z
a
"}
(39,1,1) = {"
a
z
z
z
z
z
z
z
z
z
x
x
x
x
z
z
z
z
z
z
x
x
x
x
x
z
z
z
z
z
z
z
z
z
z
z
z
z
z
a
"}
(40,1,1) = {"
a
a
a
a
a
a
a
a
a
a
a
a
a
a
a
a
a
a
a
a
a
a
a
a
a
a
a
a
a
a
a
a
a
a
a
a
a
a
a
a
"}
