//MAP CONVERTED BY dmm2tgm.py THIS HEADER COMMENT PREVENTS RECONVERSION, DO NOT REMOVE
"ac" = (
/obj/effect/floor_decal/industrial/hatch/yellow,
/obj/structure/loot_pile/mecha/durand,
/turf/simulated/floor/tiled/red,
/area/submap/MechHangar)
"af" = (
/turf/template_noop,
/area/submap/MechHangar)
"aR" = (
/obj/effect/floor_decal/corner/red/border{
	dir = 8;
	icon_state = "bordercolor"
	},
/obj/effect/decal/cleanable/dirt,
/turf/simulated/floor/tiled/dark,
/area/submap/MechHangar)
"di" = (
/obj/effect/floor_decal/corner/red/border{
	dir = 8;
	icon_state = "bordercolor"
	},
/turf/simulated/floor/tiled/dark,
/area/submap/MechHangar)
"fB" = (
/obj/effect/decal/cleanable/dirt,
/obj/structure/loot_pile/surface/bones,
/turf/simulated/floor/outdoors/rocks{
	outdoors = 0
	},
/area/submap/MechHangar)
"fL" = (
/obj/structure/table/bench/padded,
/obj/structure/loot_pile/surface/bones,
/obj/effect/floor_decal/corner/red/border,
/turf/simulated/floor/tiled/dark,
/area/submap/MechHangar)
"ha" = (
/turf/simulated/wall/r_wall,
/area/submap/MechHangar)
"hW" = (
/obj/random/outcrop,
/turf/simulated/floor/outdoors/dirt{
	outdoors = 0
	},
/area/submap/MechHangar)
"jF" = (
/obj/effect/floor_decal/industrial/hatch/yellow,
/obj/effect/decal/cleanable/dirt,
/obj/structure/loot_pile/mecha/phazon,
/turf/simulated/floor/tiled/red,
/area/submap/MechHangar)
"mP" = (
/obj/structure/boulder,
/turf/simulated/floor/tiled,
/area/submap/MechHangar)
"nC" = (
/obj/structure/filingcabinet,
/obj/effect/floor_decal/corner/red/border{
	dir = 5
	},
/turf/simulated/floor/tiled/dark,
/area/submap/MechHangar)
"ob" = (
/obj/effect/floor_decal/industrial/hatch/yellow,
/obj/structure/loot_pile/mecha/odysseus,
/turf/simulated/floor/tiled/red,
/area/submap/MechHangar)
"qr" = (
/obj/effect/decal/cleanable/dirt,
/turf/simulated/mineral/ignore_mapgen,
/area/submap/MechHangar)
"rn" = (
/obj/random/outcrop,
/turf/simulated/floor/outdoors/rocks{
	outdoors = 0
	},
/area/submap/MechHangar)
"rF" = (
/obj/effect/decal/cleanable/dirt,
/obj/effect/decal/remains,
/turf/simulated/floor/outdoors/rocks{
	outdoors = 0
	},
/area/submap/MechHangar)
"sD" = (
/turf/simulated/mineral/ignore_mapgen,
/area/submap/MechHangar)
"sX" = (
/obj/structure/boulder,
/turf/simulated/floor/outdoors/dirt{
	outdoors = 0
	},
/area/submap/MechHangar)
"tt" = (
/obj/effect/floor_decal/industrial/hatch/yellow,
/obj/random/mob/merc/armored,
/turf/simulated/floor/tiled/red,
/area/submap/MechHangar)
"tF" = (
/turf/simulated/mineral/ignore_mapgen,
/area/template_noop)
"ua" = (
/obj/effect/decal/cleanable/dirt,
/obj/effect/decal/remains,
/turf/simulated/floor/outdoors/dirt{
	outdoors = 0
	},
/area/submap/MechHangar)
"uy" = (
/turf/template_noop,
/area/template_noop)
"vy" = (
/turf/simulated/floor/outdoors/dirt{
	outdoors = 0
	},
/area/template_noop)
"vP" = (
/obj/structure/boulder,
/turf/simulated/floor/outdoors/rocks{
	outdoors = 0
	},
/area/submap/MechHangar)
"wf" = (
/obj/effect/floor_decal/corner/red/border{
	dir = 4;
	icon_state = "bordercolor"
	},
/obj/effect/decal/cleanable/dirt,
/turf/simulated/floor/tiled/dark,
/area/submap/MechHangar)
"yB" = (
/obj/effect/floor_decal/industrial/hatch/yellow,
/obj/effect/decal/mecha_wreckage/janus,
/turf/simulated/floor/tiled/red,
/area/submap/MechHangar)
"yG" = (
/obj/structure/boulder,
/turf/simulated/floor/outdoors/dirt{
	outdoors = 0
	},
/area/template_noop)
"Aj" = (
/obj/structure/boulder,
/obj/effect/decal/cleanable/dirt,
/turf/simulated/floor/outdoors/dirt{
	outdoors = 0
	},
/area/submap/MechHangar)
"AF" = (
/obj/effect/decal/remains,
/turf/simulated/floor/outdoors/dirt{
	outdoors = 0
	},
/area/submap/MechHangar)
"AW" = (
/obj/effect/floor_decal/industrial/hatch/yellow,
/obj/structure/loot_pile/mecha/marauder/mauler,
/turf/simulated/floor/tiled/red,
/area/submap/MechHangar)
"BZ" = (
/obj/structure/boulder,
/obj/effect/decal/cleanable/dirt,
/turf/simulated/floor/outdoors/rocks{
	outdoors = 0
	},
/area/submap/MechHangar)
"CO" = (
/obj/effect/decal/cleanable/dirt,
/turf/simulated/floor/tiled/dark,
/area/submap/MechHangar)
"Fd" = (
/obj/structure/filingcabinet,
/obj/effect/floor_decal/corner/red/border{
	dir = 1
	},
/turf/simulated/floor/tiled/dark,
/area/submap/MechHangar)
"FS" = (
/obj/structure/table/standard,
/obj/random/firstaid,
/obj/random/toolbox,
/obj/effect/floor_decal/corner/red/border{
	dir = 4;
	icon_state = "bordercolor"
	},
/turf/simulated/floor/tiled/dark,
/area/submap/MechHangar)
"Hz" = (
/obj/effect/floor_decal/corner/black/diagonal,
/turf/simulated/floor/tiled,
/area/submap/MechHangar)
"Ix" = (
/obj/effect/floor_decal/corner/red/border{
	dir = 6
	},
/turf/simulated/floor/tiled/dark,
/area/submap/MechHangar)
"Ju" = (
/turf/simulated/floor/outdoors/rocks{
	outdoors = 0
	},
/area/submap/MechHangar)
"JI" = (
/obj/structure/filingcabinet,
/obj/effect/floor_decal/corner/red/border{
	dir = 9
	},
/turf/simulated/floor/tiled/dark,
/area/submap/MechHangar)
"Kh" = (
/obj/random/outcrop,
/obj/effect/decal/cleanable/dirt,
/turf/simulated/floor/outdoors/rocks{
	outdoors = 0
	},
/area/submap/MechHangar)
"Kp" = (
/turf/simulated/floor/outdoors/dirt{
	outdoors = 0
	},
/area/submap/MechHangar)
"Le" = (
/obj/effect/floor_decal/corner/black/diagonal,
/obj/effect/decal/cleanable/dirt,
/turf/simulated/floor/tiled,
/area/submap/MechHangar)
"LE" = (
/obj/effect/decal/cleanable/dirt,
/turf/simulated/floor/outdoors/dirt{
	outdoors = 0
	},
/area/submap/MechHangar)
"Nh" = (
/obj/effect/floor_decal/corner/black/diagonal,
/obj/effect/decal/remains,
/obj/effect/decal/cleanable/dirt,
/turf/simulated/floor/tiled,
/area/submap/MechHangar)
"RH" = (
/obj/structure/door_assembly,
/turf/simulated/floor/tiled,
/area/submap/MechHangar)
"RK" = (
/obj/effect/floor_decal/corner/red/border{
	dir = 10
	},
/obj/effect/decal/cleanable/dirt,
/turf/simulated/floor/tiled/dark,
/area/submap/MechHangar)
"So" = (
/obj/random/outcrop,
/obj/effect/decal/cleanable/dirt,
/turf/simulated/floor/outdoors/dirt{
	outdoors = 0
	},
/area/submap/MechHangar)
"VA" = (
/obj/effect/decal/remains,
/turf/simulated/floor/outdoors/rocks{
	outdoors = 0
	},
/area/submap/MechHangar)
"WZ" = (
/obj/structure/table/standard,
/obj/item/telecube/randomized,
/turf/simulated/floor/tiled/dark,
/area/submap/MechHangar)
"XS" = (
/obj/effect/decal/cleanable/dirt,
/turf/simulated/floor/outdoors/rocks{
	outdoors = 0
	},
/area/submap/MechHangar)
"Ze" = (
/obj/effect/floor_decal/industrial/hatch/yellow,
/obj/structure/loot_pile/mecha/ripley/random_sprite,
/turf/simulated/floor/tiled/red,
/area/submap/MechHangar)

(1,1,1) = {"
uy
uy
uy
uy
uy
uy
uy
uy
uy
uy
uy
uy
uy
uy
uy
uy
uy
uy
uy
uy
"}
(2,1,1) = {"
uy
uy
uy
uy
uy
uy
uy
uy
uy
uy
uy
uy
uy
uy
uy
uy
uy
uy
uy
uy
"}
(3,1,1) = {"
uy
uy
uy
tF
tF
tF
tF
tF
tF
uy
uy
uy
uy
uy
tF
tF
uy
uy
uy
uy
"}
(4,1,1) = {"
uy
uy
tF
sD
sD
sD
sD
sD
sD
sD
af
af
Kp
sD
sD
sD
sD
uy
uy
uy
"}
(5,1,1) = {"
uy
uy
tF
ha
ha
ha
ha
ha
ha
sD
af
Kp
Ju
sD
sD
sD
sD
tF
uy
uy
"}
(6,1,1) = {"
uy
uy
tF
ha
JI
di
aR
RK
ha
sD
hW
ua
XS
sD
sD
sD
sD
uy
uy
uy
"}
(7,1,1) = {"
uy
tF
tF
ha
Fd
CO
WZ
fL
ha
sD
sD
LE
LE
vP
sD
sD
rn
uy
uy
uy
"}
(8,1,1) = {"
uy
tF
tF
ha
nC
wf
FS
Ix
ha
sD
sD
LE
LE
LE
LE
LE
LE
vy
uy
uy
"}
(9,1,1) = {"
uy
tF
tF
ha
ha
RH
ha
ha
ha
sD
sD
vP
XS
LE
LE
XS
VA
vy
vy
uy
"}
(10,1,1) = {"
uy
tF
tF
ha
AW
Le
Le
yB
ha
sD
sD
sD
XS
Kp
hW
LE
sX
tF
tF
uy
"}
(11,1,1) = {"
uy
tF
tF
ha
Hz
Le
vP
Le
ha
sD
sD
sD
LE
Kp
LE
Kp
sD
tF
tF
tF
"}
(12,1,1) = {"
uy
tF
tF
ha
ac
Hz
Le
jF
ha
sD
sD
sD
sD
LE
Kp
sX
sD
tF
tF
tF
"}
(13,1,1) = {"
uy
uy
tF
ha
mP
Le
Le
Hz
ha
sD
sD
sD
fB
LE
LE
sD
sD
tF
tF
uy
"}
(14,1,1) = {"
uy
uy
tF
ha
ob
Hz
Le
tt
ha
sD
sD
Kh
Ju
LE
LE
hW
sD
tF
uy
uy
"}
(15,1,1) = {"
uy
uy
tF
ha
Hz
Hz
Le
Hz
ha
sD
BZ
XS
XS
Aj
LE
Kp
Kp
yG
uy
uy
"}
(16,1,1) = {"
uy
tF
tF
ha
tt
Hz
Nh
Hz
Hz
Kp
LE
XS
LE
LE
XS
rF
Kp
uy
uy
uy
"}
(17,1,1) = {"
uy
tF
tF
ha
Hz
vP
Hz
Le
Le
LE
LE
So
qr
Ju
sX
LE
af
uy
uy
uy
"}
(18,1,1) = {"
uy
tF
tF
ha
Ze
Hz
Hz
Hz
vP
LE
Kp
sD
sD
sD
sD
Kp
af
uy
uy
uy
"}
(19,1,1) = {"
uy
uy
tF
ha
ha
ha
ha
ha
ha
vP
sD
sD
sD
sD
LE
LE
Kp
uy
uy
uy
"}
(20,1,1) = {"
uy
uy
tF
sD
sD
sD
sD
sD
sD
AF
vP
sD
sD
sD
LE
LE
vP
tF
uy
uy
"}
(21,1,1) = {"
uy
uy
uy
sD
sD
sD
sD
sD
sD
af
Kp
hW
sD
sX
LE
Kp
sD
tF
tF
uy
"}
(22,1,1) = {"
uy
uy
uy
sD
sD
sD
sD
sD
sD
af
af
af
af
af
Ju
sD
sD
tF
tF
uy
"}
(23,1,1) = {"
uy
uy
uy
uy
tF
tF
tF
tF
uy
uy
uy
uy
uy
uy
uy
uy
tF
tF
uy
uy
"}
(24,1,1) = {"
uy
uy
uy
uy
uy
tF
tF
tF
uy
uy
uy
uy
uy
uy
uy
uy
uy
uy
uy
uy
"}
(25,1,1) = {"
uy
uy
uy
uy
uy
uy
uy
uy
uy
uy
uy
uy
uy
uy
uy
uy
uy
uy
uy
uy
"}
