//MAP CONVERTED BY dmm2tgm.py THIS HEADER COMMENT PREVENTS RECONVERSION, DO NOT REMOVE
"a" = (
/turf/template_noop,
/area/template_noop)
"d" = (
/obj/structure/loot_pile/surface/alien/end,
/turf/simulated/shuttle/floor/alienplating/external,
/area/template_noop)
"l" = (
/turf/simulated/floor/lava/outdoors,
/area/template_noop)
"p" = (
/obj/structure/cliff/automatic{
	dir = 2
	},
/turf/simulated/floor/outdoors/rocks/sif/planetuse,
/area/template_noop)
"q" = (
/obj/structure/cliff/automatic/corner{
	dir = 10
	},
/turf/simulated/floor/outdoors/rocks/sif/planetuse,
/area/template_noop)
"s" = (
/obj/structure/cliff/automatic{
	dir = 8
	},
/turf/simulated/floor/outdoors/rocks/sif/planetuse,
/area/template_noop)
"t" = (
/obj/effect/map_effect/interval/effect_emitter/smoke/fire,
/turf/simulated/floor/lava/outdoors,
/area/template_noop)
"v" = (
/obj/structure/cliff/automatic{
	dir = 5
	},
/turf/simulated/floor/outdoors/rocks/sif/planetuse,
/area/template_noop)
"w" = (
/obj/structure/cliff/automatic,
/turf/simulated/floor/outdoors/rocks/sif/planetuse,
/area/template_noop)
"y" = (
/obj/structure/cliff/automatic/corner{
	dir = 9
	},
/turf/simulated/floor/outdoors/rocks/sif/planetuse,
/area/template_noop)
"A" = (
/obj/structure/cliff/automatic{
	dir = 6
	},
/turf/simulated/floor/outdoors/rocks/sif/planetuse,
/area/template_noop)
"B" = (
/obj/item/prop/alien/junk,
/turf/simulated/shuttle/floor/alienplating/external,
/area/template_noop)
"D" = (
/turf/simulated/shuttle/floor/alienplating/external,
/area/template_noop)
"E" = (
/obj/structure/cliff/automatic{
	dir = 10
	},
/turf/simulated/floor/outdoors/rocks/sif/planetuse,
/area/template_noop)
"J" = (
/obj/structure/cliff/automatic{
	dir = 4
	},
/turf/simulated/floor/outdoors/rocks/sif/planetuse,
/area/template_noop)
"L" = (
/obj/structure/cliff/automatic{
	dir = 9
	},
/turf/simulated/floor/outdoors/rocks/sif/planetuse,
/area/template_noop)
"O" = (
/turf/simulated/floor/outdoors/rocks/sif/planetuse,
/area/template_noop)
"P" = (
/obj/structure/cliff/automatic/corner{
	dir = 6
	},
/turf/simulated/floor/outdoors/rocks/sif/planetuse,
/area/template_noop)
"Q" = (
/obj/item/prop/alien/junk,
/turf/simulated/floor/outdoors/rocks/sif/planetuse,
/area/template_noop)
"S" = (
/obj/random/tool/alien,
/turf/simulated/shuttle/floor/alienplating/external,
/area/template_noop)
"V" = (
/obj/structure/cliff/automatic/corner,
/turf/simulated/floor/outdoors/rocks/sif/planetuse,
/area/template_noop)

(1,1,1) = {"
a
a
a
a
a
a
a
a
a
a
a
a
a
a
a
a
a
a
a
a
a
a
a
a
a
a
a
a
a
a
a
a
a
"}
(2,1,1) = {"
a
a
a
a
a
a
a
L
s
s
s
s
s
s
s
s
s
s
s
s
s
s
s
s
s
s
s
E
a
a
a
a
a
"}
(3,1,1) = {"
a
a
a
a
a
a
a
w
l
l
l
l
l
l
l
l
l
l
l
l
l
l
l
l
l
l
l
q
E
a
a
a
a
"}
(4,1,1) = {"
a
a
a
a
a
a
a
w
l
l
l
l
l
l
l
l
l
l
l
l
l
l
l
l
l
l
l
l
p
a
a
a
a
"}
(5,1,1) = {"
a
a
a
a
a
a
L
y
l
l
l
l
l
l
O
O
t
O
O
O
l
l
l
l
S
D
l
l
p
a
a
a
a
"}
(6,1,1) = {"
a
a
a
a
a
a
w
l
l
l
l
l
l
O
O
O
O
O
O
O
Q
l
l
l
D
D
l
l
p
a
a
a
a
"}
(7,1,1) = {"
a
a
a
a
a
a
w
l
l
l
l
l
O
l
O
O
O
O
l
O
O
O
l
l
D
D
t
l
q
E
a
a
a
"}
(8,1,1) = {"
a
a
a
a
a
L
y
l
l
t
l
O
O
O
O
l
l
O
O
O
O
l
O
l
D
D
l
l
l
p
a
a
a
"}
(9,1,1) = {"
a
a
a
a
a
w
l
l
l
l
O
O
O
O
l
l
l
l
O
O
O
O
O
l
l
l
l
l
l
p
a
a
a
"}
(10,1,1) = {"
a
a
a
a
a
w
l
l
l
l
O
O
O
l
l
l
l
l
l
O
O
O
l
O
l
l
l
l
l
q
E
a
a
"}
(11,1,1) = {"
a
a
a
a
L
y
l
l
l
O
O
O
l
l
l
l
l
l
t
l
O
O
O
O
l
l
l
l
l
l
p
a
a
"}
(12,1,1) = {"
a
a
a
a
w
l
l
l
l
O
Q
O
l
l
l
l
l
l
l
l
l
O
O
O
O
l
l
l
l
l
p
a
a
"}
(13,1,1) = {"
a
a
a
a
w
l
l
l
l
l
O
l
l
l
D
l
l
l
l
l
l
l
O
O
O
O
l
l
l
l
p
a
a
"}
(14,1,1) = {"
a
a
a
a
w
l
l
t
l
l
l
l
l
D
D
D
l
l
l
l
l
l
O
O
t
O
O
O
l
l
p
a
a
"}
(15,1,1) = {"
a
a
a
a
w
l
l
l
l
l
l
l
D
D
D
D
D
l
l
l
O
O
O
O
O
O
O
O
O
l
q
a
a
"}
(16,1,1) = {"
a
a
a
a
w
l
l
l
l
l
l
D
D
D
B
D
l
l
l
O
O
O
l
O
l
l
O
O
O
O
O
a
a
"}
(17,1,1) = {"
a
a
a
a
w
l
l
l
l
l
l
l
d
D
D
l
l
l
O
O
l
O
O
l
l
l
l
O
O
O
O
a
a
"}
(18,1,1) = {"
a
a
a
a
w
l
l
O
O
l
l
l
l
D
l
l
l
O
O
O
O
O
O
l
l
l
l
l
l
O
O
a
a
"}
(19,1,1) = {"
a
a
a
a
w
l
Q
O
O
O
l
l
l
l
l
l
O
O
O
O
O
O
l
l
D
l
l
l
l
l
P
a
a
"}
(20,1,1) = {"
a
a
a
a
w
l
O
O
O
O
O
l
l
l
l
O
O
O
O
O
l
l
l
D
D
D
l
l
l
l
p
a
a
"}
(21,1,1) = {"
a
a
a
a
w
l
l
l
O
O
O
O
O
O
O
O
O
t
O
l
l
l
D
D
D
D
D
l
l
l
p
a
a
"}
(22,1,1) = {"
a
a
a
a
w
l
l
l
O
O
O
O
O
O
O
O
O
O
O
l
l
l
l
B
D
D
D
D
l
l
p
a
a
"}
(23,1,1) = {"
a
a
a
a
v
V
l
l
l
O
t
O
O
O
O
O
O
O
l
O
l
l
l
l
D
D
d
l
l
l
p
a
a
"}
(24,1,1) = {"
a
a
a
a
a
w
l
l
l
l
O
O
O
l
O
l
O
O
O
O
O
l
l
l
l
D
l
t
l
P
A
a
a
"}
(25,1,1) = {"
a
a
a
a
a
w
l
l
l
l
l
O
O
O
l
l
O
O
O
O
O
O
O
l
l
l
l
l
l
p
a
a
a
"}
(26,1,1) = {"
a
a
a
a
a
v
V
l
l
l
l
l
l
l
l
l
l
O
O
O
l
O
O
O
l
l
l
l
l
p
a
a
a
"}
(27,1,1) = {"
a
a
a
a
a
a
w
l
l
l
l
l
l
l
l
l
t
l
l
O
O
O
O
O
O
l
l
l
P
A
a
a
a
"}
(28,1,1) = {"
a
a
a
a
a
a
w
l
l
l
l
l
D
S
D
D
l
l
l
l
O
O
t
O
O
l
l
l
p
a
a
a
a
"}
(29,1,1) = {"
a
a
a
a
a
a
v
V
l
l
l
l
D
D
D
D
l
l
l
l
l
O
O
Q
O
l
l
l
p
a
a
a
a
"}
(30,1,1) = {"
a
a
a
a
a
a
a
w
l
t
l
l
l
l
l
l
l
l
l
l
l
O
O
O
l
l
l
l
p
a
a
a
a
"}
(31,1,1) = {"
a
a
a
a
a
a
a
w
l
l
l
l
l
l
l
l
l
l
l
l
l
l
l
l
l
l
l
P
A
a
a
a
a
"}
(32,1,1) = {"
a
a
a
a
a
a
a
v
J
J
J
J
J
J
J
J
J
J
J
J
J
J
J
J
J
J
J
A
a
a
a
a
a
"}
(33,1,1) = {"
a
a
a
a
a
a
a
a
a
a
a
a
a
a
a
a
a
a
a
a
a
a
a
a
a
a
a
a
a
a
a
a
a
"}
