//MAP CONVERTED BY dmm2tgm.py THIS HEADER COMMENT PREVENTS RECONVERSION, DO NOT REMOVE
"a" = (
/turf/simulated/floor/outdoors/dirt,
/area/submap/WolfDen)
"b" = (
/obj/effect/decal/cleanable/dirt,
/obj/random/cargopod,
/turf/simulated/floor/outdoors/dirt{
	outdoors = 0
	},
/area/submap/WolfDen)
"c" = (
/obj/item/bone,
/obj/effect/decal/cleanable/dirt,
/obj/effect/gibspawner/human,
/obj/random/maintenance/engineering,
/turf/simulated/floor/outdoors/dirt{
	outdoors = 0
	},
/area/submap/WolfDen)
"d" = (
/mob/living/simple_mob/vore/wolf/direwolf{
	faction = "wilderness"
	},
/turf/simulated/floor/outdoors/dirt{
	outdoors = 0
	},
/area/submap/WolfDen)
"e" = (
/obj/effect/decal/cleanable/dirt,
/obj/effect/decal/cleanable/dirt,
/obj/random/junk,
/obj/random/maintenance/cargo,
/turf/simulated/floor/outdoors/dirt{
	outdoors = 0
	},
/area/submap/WolfDen)
"i" = (
/obj/random/cargopod,
/obj/random/maintenance/security,
/turf/simulated/floor/outdoors/dirt{
	outdoors = 0
	},
/area/submap/WolfDen)
"j" = (
/obj/random/gun/random,
/obj/random/junk,
/turf/simulated/floor/outdoors/rocks{
	outdoors = 0
	},
/area/submap/WolfDen)
"m" = (
/obj/item/bone/ribs,
/turf/simulated/floor/outdoors/dirt{
	outdoors = 0
	},
/area/submap/WolfDen)
"o" = (
/turf/simulated/mineral/ignore_mapgen,
/area/submap/WolfDen)
"p" = (
/mob/living/simple_mob/vore/wolf/direwolf/dog{
	faction = "wilderness";
	maxHealth = 350;
	melee_damage_lower = 15;
	melee_damage_upper = 30;
	name = "Alpha dire wolf"
	},
/turf/simulated/floor/outdoors/dirt{
	outdoors = 0
	},
/area/submap/WolfDen)
"q" = (
/obj/structure/loot_pile/surface/bones,
/obj/random/maintenance/cargo,
/turf/simulated/floor/outdoors/rocks{
	outdoors = 0
	},
/area/submap/WolfDen)
"r" = (
/obj/random/humanoidremains,
/turf/simulated/floor/outdoors/dirt{
	outdoors = 0
	},
/area/submap/WolfDen)
"u" = (
/obj/effect/decal/cleanable/dirt,
/obj/effect/decal/cleanable/dirt,
/obj/structure/ledge/ledge_stairs{
	dir = 4
	},
/turf/simulated/floor/outdoors/dirt{
	outdoors = 0
	},
/area/submap/WolfDen)
"v" = (
/obj/effect/decal/cleanable/dirt,
/obj/effect/decal/cleanable/dirt,
/turf/simulated/floor/outdoors/dirt{
	outdoors = 0
	},
/area/submap/WolfDen)
"w" = (
/obj/effect/decal/cleanable/dirt,
/obj/effect/decal/cleanable/dirt,
/obj/random/junk,
/turf/simulated/floor/outdoors/dirt{
	outdoors = 0
	},
/area/submap/WolfDen)
"y" = (
/mob/living/simple_mob/vore/wolf/direwolf{
	faction = "wilderness"
	},
/obj/random/maintenance/security,
/turf/simulated/floor/outdoors/rocks{
	outdoors = 0
	},
/area/submap/WolfDen)
"z" = (
/obj/effect/decal/cleanable/dirt,
/turf/simulated/floor/outdoors/dirt,
/area/submap/WolfDen)
"A" = (
/obj/effect/decal/cleanable/dirt,
/obj/random/maintenance/security,
/turf/simulated/floor/outdoors/dirt{
	outdoors = 0
	},
/area/submap/WolfDen)
"C" = (
/obj/random/trash_pile,
/turf/simulated/floor/outdoors/dirt,
/area/submap/WolfDen)
"D" = (
/obj/effect/decal/cleanable/dirt,
/obj/random/junk,
/turf/simulated/floor/outdoors/rocks{
	outdoors = 0
	},
/area/submap/WolfDen)
"G" = (
/obj/item/bone/arm,
/obj/effect/decal/cleanable/dirt,
/turf/simulated/floor/outdoors/dirt{
	outdoors = 0
	},
/area/submap/WolfDen)
"I" = (
/obj/effect/decal/cleanable/dirt,
/turf/simulated/floor/outdoors/dirt{
	outdoors = 0
	},
/area/submap/WolfDen)
"J" = (
/obj/effect/decal/cleanable/dirt,
/obj/random/junk,
/turf/simulated/floor/outdoors/dirt{
	outdoors = 0
	},
/area/submap/WolfDen)
"K" = (
/obj/effect/decal/cleanable/dirt,
/obj/effect/decal/cleanable/dirt,
/obj/effect/decal/cleanable/dirt,
/turf/simulated/floor/outdoors/dirt{
	outdoors = 0
	},
/area/submap/WolfDen)
"M" = (
/obj/random/cargopod,
/obj/random/maintenance/cargo,
/turf/simulated/floor/outdoors/rocks{
	outdoors = 0
	},
/area/submap/WolfDen)
"O" = (
/obj/random/gun/random,
/turf/simulated/floor/outdoors/dirt{
	outdoors = 0
	},
/area/submap/WolfDen)
"R" = (
/obj/effect/decal/cleanable/dirt,
/obj/effect/decal/cleanable/dirt,
/obj/effect/decal/cleanable/dirt,
/turf/simulated/floor/outdoors/dirt,
/area/submap/WolfDen)
"S" = (
/obj/item/bone,
/obj/effect/decal/cleanable/dirt,
/obj/effect/decal/cleanable/dirt,
/turf/simulated/floor/outdoors/rocks{
	outdoors = 0
	},
/area/submap/WolfDen)
"T" = (
/obj/effect/decal/cleanable/dirt,
/obj/random/maintenance/engineering,
/turf/simulated/floor/outdoors/rocks{
	outdoors = 0
	},
/area/submap/WolfDen)
"U" = (
/obj/effect/decal/cleanable/dirt,
/obj/random/maintenance/engineering,
/obj/item/clothing/head/fedora,
/turf/simulated/floor/outdoors/rocks{
	outdoors = 0
	},
/area/submap/WolfDen)
"V" = (
/obj/random/outcrop,
/turf/simulated/floor/outdoors/dirt,
/area/submap/WolfDen)
"W" = (
/obj/structure/loot_pile/surface/bones,
/obj/effect/decal/cleanable/dirt,
/obj/random/maintenance/cargo,
/turf/simulated/floor/outdoors/dirt{
	outdoors = 0
	},
/area/submap/WolfDen)
"X" = (
/obj/item/stolenpackage,
/turf/simulated/floor/outdoors/dirt{
	outdoors = 0
	},
/area/submap/WolfDen)
"Y" = (
/obj/effect/decal/cleanable/dirt,
/obj/random/cargopod,
/turf/simulated/floor/outdoors/rocks{
	outdoors = 0
	},
/area/submap/WolfDen)
"Z" = (
/turf/template_noop,
/area/submap/WolfDen)

(1,1,1) = {"
Z
V
o
o
o
o
o
o
o
a
"}
(2,1,1) = {"
Z
o
o
o
d
O
X
o
o
o
"}
(3,1,1) = {"
Z
o
o
i
S
W
D
y
o
o
"}
(4,1,1) = {"
Z
o
v
A
w
e
J
b
r
o
"}
(5,1,1) = {"
Z
o
u
o
r
T
G
q
Y
o
"}
(6,1,1) = {"
Z
o
K
o
o
p
M
c
U
o
"}
(7,1,1) = {"
o
o
u
o
o
o
m
j
X
o
"}
(8,1,1) = {"
Z
z
v
I
o
o
o
d
o
o
"}
(9,1,1) = {"
a
R
z
o
o
o
o
o
o
a
"}
(10,1,1) = {"
Z
o
o
o
o
C
o
o
V
Z
"}
