//MAP CONVERTED BY dmm2tgm.py THIS HEADER COMMENT PREVENTS RECONVERSION, DO NOT REMOVE
"a" = (
/turf/template_noop,
/area/template_noop)
"b" = (
/obj/structure/fence/corner{
	dir = 1
	},
/obj/effect/decal/cleanable/dirt,
/turf/simulated/floor/outdoors/dirt,
/area/submap/XenoWeaveMinour)
"c" = (
/obj/effect/decal/cleanable/dirt,
/obj/random/maintenance/cargo,
/turf/simulated/floor/outdoors/dirt,
/area/submap/XenoWeaveMinour)
"e" = (
/obj/effect/decal/remains/human,
/turf/template_noop,
/area/template_noop)
"f" = (
/obj/effect/decal/remains/ribcage,
/turf/template_noop,
/area/template_noop)
"g" = (
/obj/effect/decal/remains/tajaran,
/turf/template_noop,
/area/template_noop)
"h" = (
/obj/structure/dogbed,
/obj/effect/decal/cleanable/dirt,
/obj/random/maintenance/security,
/turf/simulated/floor/outdoors/dirt,
/area/submap/XenoWeaveMinour)
"j" = (
/turf/simulated/shuttle/floor/alien/blue,
/area/submap/XenoWeaveMinour)
"k" = (
/obj/structure/fence,
/obj/effect/decal/cleanable/dirt,
/turf/simulated/floor/outdoors/dirt,
/area/submap/XenoWeaveMinour)
"l" = (
/obj/machinery/door/airlock/external,
/turf/simulated/floor/tiled/dark,
/area/submap/XenoWeaveMinour)
"m" = (
/obj/effect/decal/cleanable/dirt,
/turf/template_noop,
/area/template_noop)
"n" = (
/obj/structure/fence{
	dir = 4
	},
/obj/effect/decal/cleanable/dirt,
/turf/simulated/floor/outdoors/dirt,
/area/submap/XenoWeaveMinour)
"o" = (
/obj/structure/prop/alien/power,
/turf/simulated/shuttle/floor/alien/blue,
/area/submap/XenoWeaveMinour)
"p" = (
/obj/machinery/door/blast/gate/thin,
/obj/effect/decal/cleanable/dirt,
/turf/simulated/floor/outdoors/dirt,
/area/submap/XenoWeaveMinour)
"q" = (
/obj/structure/dogbed,
/obj/effect/decal/remains/deer,
/obj/effect/decal/cleanable/dirt,
/obj/random/contraband,
/turf/simulated/floor/outdoors/dirt,
/area/submap/XenoWeaveMinour)
"r" = (
/obj/effect/decal/remains/human,
/obj/effect/decal/cleanable/dirt,
/obj/random/maintenance/cargo,
/turf/simulated/floor/outdoors/dirt,
/area/submap/XenoWeaveMinour)
"t" = (
/obj/structure/dogbed,
/obj/effect/decal/remains/deer,
/obj/effect/decal/cleanable/dirt,
/obj/random/maintenance/medical,
/turf/simulated/floor/outdoors/dirt,
/area/submap/XenoWeaveMinour)
"v" = (
/obj/structure/dogbed,
/obj/effect/decal/remains/human,
/obj/effect/decal/cleanable/filth,
/obj/effect/decal/cleanable/dirt,
/obj/item/bone/ribs,
/obj/random/maintenance/research,
/turf/simulated/floor/outdoors/dirt,
/area/submap/XenoWeaveMinour)
"x" = (
/obj/machinery/porta_turret/alien{
	faction = "hivebot"
	},
/turf/simulated/floor,
/area/submap/XenoWeaveMinour)
"A" = (
/obj/effect/decal/cleanable/dirt,
/turf/simulated/floor,
/area/submap/XenoWeaveMinour)
"C" = (
/mob/living/simple_mob/mechanical/mecha/eclipse/hivebot/boss/sifpoi,
/turf/simulated/shuttle/floor/alien/blue,
/area/submap/XenoWeaveMinour)
"D" = (
/obj/effect/decal/remains/unathi,
/obj/effect/decal/cleanable/dirt,
/turf/simulated/floor/outdoors/dirt,
/area/submap/XenoWeaveMinour)
"F" = (
/obj/effect/decal/remains/human,
/obj/effect/decal/cleanable/filth,
/obj/effect/decal/cleanable/dirt,
/obj/random/maintenance/cargo,
/turf/simulated/floor/outdoors/dirt,
/area/submap/XenoWeaveMinour)
"J" = (
/obj/structure/dogbed,
/obj/effect/decal/cleanable/dirt,
/obj/random/maintenance/research,
/turf/simulated/floor/outdoors/dirt,
/area/submap/XenoWeaveMinour)
"L" = (
/obj/structure/dogbed,
/obj/effect/decal/cleanable/dirt,
/obj/item/bone,
/obj/random/maintenance/security,
/turf/simulated/floor/outdoors/dirt,
/area/submap/XenoWeaveMinour)
"N" = (
/obj/effect/decal/cleanable/dirt,
/turf/simulated/floor/outdoors/dirt,
/area/template_noop)
"O" = (
/obj/structure/dogbed,
/obj/effect/decal/remains/unathi,
/obj/effect/decal/cleanable/dirt,
/obj/random/maintenance/security,
/turf/simulated/floor/outdoors/dirt,
/area/submap/XenoWeaveMinour)
"P" = (
/turf/simulated/floor/outdoors/dirt,
/area/template_noop)
"Q" = (
/obj/effect/decal/cleanable/dirt,
/turf/simulated/floor/outdoors/dirt,
/area/submap/XenoWeaveMinour)
"R" = (
/turf/simulated/shuttle/wall/alien/blue,
/area/submap/XenoWeaveMinour)
"S" = (
/obj/structure/dogbed,
/obj/effect/decal/cleanable/dirt,
/obj/item/bone,
/obj/random/contraband,
/turf/simulated/floor/outdoors/dirt,
/area/submap/XenoWeaveMinour)
"U" = (
/obj/structure/dogbed,
/obj/effect/decal/remains/tajaran,
/obj/effect/decal/cleanable/filth,
/obj/effect/decal/cleanable/dirt,
/obj/item/bone,
/obj/random/maintenance/security,
/turf/simulated/floor/outdoors/dirt,
/area/submap/XenoWeaveMinour)
"V" = (
/obj/effect/decal/cleanable/dirt,
/obj/item/bone/leg,
/turf/simulated/floor/outdoors/dirt,
/area/submap/XenoWeaveMinour)
"W" = (
/obj/effect/floor_decal/industrial/danger{
	dir = 1
	},
/turf/simulated/floor,
/area/submap/XenoWeaveMinour)
"X" = (
/turf/simulated/floor,
/area/submap/XenoWeaveMinour)
"Y" = (
/obj/structure/dogbed,
/obj/effect/decal/cleanable/dirt,
/obj/effect/decal/remains/tajaran,
/obj/random/maintenance/medical,
/turf/simulated/floor/outdoors/dirt,
/area/submap/XenoWeaveMinour)
"Z" = (
/obj/structure/dogbed,
/obj/effect/decal/cleanable/dirt,
/obj/effect/decal/remains/human,
/obj/random/contraband,
/turf/simulated/floor/outdoors/dirt,
/area/submap/XenoWeaveMinour)

(1,1,1) = {"
a
a
a
a
a
a
a
a
e
a
a
a
a
a
a
a
a
a
a
a
a
a
a
a
a
a
a
a
e
a
"}
(2,1,1) = {"
a
a
a
a
a
a
a
a
a
a
a
a
a
a
a
a
a
a
a
a
a
a
a
a
a
a
a
a
a
a
"}
(3,1,1) = {"
a
e
a
a
a
a
a
a
a
a
a
a
a
a
a
a
a
a
a
a
a
a
a
a
a
a
a
a
a
a
"}
(4,1,1) = {"
a
a
a
a
a
a
a
x
X
a
a
a
X
x
a
a
a
a
a
a
a
a
a
a
a
a
a
a
a
a
"}
(5,1,1) = {"
a
a
a
a
a
a
a
X
R
R
R
R
R
k
k
k
k
k
b
m
a
a
a
a
N
a
a
e
a
a
"}
(6,1,1) = {"
a
a
a
a
a
a
a
a
R
j
o
j
R
v
q
t
L
O
n
m
g
a
a
N
N
a
a
P
a
a
"}
(7,1,1) = {"
a
a
a
a
a
a
a
a
R
o
j
o
R
h
F
V
D
c
p
N
N
N
N
N
a
P
a
a
a
a
"}
(8,1,1) = {"
a
a
a
a
a
a
a
a
R
o
j
o
R
U
Q
Q
r
Q
p
N
N
N
N
a
a
a
a
P
a
a
"}
(9,1,1) = {"
a
a
x
X
a
a
a
a
R
j
o
j
R
J
Z
Y
S
t
n
g
a
a
m
m
A
x
a
a
a
a
"}
(10,1,1) = {"
a
a
X
R
R
R
R
R
R
R
R
R
R
R
R
R
R
R
R
R
R
R
R
R
R
X
a
e
a
a
"}
(11,1,1) = {"
a
a
a
R
R
R
j
j
j
j
j
j
R
R
R
R
j
j
j
j
j
j
R
R
R
X
X
a
a
a
"}
(12,1,1) = {"
e
a
a
R
R
j
j
j
j
j
j
j
j
R
R
j
j
j
j
j
j
j
j
R
R
W
X
a
a
P
"}
(13,1,1) = {"
a
a
a
R
j
j
j
j
j
j
j
j
j
j
j
j
j
j
j
j
j
j
j
j
R
W
X
P
P
a
"}
(14,1,1) = {"
a
X
X
R
j
j
j
j
j
j
j
j
j
j
j
j
j
j
j
j
j
j
j
j
R
W
X
P
a
a
"}
(15,1,1) = {"
a
x
X
R
j
j
j
j
R
j
C
j
j
j
j
j
j
j
j
R
j
j
j
j
l
W
X
P
P
P
"}
(16,1,1) = {"
a
X
X
R
j
j
j
j
j
j
j
j
j
j
j
j
j
j
j
j
j
j
j
j
R
W
X
P
P
a
"}
(17,1,1) = {"
a
a
a
R
j
j
j
j
j
j
j
j
j
j
j
j
j
j
j
j
j
j
j
j
R
W
X
P
P
a
"}
(18,1,1) = {"
a
a
a
R
R
j
j
j
j
j
j
j
j
R
R
j
j
j
j
j
j
j
j
R
R
W
X
a
P
a
"}
(19,1,1) = {"
e
a
a
R
R
R
j
j
j
j
j
j
R
R
R
R
j
j
j
j
j
j
R
R
R
X
X
a
a
a
"}
(20,1,1) = {"
a
a
X
R
R
R
R
R
R
R
R
R
R
R
R
R
R
R
R
R
R
R
R
R
R
X
a
a
a
a
"}
(21,1,1) = {"
a
a
x
X
a
a
a
a
R
j
o
j
R
a
a
a
a
a
a
a
a
a
a
a
X
x
a
a
a
e
"}
(22,1,1) = {"
a
a
a
a
a
a
a
a
R
o
j
o
R
a
a
a
a
a
a
a
a
a
a
a
a
a
a
a
a
a
"}
(23,1,1) = {"
a
a
a
a
a
a
a
a
R
o
j
o
R
a
a
a
a
a
a
a
a
a
a
a
a
a
a
a
a
a
"}
(24,1,1) = {"
a
a
a
a
a
a
a
a
R
j
o
j
R
a
a
e
a
a
e
a
a
a
e
a
a
a
a
a
e
a
"}
(25,1,1) = {"
a
a
e
a
a
a
a
X
R
R
R
R
R
X
a
a
a
a
a
a
f
a
a
a
a
a
a
a
a
a
"}
(26,1,1) = {"
a
a
a
a
a
a
a
x
X
a
a
a
X
x
a
a
a
a
a
a
a
a
a
a
a
a
a
a
a
a
"}
(27,1,1) = {"
a
a
a
a
a
a
a
a
a
a
a
a
a
a
a
a
a
a
a
a
a
a
a
a
e
a
a
e
a
a
"}
(28,1,1) = {"
a
a
a
a
a
a
a
a
a
a
a
a
a
a
a
e
a
a
a
a
a
a
a
a
a
a
a
a
a
a
"}
(29,1,1) = {"
a
a
a
a
a
a
a
a
a
a
a
e
a
a
a
a
a
a
a
a
a
a
a
a
a
a
a
a
a
a
"}
(30,1,1) = {"
a
a
a
a
a
a
a
a
e
a
a
a
a
a
a
a
a
a
a
a
a
a
a
a
a
a
a
a
a
a
"}
