"c" = (/obj/structure/railing{dir = 1; icon_state = "railing0"},/obj/structure/metal_edge,/turf/simulated/mineral/floor/ignore_mapgen/bor4,/area/cryogaia_away/aerostat/surface/explored)
"d" = (/obj/effect/floor_decal/rust,/obj/effect/shuttle_landmark/premade/aerostat_surface,/turf/simulated/floor/tiled/techfloor/bor4,/area/cryogaia_away/aerostat/surface/explored)
"h" = (/turf/simulated/mineral/bor4,/area/cryogaia_away/aerostat/surface/explored)
"j" = (/turf/simulated/mineral/floor/ignore_mapgen/bor4,/area/cryogaia_away/aerostat/surface/explored)
"m" = (/turf/simulated/shuttle/wall/voidcraft/green/bor4,/area/space)
"o" = (/turf/simulated/mineral/bor4,/area/cryogaia_away/aerostat/surface/unexplored)
"B" = (/obj/structure/railing{dir = 8; icon_state = "railing0"},/turf/simulated/mineral/floor/ignore_mapgen/bor4,/area/cryogaia_away/aerostat/surface/explored)
"C" = (/obj/structure/railing,/turf/simulated/mineral/floor/ignore_mapgen/bor4,/area/cryogaia_away/aerostat/surface/explored)
"I" = (/obj/structure/salvageable/personal,/turf/simulated/mineral/floor/ignore_mapgen/bor4,/area/cryogaia_away/aerostat/surface/explored)
"J" = (/turf/space,/area/space)
"N" = (/obj/structure/railing{dir = 4; icon_state = "railing0"},/turf/simulated/mineral/floor/ignore_mapgen/bor4,/area/cryogaia_away/aerostat/surface/explored)
"R" = (/obj/effect/floor_decal/rust,/turf/simulated/floor/tiled/techfloor/bor4,/area/cryogaia_away/aerostat/surface/explored)
"U" = (/obj/cryogaia_away_spawner/aerostat_surface,/turf/simulated/mineral/floor/ignore_mapgen/bor4,/area/cryogaia_away/aerostat/surface/explored)
"Y" = (/turf/unsimulated/wall/planetary/bor4,/area/cryogaia_away/aerostat/surface)

(1,1,1) = {"
JJJJJJJJJJJJJJJJJJJJJJJJJJJJJJJJJJJJJJJJJJJJJJJJJJJJJJJJJJJJJJJJJJJJJJJJJJJJJJJJJJJJJJJJJJJJJJJJJJJJJJJJJJJJJJJJJJJJJJJJJJJJJJJJJJJJJJJJJJJJJJJJJJJJJJJJJJJJJJJJ
JJJJJJJJJJJJJJJJJJJJJJJJJJJJJJJJJJJJJJJJJJJJJJJJJJJJJJJJJJJJJJJJJJJJJJJJJJJJJJJJJJJJJJJJJJJJJJJJJJJJJJJJJJJJJJJJJJJJJJJJJJJJJJJJJJJJJJJJJJJJJJJJJJJJJJJJJJJJJJJJ
JJJJJJJJJJJJJJJJJJJJJJJJJJJJJJJJJJJJJJJJJJJJJJJJJJJJJJJJJJJJJJJJJJJJJJJJJJJJJJJJJJJJJJJJJJJJJJJJJJJJJJJJJJJJJJJJJJJJJJJJJJJJJJJJJJJJJJJJJJJJJJJJJJJJJJJJJJJJJJJJ
JJJJJJJJJJJJJJJJJJJJJJJJJJJJJJJJJJJJJJJJJJJJJJJJJJJJJJJJJJJJJJJJJJJJJJJJJJJJJJJJJJJJJJJJJJJJJJJJJJJJJJJJJJJJJJJJJJJJJJJJJJJJJJJJJJJJJJJJJJJJJJJJJJJJJJJJJJJJJJJJ
JJJJJJJJJJJJJJJJJJJJJJJJJJJJJJJJJJJJJJJJJJJJJJJJJJJJJJJJJJJJJJJJJJJJJJJJJJJJJJJJJJJJJJJJJJJJJJJJJJJJJJJJJJJJJJJJJJJJJJJJJJJJJJJJJJJJJJJJJJJJJJJJJJJJJJJJJJJJJJJJ
JJJJJJJJJJJJJJJJJJJJJJJJJJJJJJJJJJJJJJJJJJJJJJJJJJJJJJJJJJJJJJJJJJJJJJJJJJJJJJJJJJJJJJJJJJJJJJJJJJJJJJJJJJJJJJJJJJJJJJJJJJJJJJJJJJJJJJJJJJJJJJJJJJJJJJJJJJJJJJJJ
JJJJJJJJJJJJJJJJJJJJJJJJJJJJJJJJJJJJJJJJJJJJJJJJJJJJJJJJJJJJJJJJJJJJJJJJJJJJJJJJJJJJJJJJJJJJJJJJJJJJJJJJJJJJJJJJJJJJJJJJJJJJJJJJJJJJJJJJJJJJJJJJJJJJJJJJJJJJJJJJ
JJJJJJJJJJJJJJJJJJJJJJJJJJJJJJJJJJJJJJJJJJJJJJJJJJJJJJJJJJJJJJJJJJJJJJJJJJJJJJJJJJJJJJJJJJJJJJJJJJJJJJJJJJJJJJJJJJJJJJJJJJJJJJJJJJJJJJJJJJJJJJJJJJJJJJJJJJJJJJJJ
JJJJJJJJJJJJJJJJJJJJJJJJJJJJJJJJJJJJJJJJJJJJJJJJJJJJJJJJJJJJJJJJJJJJJJJJJJJJJJJJJJJJJJJJJJJJJJJJJJJJJJJJJJJJJJJJJJJJJJJJJJJJJJJJJJJJJJJJJJJJJJJJJJJJJJJJJJJJJJJJ
JJJJJJJJJJJJJJJJJJJJJJJJJJJJJJJJJJJJJJJJJJJJJJJJJJJJJJJJJJJJJJJJJJJJJJJJJJJJJJJJJJJJJJJJJJJJJJJJJJJJJJJJJJJJJJJJJJJJJJJJJJJJJJJJJJJJJJJJJJJJJJJJJJJJJJJJJJJJJJJJ
JJJJJJJJJJJJJJJJJJJJJJJJJJJJJJJJJJJJJJJJJJJJJJJJJJJJJJJJJJJJJJJJJJJJJJJJJJJJJJJJJJJJJJJJJJJJJJJJJJJJJJJJJJJJJJJJJJJJJJJJJJJJJJJJJJJJJJJJJJJJJJJJJJJJJJJJJJJJJJJJ
JJJJJJJJJJJJJJJJJJJJJJJJJJJJJJJJJJJJJJJJJJJJJJJJJJJJJJJJJJJJJJJJJJJJJJJJJJJJJJJJJJJJJJJJJJJJJJJJJJJJJJJJJJJJJJJJJJJJJJJJJJJJJJJJJJJJJJJJJJJJJJJJJJJJJJJJJJJJJJJJ
JJJJJJJJJJJJJJJJJJJJJJJJJJJJJJJJJJJJJJJJJJJJJJJJJJJJJJJJJJJJJJJJJJJJJJJJJJJJJJJJJJJJJJJJJJJJJJJJJJJJJJJJJJJJJJJJJJJJJJJJJJJJJJJJJJJJJJJJJJJJJJJJJJJJJJJJJJJJJJJJ
JJJJJJJJJJJJJJJJJJJJJJJJJJJJJJJJJJJJJJJJJJJJJJJJJJJJJJJJJJJJJJJJJJJJJJJJJJJJJJJJJJJJJJJJJJJJJJJJJJJJJJJJJJJJJJJJJJJJJJJJJJJJJJJJJJJJJJJJJJJJJJJJJJJJJJJJJJJJJJJJ
JJJJJJJJJJJJJJJJJJJJJJJJJJJJJJJJJJJJJJJJJJJJJJJJJJJJJJJJJJJJJJJJJJJJJJJJJJJJJJJJJJJJJJJJJJJJJJJJJJJJJJJJJJJJJJJJJJJJJJJJJJJJJJJJJJJJJJJJJJJJJJJJJJJJJJJJJJJJJJJJ
JJJJJJJJJJJJJJJJJJJJJJJJJJJJJJJJJJJJJJJJJJJJJJJJJJJJJJJJJJJJJJJJJJJJJJJJJJJJJJJJJJJJJJJJJJJJJJJJJJJJJJJJJJJJJJJJJJJJJJJJJJJJJJJJJJJJJJJJJJJJJJJJJJJJJJJJJJJJJJJJ
JJJJJJJJJJJJJJJJJJJJJJJJJJJJJJJJJJJJJJJJJJJJJJJJJJJJJJJJJJJJJJJJJJJJJJJJJJJJJJJJJJJJJJJJJJJJJJJJJJJJJJJJJJJJJJJJJJJJJJJJJJJJJJJJJJJJJJJJJJJJJJJJJJJJJJJJJJJJJJJJ
JJJJJJJJJJJJJJJJJJJJJJJJJJJJJJJJJJJJJJJJJJJJJJJJJJJJJJJJJJJJJJJJJJJJJJJJJJJJJJJJJJJJJJJJJJJJJJJJJJJJJJJJJJJJJJJJJJJJJJJJJJJJJJJJJJJJJJJJJJJJJJJJJJJJJJJJJJJJJJJJ
JJJJJJJJJJJJJJJJJJJJJJJJJJJJJJJJJJJJJJJJJJJJJJJJJJJJJJJJJJJJJJJJJJJJJJJJJJJJJJJJJJJJJJJJJJJJJJJJJJJJJJJJJJJJJJJJJJJJJJJJJJJJJJJJJJJJJJJJJJJJJJJJJJJJJJJJJJJJJJJJ
mmmmmmmmmmmmmmmmmmmmmmmmmmmmmmmmmmmmmmmmmmmmmmmmmmmmmmmmmmmmmmmmmmmmmmmmmmmmmmmmmmmmmmmmmmmmmmmmmmmmmmmmmmmmmmmmmmmmmmmmmmmmmmmmmmmmmmmmmmmmmJJJJJJJJJJJJJJJJJJJ
YYYYYYYYYYYYYYYYYYYYYYYYYYYYYYYYYYYYYYYYYYYYYYYYYYYYYYYYYYYYYYYYYYYYYYYYYYYYYYYYYYYYYYYYYYYYYYYYYYYYYYYYYYYYYYYYYYYYYYYYYYYYYYYYYYYYYYYYYYYYmJJJJJJJJJJJJJJJJJJJ
YhhhhhhhhhhhhhhhhhhhhhhhhhhhhhhhhhhhhhhhhhhhhhhhhhhhhhhhhhhhhhhhhhhhhhhhhhhhhhhhhhhhhhhhhhhhhhhhhhhhhhhhhhhhhhhhhhhhhhhhhhhhhhhhhhhhhhhhhhhYmJJJJJJJJJJJJJJJJJJJ
YhoooooooooooooooooooooooooooooooooooooooooooooooooooooooooooooooooooooooooooooooooooooooooooooooooooooooooooooooooooooooooooooooooooooooohYmJJJJJJJJJJJJJJJJJJJ
YhoooooooooooooooooooooooooooooooooooooooooooooooooooooooooooooooooooooooooooooooooooooooooooooooooooooooooooooooooooooooooooooooooooooooohYmJJJJJJJJJJJJJJJJJJJ
YhoooooooooooooooooooooooooooooooooooooooooooooooooooooooooooooooooooooooooooooooooooooooooooooooooooooooooooooooooooooooooooooooooooooooohYmJJJJJJJJJJJJJJJJJJJ
YhoooooooooooooooooooooooooooooooooooooooooooooooooooooooooooooooooooooooooooooooooooooooooooooooooooooooooooooooooooooooooooooooooooooooohYmJJJJJJJJJJJJJJJJJJJ
YhoooooooooooooooooooooooooooooooooooooooooooooooooooooooooooooooooooooooooooooooooooooooooooooooooooooooooooooooooooooooooooooooooooooooohYmJJJJJJJJJJJJJJJJJJJ
YhoooooooooooooooooooooooooooooooooooooooooooooooooooooooooooooooooooooooooooooooooooooooooooooooooooooooooooooooooooooooooooooooooooooooohYmJJJJJJJJJJJJJJJJJJJ
YhoooooooooooooooooooooooooooooooooooooooooooooooooooooooooooooooooooooooooooooooooooooooooooooooooooooooooooooooooooooooooooooooooooooooohYmJJJJJJJJJJJJJJJJJJJ
YhoooooooooooooooooooooooooooooooooooooooooooooooooooooooooooooooooooooooooooooooooooooooooooooooooooooooooooooooooooooooooooooooooooooooohYmJJJJJJJJJJJJJJJJJJJ
YhoooooooooooooooooooooooooooooooooooooooooooooooooooooooooooooooooooooooooooooooooooooooooooooooooooooooooooooooooooooooooooooooooooooooohYmJJJJJJJJJJJJJJJJJJJ
YhoooooooooooooooooooooooooooooooooooooooooooooooooooooooooooooooooooooooooooooooooooooooooooooooooooooooooooooooooooooooooooooooooooooooohYmJJJJJJJJJJJJJJJJJJJ
YhoooooooooooooooooooooooooooooooooooooooooooooooooooooooooooooooooooooooooooooooooooooooooooooooooooooooooooooooooooooooooooooooooooooooohYmJJJJJJJJJJJJJJJJJJJ
YhoooooooooooooooooooooooooooooooooooooooooooooooooooooooooooooooooooooooooooooooooooooooooooooooooooooooooooooooooooooooooooooooooooooooohYmJJJJJJJJJJJJJJJJJJJ
YhoooooooooooooooooooooooooooooooooooooooooooooooooooooooooooooooooooooooooooooooooooooooooooooooooooooooooooooooooooooooooooooooooooooooohYmJJJJJJJJJJJJJJJJJJJ
YhoooooooooooooooooooooooooooooooooooooooooooooooooooooooooooooooooooooooooooooooooooooooooooooooooooooooooooooooooooooooooooooooooooooooohYmJJJJJJJJJJJJJJJJJJJ
YhoooooooooooooooooooooooooooooooooooooooooooooooooooooooooooooooooooooooooooooooooooooooooooooooooooooooooooooooooooooooooooooooooooooooohYmJJJJJJJJJJJJJJJJJJJ
YhoooooooooooooooooooooooooooooooooooooooooooooooooooooooooooooooooooooooooooooooooooooooooooooooooooooooooooooooooooooooooooooooooooooooohYmJJJJJJJJJJJJJJJJJJJ
YhoooooooooooooooooooooooooooooooooooooooooooooooooooooooooooooooooooooooooooooooooooooooooooooooooooooooooooooooooooooooooooooooooooooooohYmJJJJJJJJJJJJJJJJJJJ
YhoooooooooooooooooooooooooooooooooooooooooooooooooooooooooooooooooooooooooooooooooooooooooooooooooooooooooooooooooooooooooooooooooooooooohYmJJJJJJJJJJJJJJJJJJJ
YhoooooooooooooooooooooooooooooooooooooooooooooooooooooooooooooooooooooooooooooooooooooooooooooooooooooooooooooooooooooooooooooooooooooooohYmJJJJJJJJJJJJJJJJJJJ
YhoooooooooooooooooooooooooooooooooooooooooooooooooooooooooooooooooooooooooooooooooooooooooooooooooooooooooooooooooooooooooooooooooooooooohYmJJJJJJJJJJJJJJJJJJJ
YhoooooooooooooooooooooooooooooooooooooooooooooooooooooooooooooooooooooooooooooooooooooooooooooooooooooooooooooooooooooooooooooooooooooooohYmJJJJJJJJJJJJJJJJJJJ
YhoooooooooooooooooooooooooooooooooooooooooooooooooooooooooooooooooooooooooooooooooooooooooooooooooooooooooooooooooooooooooooooooooooooooohYmJJJJJJJJJJJJJJJJJJJ
YhoooooooooooooooooooooooooooooooooooooooooooooooooooooooooooooooooooooooooooooooooooooooooooooooooooooooooooooooooooooooooooooooooooooooohYmJJJJJJJJJJJJJJJJJJJ
YhoooooooooooooooooooooooooooooooooooooooooooooooooooooooooooooooooooooooooooooooooooooooooooooooooooooooooooooooooooooooooooooooooooooooohYmJJJJJJJJJJJJJJJJJJJ
YhoooooooooooooooooooooooooooooooooooooooooooooooooooooooooooooooooooooooooooooooooooooooooooooooooooooooooooooooooooooooooooooooooooooooohYmJJJJJJJJJJJJJJJJJJJ
YhoooooooooooooooooooooooooooooooooooooooooooooooooooooooooooooooooooooooooooooooooooooooooooooooooooooooooooooooooooooooooooooooooooooooohYmJJJJJJJJJJJJJJJJJJJ
YhoooooooooooooooooooooooooooooooooooooooooooooooooooooooooooooooooooooooooooooooooooooooooooooooooooooooooooooooooooooooooooooooooooooooohYmJJJJJJJJJJJJJJJJJJJ
YhoooooooooooooooooooooooooooooooooooooooooooooooooooooooooooooooooooooooooooooooooooooooooooooooooooooooooooooooooooooooooooooooooooooooohYmJJJJJJJJJJJJJJJJJJJ
YhoooooooooooooooooooooooooooooooooooooooooooooooooooooooooooooooooooooooooooooooooooooooooooooooooooooooooooooooooooooooooooooooooooooooohYmJJJJJJJJJJJJJJJJJJJ
YhoooooooooooooooooooooooooooooooooooooooooooooooooooooooooooooooooooooooooooooooooooooooooooooooooooooooooooooooooooooooooooooooooooooooohYmJJJJJJJJJJJJJJJJJJJ
YhoooooooooooooooooooooooooooooooooooooooooooooooooooooooooooooooooooooooooooooooooooooooooooooooooooooooooooooooooooooooooooooooooooooooohYmJJJJJJJJJJJJJJJJJJJ
YhoooooooooooooooooooooooooooooooooooooooooooooooooooooooooooooooooooooooooooooooooooooooooooooooooooooooooooooooooooooooooooooooooooooooohYmJJJJJJJJJJJJJJJJJJJ
YhoooooooooooooooooooooooooooooooooooooooooooooooooooooooooooooooooooooooooooooooooooooooooooooooooojjoooooooooooooooooooooooooooooooooooohYmJJJJJJJJJJJJJJJJJJJ
YhoooooooooooooooooooooooooooooooooooooooooooooooooooooooooooooooooooooooooooooooooooooooooooooooojjjjjjjooooooooooooooooooooooooooooooooohYmJJJJJJJJJJJJJJJJJJJ
YhooooooooooooooooooooooooooooooooooooooooooooooooooooooooooooooooooooooooooooooooooooooooooooooojjjjjUjjjjooooooooooooooooooooooooooooooohYmJJJJJJJJJJJJJJJJJJJ
YhoooooooooooooooooooooooooooooooooooooooooooooooooooooooooooooooooooooooooooooooooooooooooooooojjjjjjjjjjjooooooooooooooooooooooooooooooohYmJJJJJJJJJJJJJJJJJJJ
YhoooooooooooooooooooooooooooooooooooooooooooooooooooooooooooooooooooooooooooooooooooooooooooojjjjoojjjjjjoooooooooooooooooooooooooooooooohYmJJJJJJJJJJJJJJJJJJJ
YhoooooooooooooooooooooooooooooooooooooooooooooooooooooooooooooooooooooooooooooooooooooooooooojjjjoooooooooooooooooooooooooooooooooooooooohYmJJJJJJJJJJJJJJJJJJJ
YhoooooooooooooooooooooooooooooooooooooooooooooooooooooooooooooooooooooooooooooooooooooooooooojjjjoooooooooooooooooooooooooooooooooooooooohYmJJJJJJJJJJJJJJJJJJJ
YhooooooooooooooooooooooooooooooooooooooooooooooooooooooooooooooooooooooooooooooooooooooooooojjjjooooooooooooooooooooooooooooooooooooooooohYmJJJJJJJJJJJJJJJJJJJ
YhooooooooooooooooooooooooooooooooooooooooooooooooooooooooooooooooooooooooooooooooooooooooooojjooooooooooooooooooooooooooooooooooooooooooohYmJJJJJJJJJJJJJJJJJJJ
YhooooooooooooooooooooooooooooooooooooooooooooooooooooooooooooooooooooooooooooooooooooooooojjjjooooooooooooooooooooooooooooooooooooooooooohYmJJJJJJJJJJJJJJJJJJJ
YhooooooooooooooooooooooooooooooooooooooooooooooooooooooooooooooooooooooooooooooooooooooojjjjjoooooooooooooooooooooooooooooooooooooooooooohYmJJJJJJJJJJJJJJJJJJJ
YhooooooooooooooooooooooooooooooooooooooooooooooooooooooooooooooooooooooooooooooooooooooojjooooooooooooooooooooooooooooooooooooooooooooooohYmJJJJJJJJJJJJJJJJJJJ
YhooooooooooooooooooooooooooooooooooooooooooooooooooooooooooooooooooooooooooooooooooooooojjooooooooooooooooooooooooooooooooooooooooooooooohYmJJJJJJJJJJJJJJJJJJJ
YhoooooooooooooooooooooooooooooooooooooooooooooooooooooooooooooooooooooooooooooooooooooojjjooooooooooooooooooooooooooooooooooooooooooooooohYmJJJJJJJJJJJJJJJJJJJ
YhoooooooooooooooooooooooooooooooooooooooooooooooooooooooooooooooooooooooooooooooooooojjjjjooooooooooooooooooooooooooooooooooooooooooooooohYmJJJJJJJJJJJJJJJJJJJ
YhoooooooooooooooooooooooooooooooooooooooooooooooooooooooooooooooooooooooooooooooooooojjjjoooooooooooooooooooooooooooooooooooooooooooooooohYmJJJJJJJJJJJJJJJJJJJ
YhooooooooooooooooooooooooooooooooooooooooooooooooooooooooooooooooooooooooooooooooooojjjjooooooooooooooooooooooooooooooooooooooooooooooooohYmJJJJJJJJJJJJJJJJJJJ
YhooooooooooooooooooooooooooooooooooooooooooooooooooooooooooooooooooooooooooooooooooojjjoooooooooooooooooooooooooooooooooooooooooooooooooohYmJJJJJJJJJJJJJJJJJJJ
YhooooooooooooooooooooooooooooooooooooooooooooooooooooooooooooooooooooooooooooooooojjjjjoooooooooooooooooooooooooooooooooooooooooooooooooohYmJJJJJJJJJJJJJJJJJJJ
YhoooooooooooooooooooooooooooooooooooooooooooooooooooooooooooooooooooooooooooooooojjjjoooooooooooooooooooooooooooooooooooooooooooooooooooohYmJJJJJJJJJJJJJJJJJJJ
YhooooooooooooooooooooooooooooooooooooooooooooooooooooooooooooooooooooooooooooooojjjjjoooooooooooooooooooooooooooooooooooooooooooooooooooohYmJJJJJJJJJJJJJJJJJJJ
YhoooooooooooooooooooooooooooooooooooooooooooooooooooooooooooooooooooojoooooooojjjjjjjoooooooooooooooooooooooooooooooooooooooooooooooooooohYmJJJJJJJJJJJJJJJJJJJ
YhoooooooooooooooooooooooooooooooooooooooooooooooooooooooooooooooooooojjjoooooojjjoooooooooooooooooooooooooooooooooooooooooooooooooooooooohYmJJJJJJJJJJJJJJJJJJJ
YhoooooooooooooooooooooooooooooooooooooooooooooooooooooooojjjjjoooojjjjjjjjjooojjjoooooooooooooooooooooooooooooooooooooooooooooooooooooooohYmJJJJJJJJJJJJJJJJJJJ
YhoooooooooooooooooooooooooooooooooooooooooooooooooooooojjjjjjjjjjjjjjjjjjjjjjjjjooooooooooooooooooooooooooooooooooooooooooooooooooooooooohYmJJJJJJJJJJJJJJJJJJJ
YhooooooooooooooooooooooooooooooooooooooooooooooooooooooojUjjjjjjjjjjjjjjjjjjRRjjooooooooooooooooooooooooooooooooooooooooooooooooooooooooohYmJJJJJJJJJJJJJJJJJJJ
YhooooooooooooooooooooooooooooooooooooooooooooooooooooojjjjjjjCCCCCCCCCCCCCjjRjjjooooooooooooooooooooooooooooooooooooooooooooooooooooooooohYmJJJJJJJJJJJJJJJJJJJ
YhooooooooooooooooooooooooooooooooooooooooooooooooooooojjjjjjNRRRRRRRRRRRRRBjjjjjooooooooooooooooooooooooooooooooooooooooooooooooooooooooohYmJJJJJJJJJJJJJJJJJJJ
YhooooooooooooooooooooooooooooooooooooooooooooooooooooojjjjjjNRRRRRRRRRRRRRBRRjjoooooooooooooooooooooooooooooooooooooooooooooooooooooooooohYmJJJJJJJJJJJJJJJJJJJ
YhooooooooooooooooooooooooooooooooooooooooooooooooooooojjjjjjNRRRRRRRRRRRRRBjjjjoooooooooooooooooooooooooooooooooooooooooooooooooooooooooohYmJJJJJJJJJJJJJJJJJJJ
YhoooooooooooooooooooooooooooooooooooooooooooooooooooooojjjjjNRRRRRRRRRRRRRBjjjjoooooooooooooooooooooooooooooooooooooooooooooooooooooooooohYmJJJJJJJJJJJJJJJJJJJ
YhooooooooooooooooooooooooooooooooooooooooooooooooooooojjjjjINRRRRRRRRRRRRRBRRjjjooooooooooooooooooooooooooooooooooooooooooooooooooooooooohYmJJJJJJJJJJJJJJJJJJJ
YhoooooooooooooooooooooooooooooooooooooooooooooooooooojjjjjjjNRRRRRRRRRRRRRBjRjjjooooooooooooooooooooooooooooooooooooooooooooooooooooooooohYmJJJJJJJJJJJJJJJJJJJ
YhooooooooooooooooooooooooooooooooooooooooooooooooooojjjjjjjjRRRRRRRRRRRRRRRjjjjjjoooooooooooooooooooooooooooooooooooooooooooooooooooooooohYmJJJJJJJJJJJJJJJJJJJ
YhooooooooooooooooooooooooooooooooooooooooooooooooooojjjjjjjjRRRRRRRRdRRRRRRjjjjjjoooooooooooooooooooooooooooooooooooooooooooooooooooooooohYmJJJJJJJJJJJJJJJJJJJ
YhoooooooooooooooooooooooooooooooooooooooooooooooooooojjjjjRjNRRRRRRRRRRRRRBjjjjjooooooooooooooooooooooooooooooooooooooooooooooooooooooooohYmJJJJJJJJJJJJJJJJJJJ
YhoooooooooooooooooooooooooooooooooooooooooooooooooooooojjjRjNRRRRRRRRRRRRRBjjjjoooooooooooooooooooooooooooooooooooooooooooooooooooooooooohYmJJJJJJJJJJJJJJJJJJJ
YhooooooooooooooooooooooooooooooooooooooooooooooooooooojjjRRjNRRRRRRRRRRRRRBjjjjoooooooooooooooooooooooooooooooooooooooooooooooooooooooooohYmJJJJJJJJJJJJJJJJJJJ
YhooooooooooooooooooooooooooooooooooooooooooooooooooooojjRRRjNRRRRRRRRRRRRRBjjjjjooooooooooooooooooooooooooooooooooooooooooooooooooooooooohYmJJJJJJJJJJJJJJJJJJJ
YhooooooooooooooooooooooooooooooooooooooooooooooooooooojjRjjjNRRRRRRRRRRRRRBjjjjjjjooooooooooooooooooooooooooooooooooooooooooooooooooooooohYmJJJJJJJJJJJJJJJJJJJ
YhoooooooooooooooooooooooooooooooooooooooooooooooooooojjjjjjjNRRRRRRRRRRRRRBjjjjjjjooooooooooooooooooooooooooooooooooooooooooooooooooooooohYmJJJJJJJJJJJJJJJJJJJ
YhoooooooooooooooooooooooooooooooooooooooooooooooooooojjjjjjjNRRRRRRRRRRRRRBjjjjjjjooooooooooooooooooooooooooooooooooooooooooooooooooooooohYmJJJJJJJJJJJJJJJJJJJ
YhooooooooooooooooooooooooooooooooooooooooooooooooooooojjRjjjNRRRRRRRRRRRRRBjjjjjjjooooooooooooooooooooooooooooooooooooooooooooooooooooooohYmJJJJJJJJJJJJJJJJJJJ
YhoooooooooooooooooooooooooooooooooooooooooooooooooooooojRjjjjcccccccccccccjjjjjjjjooooooooooooooooooooooooooooooooooooooooooooooooooooooohYmJJJJJJJJJJJJJJJJJJJ
YhooooooooooooooooooooooooooooooooooooooooooooooooooooojjRjjjjjjjjjjjjjjjjjjjUjjjjjooooooooooooooooooooooooooooooooooooooooooooooooooooooohYmJJJJJJJJJJJJJJJJJJJ
YhooooooooooooooooooooooooooooooooooooooooooooooooooooojjjjjjjjjjjjjjjjjjjjjjjjjjjoooooooooooooooooooooooooooooooooooooooooooooooooooooooohYmJJJJJJJJJJJJJJJJJJJ
YhoooooooooooooooooooooooooooooooooooooooooooooooooooojjjjjjjjjjjjjjjjjoojjjjjjjjooooooooooooooooooooooooooooooooooooooooooooooooooooooooohYmJJJJJJJJJJJJJJJJJJJ
YhoooooooooooooooooooooooooooooooooooooooooooooooooooojjjjjjjjjjoooooooooojjjjjjoooooooooooooooooooooooooooooooooooooooooooooooooooooooooohYmJJJJJJJJJJJJJJJJJJJ
YhoooooooooooooooooooooooooooooooooooooooooooooooooooojjjoooooooooooooooooojjjjooooooooooooooooooooooooooooooooooooooooooooooooooooooooooohYmJJJJJJJJJJJJJJJJJJJ
YhooooooooooooooooooooooooooooooooooooooooooooooooooojjjjooooooooooooooooooooooooooooooooooooooooooooooooooooooooooooooooooooooooooooooooohYmJJJJJJJJJJJJJJJJJJJ
YhooooooooooooooooooooooooooooooooooooooooooooooooooojjooooooooooooooooooooooooooooooooooooooooooooooooooooooooooooooooooooooooooooooooooohYmJJJJJJJJJJJJJJJJJJJ
YhoooooooooooooooooooooooooooooooooooooooooooooooooojjjooooooooooooooooooooooooooooooooooooooooooooooooooooooooooooooooooooooooooooooooooohYmJJJJJJJJJJJJJJJJJJJ
YhoooooooooooooooooooooooooooooooooooooooooooooooooojjjooooooooooooooooooooooooooooooooooooooooooooooooooooooooooooooooooooooooooooooooooohYmJJJJJJJJJJJJJJJJJJJ
YhooooooooooooooooooooooooooooooooooooooooooooooooojjjjooooooooooooooooooooooooooooooooooooooooooooooooooooooooooooooooooooooooooooooooooohYmJJJJJJJJJJJJJJJJJJJ
YhooooooooooooooooooooooooooooooooooooooooooooooooojjjoooooooooooooooooooooooooooooooooooooooooooooooooooooooooooooooooooooooooooooooooooohYmJJJJJJJJJJJJJJJJJJJ
YhooooooooooooooooooooooooooooooooooooooooooooooooojjjoooooooooooooooooooooooooooooooooooooooooooooooooooooooooooooooooooooooooooooooooooohYmJJJJJJJJJJJJJJJJJJJ
YhooooooooooooooooooooooooooooooooooooooooooooooooojjooooooooooooooooooooooooooooooooooooooooooooooooooooooooooooooooooooooooooooooooooooohYmJJJJJJJJJJJJJJJJJJJ
YhoooooooooooooooooooooooooooooooooooooooooooooojjjjoooooooooooooooooooooooooooooooooooooooooooooooooooooooooooooooooooooooooooooooooooooohYmJJJJJJJJJJJJJJJJJJJ
YhoooooooooooooooooooooooooooooooooooooooooooooojjjjoooooooooooooooooooooooooooooooooooooooooooooooooooooooooooooooooooooooooooooooooooooohYmJJJJJJJJJJJJJJJJJJJ
YhoooooooooooooooooooooooooooooooooooooooooooooojjjjoooooooooooooooooooooooooooooooooooooooooooooooooooooooooooooooooooooooooooooooooooooohYmJJJJJJJJJJJJJJJJJJJ
YhoooooooooooooooooooooooooooooooooooooooooojjjjjjjjoooooooooooooooooooooooooooooooooooooooooooooooooooooooooooooooooooooooooooooooooooooohYmJJJJJJJJJJJJJJJJJJJ
YhooooooooooooooooooooooooooooooooooooooooooojjjjjjooooooooooooooooooooooooooooooooooooooooooooooooooooooooooooooooooooooooooooooooooooooohYmJJJJJJJJJJJJJJJJJJJ
YhoooooooooooooooooooooooooooooooooooooooooooojjjjjooooooooooooooooooooooooooooooooooooooooooooooooooooooooooooooooooooooooooooooooooooooohYmJJJJJJJJJJJJJJJJJJJ
YhoooooooooooooooooooooooooooooooooooooooooooojjjjjooooooooooooooooooooooooooooooooooooooooooooooooooooooooooooooooooooooooooooooooooooooohYmJJJJJJJJJJJJJJJJJJJ
YhooooooooooooooooooooooooooooooooooooooooooooojjjoooooooooooooooooooooooooooooooooooooooooooooooooooooooooooooooooooooooooooooooooooooooohYmJJJJJJJJJJJJJJJJJJJ
YhooooooooooooooooooooooooooooooooooooooooooooojjjoooooooooooooooooooooooooooooooooooooooooooooooooooooooooooooooooooooooooooooooooooooooohYmJJJJJJJJJJJJJJJJJJJ
YhoooooooooooooooooooooooooooooooooooooooooooojjjjoooooooooooooooooooooooooooooooooooooooooooooooooooooooooooooooooooooooooooooooooooooooohYmJJJJJJJJJJJJJJJJJJJ
YhooooooooooooooooooooooooooooooooooooooooooojjjjooooooooooooooooooooooooooooooooooooooooooooooooooooooooooooooooooooooooooooooooooooooooohYmJJJJJJJJJJJJJJJJJJJ
YhooooooooooooooooooooooooooooooooooooooooooojjjjooooooooooooooooooooooooooooooooooooooooooooooooooooooooooooooooooooooooooooooooooooooooohYmJJJJJJJJJJJJJJJJJJJ
YhoooooooooooooooooooooooooooooooooooooooooojjjjjooooooooooooooooooooooooooooooooooooooooooooooooooooooooooooooooooooooooooooooooooooooooohYmJJJJJJJJJJJJJJJJJJJ
YhoooooooooooooooooooooooooooooooooooooooooojjjjoooooooooooooooooooooooooooooooooooooooooooooooooooooooooooooooooooooooooooooooooooooooooohYmJJJJJJJJJJJJJJJJJJJ
YhooooooooooooooooooooooooooooooooooooooooojjjjooooooooooooooooooooooooooooooooooooooooooooooooooooooooooooooooooooooooooooooooooooooooooohYmJJJJJJJJJJJJJJJJJJJ
YhoooooooooooooooooooooooooooooooooooooooojjjjoooooooooooooooooooooooooooooooooooooooooooooooooooooooooooooooooooooooooooooooooooooooooooohYmJJJJJJJJJJJJJJJJJJJ
YhoooooooooooooooooooooooooooooooooooooooojjjooooooooooooooooooooooooooooooooooooooooooooooooooooooooooooooooooooooooooooooooooooooooooooohYmJJJJJJJJJJJJJJJJJJJ
YhoooooooooooooooooooooooooooooooooooooooojUjooooooooooooooooooooooooooooooooooooooooooooooooooooooooooooooooooooooooooooooooooooooooooooohYmJJJJJJJJJJJJJJJJJJJ
YhoooooooooooooooooooooooooooooooooooooooojjjooooooooooooooooooooooooooooooooooooooooooooooooooooooooooooooooooooooooooooooooooooooooooooohYmJJJJJJJJJJJJJJJJJJJ
YhoooooooooooooooooooooooooooooooooooooooojjoooooooooooooooooooooooooooooooooooooooooooooooooooooooooooooooooooooooooooooooooooooooooooooohYmJJJJJJJJJJJJJJJJJJJ
YhooooooooooooooooooooooooooooooooooooooojjjoooooooooooooooooooooooooooooooooooooooooooooooooooooooooooooooooooooooooooooooooooooooooooooohYmJJJJJJJJJJJJJJJJJJJ
YhooooooooooooooooooooooooooooooooooooooojjooooooooooooooooooooooooooooooooooooooooooooooooooooooooooooooooooooooooooooooooooooooooooooooohYmJJJJJJJJJJJJJJJJJJJ
YhooooooooooooooooooooooooooooooooooooooojjooooooooooooooooooooooooooooooooooooooooooooooooooooooooooooooooooooooooooooooooooooooooooooooohYmJJJJJJJJJJJJJJJJJJJ
YhoooooooooooooooooooooooooooooooooooooooooooooooooooooooooooooooooooooooooooooooooooooooooooooooooooooooooooooooooooooooooooooooooooooooohYmJJJJJJJJJJJJJJJJJJJ
YhoooooooooooooooooooooooooooooooooooooooooooooooooooooooooooooooooooooooooooooooooooooooooooooooooooooooooooooooooooooooooooooooooooooooohYmJJJJJJJJJJJJJJJJJJJ
YhoooooooooooooooooooooooooooooooooooooooooooooooooooooooooooooooooooooooooooooooooooooooooooooooooooooooooooooooooooooooooooooooooooooooohYmJJJJJJJJJJJJJJJJJJJ
YhoooooooooooooooooooooooooooooooooooooooooooooooooooooooooooooooooooooooooooooooooooooooooooooooooooooooooooooooooooooooooooooooooooooooohYmJJJJJJJJJJJJJJJJJJJ
YhoooooooooooooooooooooooooooooooooooooooooooooooooooooooooooooooooooooooooooooooooooooooooooooooooooooooooooooooooooooooooooooooooooooooohYmJJJJJJJJJJJJJJJJJJJ
YhoooooooooooooooooooooooooooooooooooooooooooooooooooooooooooooooooooooooooooooooooooooooooooooooooooooooooooooooooooooooooooooooooooooooohYmJJJJJJJJJJJJJJJJJJJ
YhoooooooooooooooooooooooooooooooooooooooooooooooooooooooooooooooooooooooooooooooooooooooooooooooooooooooooooooooooooooooooooooooooooooooohYmJJJJJJJJJJJJJJJJJJJ
YhoooooooooooooooooooooooooooooooooooooooooooooooooooooooooooooooooooooooooooooooooooooooooooooooooooooooooooooooooooooooooooooooooooooooohYmJJJJJJJJJJJJJJJJJJJ
YhoooooooooooooooooooooooooooooooooooooooooooooooooooooooooooooooooooooooooooooooooooooooooooooooooooooooooooooooooooooooooooooooooooooooohYmJJJJJJJJJJJJJJJJJJJ
YhoooooooooooooooooooooooooooooooooooooooooooooooooooooooooooooooooooooooooooooooooooooooooooooooooooooooooooooooooooooooooooooooooooooooohYmJJJJJJJJJJJJJJJJJJJ
YhoooooooooooooooooooooooooooooooooooooooooooooooooooooooooooooooooooooooooooooooooooooooooooooooooooooooooooooooooooooooooooooooooooooooohYmJJJJJJJJJJJJJJJJJJJ
YhoooooooooooooooooooooooooooooooooooooooooooooooooooooooooooooooooooooooooooooooooooooooooooooooooooooooooooooooooooooooooooooooooooooooohYmJJJJJJJJJJJJJJJJJJJ
YhoooooooooooooooooooooooooooooooooooooooooooooooooooooooooooooooooooooooooooooooooooooooooooooooooooooooooooooooooooooooooooooooooooooooohYmJJJJJJJJJJJJJJJJJJJ
YhoooooooooooooooooooooooooooooooooooooooooooooooooooooooooooooooooooooooooooooooooooooooooooooooooooooooooooooooooooooooooooooooooooooooohYmJJJJJJJJJJJJJJJJJJJ
YhoooooooooooooooooooooooooooooooooooooooooooooooooooooooooooooooooooooooooooooooooooooooooooooooooooooooooooooooooooooooooooooooooooooooohYmJJJJJJJJJJJJJJJJJJJ
YhoooooooooooooooooooooooooooooooooooooooooooooooooooooooooooooooooooooooooooooooooooooooooooooooooooooooooooooooooooooooooooooooooooooooohYmJJJJJJJJJJJJJJJJJJJ
YhoooooooooooooooooooooooooooooooooooooooooooooooooooooooooooooooooooooooooooooooooooooooooooooooooooooooooooooooooooooooooooooooooooooooohYmJJJJJJJJJJJJJJJJJJJ
YhoooooooooooooooooooooooooooooooooooooooooooooooooooooooooooooooooooooooooooooooooooooooooooooooooooooooooooooooooooooooooooooooooooooooohYmJJJJJJJJJJJJJJJJJJJ
YhoooooooooooooooooooooooooooooooooooooooooooooooooooooooooooooooooooooooooooooooooooooooooooooooooooooooooooooooooooooooooooooooooooooooohYmJJJJJJJJJJJJJJJJJJJ
YhoooooooooooooooooooooooooooooooooooooooooooooooooooooooooooooooooooooooooooooooooooooooooooooooooooooooooooooooooooooooooooooooooooooooohYmJJJJJJJJJJJJJJJJJJJ
YhoooooooooooooooooooooooooooooooooooooooooooooooooooooooooooooooooooooooooooooooooooooooooooooooooooooooooooooooooooooooooooooooooooooooohYmJJJJJJJJJJJJJJJJJJJ
YhoooooooooooooooooooooooooooooooooooooooooooooooooooooooooooooooooooooooooooooooooooooooooooooooooooooooooooooooooooooooooooooooooooooooohYmJJJJJJJJJJJJJJJJJJJ
YhoooooooooooooooooooooooooooooooooooooooooooooooooooooooooooooooooooooooooooooooooooooooooooooooooooooooooooooooooooooooooooooooooooooooohYmJJJJJJJJJJJJJJJJJJJ
YhoooooooooooooooooooooooooooooooooooooooooooooooooooooooooooooooooooooooooooooooooooooooooooooooooooooooooooooooooooooooooooooooooooooooohYmJJJJJJJJJJJJJJJJJJJ
YhhhhhhhhhhhhhhhhhhhhhhhhhhhhhhhhhhhhhhhhhhhhhhhhhhhhhhhhhhhhhhhhhhhhhhhhhhhhhhhhhhhhhhhhhhhhhhhhhhhhhhhhhhhhhhhhhhhhhhhhhhhhhhhhhhhhhhhhhhYmJJJJJJJJJJJJJJJJJJJ
YYYYYYYYYYYYYYYYYYYYYYYYYYYYYYYYYYYYYYYYYYYYYYYYYYYYYYYYYYYYYYYYYYYYYYYYYYYYYYYYYYYYYYYYYYYYYYYYYYYYYYYYYYYYYYYYYYYYYYYYYYYYYYYYYYYYYYYYYYYYmJJJJJJJJJJJJJJJJJJJ
"}
