//MAP CONVERTED BY dmm2tgm.py THIS HEADER COMMENT PREVENTS RECONVERSION, DO NOT REMOVE
"a" = (
/turf/simulated/floor/lava/warm,
/area/submap/crystalcore/purple/eight)
"j" = (
/turf/template_noop,
/area/template_noop)

(1,1,1) = {"
j
j
j
j
j
j
j
j
j
j
j
j
j
j
j
a
a
a
a
a
a
a
a
a
j
j
j
j
j
j
j
j
j
j
j
j
j
j
j
j
"}
(2,1,1) = {"
j
j
j
j
j
j
j
j
j
j
j
a
a
a
a
a
a
a
a
a
a
a
a
a
a
a
a
a
j
j
j
j
j
j
j
j
j
j
j
j
"}
(3,1,1) = {"
j
j
j
j
j
j
j
a
a
a
a
a
a
a
a
a
a
a
a
a
a
a
a
a
a
a
a
a
a
a
a
a
a
j
j
j
j
j
j
j
"}
(4,1,1) = {"
j
j
j
a
a
a
a
a
a
a
a
a
a
a
a
a
a
a
a
a
a
a
a
a
a
a
a
a
a
a
a
a
a
a
a
a
a
j
j
j
"}
(5,1,1) = {"
j
a
a
a
a
a
a
a
a
a
a
a
a
a
a
a
a
a
a
a
a
a
a
a
a
a
a
a
a
a
a
a
a
a
a
a
a
a
a
j
"}
(6,1,1) = {"
a
a
a
a
a
a
a
a
a
a
a
a
a
a
a
a
a
a
a
a
a
a
a
a
a
a
a
a
a
a
a
a
a
a
a
a
a
a
a
a
"}
(7,1,1) = {"
a
a
a
a
a
a
a
a
a
a
a
a
a
a
a
a
a
a
a
a
a
a
a
a
a
a
a
a
a
a
a
a
a
a
a
a
a
a
a
a
"}
(8,1,1) = {"
a
a
a
a
a
a
a
a
a
a
a
a
a
a
a
a
a
a
a
a
a
a
a
a
a
a
a
a
a
a
a
a
a
a
a
a
a
a
a
a
"}
(9,1,1) = {"
j
a
a
a
a
a
a
a
a
a
a
a
a
a
a
a
a
a
a
a
a
a
a
a
a
a
a
a
a
a
a
a
a
a
a
a
a
a
a
j
"}
(10,1,1) = {"
j
j
j
a
a
a
a
a
a
a
a
a
a
a
a
a
a
a
a
a
a
a
a
a
a
a
a
a
a
a
a
a
a
a
a
a
a
j
j
j
"}
(11,1,1) = {"
j
j
j
j
j
j
j
a
a
a
a
a
a
a
a
a
a
a
a
a
a
a
a
a
a
a
a
a
a
a
a
a
a
j
j
j
j
j
j
j
"}
(12,1,1) = {"
j
j
j
j
j
j
j
j
j
j
j
a
a
a
a
a
a
a
a
a
a
a
a
a
a
a
a
a
j
j
j
j
j
j
j
j
j
j
j
j
"}
(13,1,1) = {"
j
j
j
j
j
j
j
j
j
j
j
j
j
j
j
a
a
a
a
a
a
a
a
a
j
j
j
j
j
j
j
j
j
j
j
j
j
j
j
j
"}
