//MAP CONVERTED BY dmm2tgm.py THIS HEADER COMMENT PREVENTS RECONVERSION, DO NOT REMOVE
"a" = (
/turf/template_noop,
/area/template_noop)
"f" = (
/obj/structure/table/steel,
/turf/simulated/floor/outdoors/crystal_planet/purplesand,
/area/submap/crystalcore/purple/eleven)
"o" = (
/obj/item/weapon/material/barbedwire{
	anchored = 1;
	icon_state = "barbedwire-out"
	},
/turf/simulated/floor/outdoors/crystal_planet/purplesand,
/area/submap/crystalcore/purple/eleven)
"t" = (
/turf/simulated/floor/outdoors/crystal_planet/purplesand,
/area/submap/crystalcore/purple/eleven)
"K" = (
/obj/structure/table/steel,
/obj/item/weapon/pickaxe/silver,
/turf/simulated/floor/outdoors/crystal_planet/purplesand,
/area/submap/crystalcore/purple/eleven)
"L" = (
/turf/simulated/wall,
/area/submap/crystalcore/purple/eleven)
"O" = (
/obj/structure/girder,
/turf/simulated/floor/outdoors/crystal_planet/purplesand,
/area/submap/crystalcore/purple/eleven)
"S" = (
/obj/structure/table/steel,
/obj/item/weapon/storage/toolbox/syndicate/powertools,
/turf/simulated/floor/outdoors/crystal_planet/purplesand,
/area/submap/crystalcore/purple/eleven)

(1,1,1) = {"
a
a
a
a
a
a
a
a
a
a
a
a
a
a
a
a
a
"}
(2,1,1) = {"
a
a
a
a
a
a
a
a
a
a
a
a
a
a
a
a
a
"}
(3,1,1) = {"
a
a
a
a
a
a
a
a
a
a
a
a
a
a
a
a
a
"}
(4,1,1) = {"
a
a
a
a
a
L
t
t
t
t
t
O
a
a
a
a
a
"}
(5,1,1) = {"
a
a
a
a
a
L
o
t
t
t
o
L
a
a
a
a
a
"}
(6,1,1) = {"
a
a
a
O
L
L
t
t
t
t
t
L
O
O
a
a
a
"}
(7,1,1) = {"
a
a
a
t
t
t
t
t
t
t
t
t
o
t
a
a
a
"}
(8,1,1) = {"
a
a
a
t
o
t
t
t
f
t
t
t
t
t
a
a
a
"}
(9,1,1) = {"
a
a
a
t
o
t
t
K
f
S
t
t
t
t
a
a
a
"}
(10,1,1) = {"
a
a
a
t
o
t
t
t
f
t
t
t
o
t
a
a
a
"}
(11,1,1) = {"
a
a
a
t
t
t
t
t
t
t
t
t
o
t
a
a
a
"}
(12,1,1) = {"
a
a
a
L
O
L
t
t
t
t
t
L
L
L
a
a
a
"}
(13,1,1) = {"
a
a
a
a
a
L
t
t
o
o
o
L
a
a
a
a
a
"}
(14,1,1) = {"
a
a
a
a
a
O
t
t
t
t
t
O
a
a
a
a
a
"}
(15,1,1) = {"
a
a
a
a
a
a
a
a
a
a
a
a
a
a
a
a
a
"}
(16,1,1) = {"
a
a
a
a
a
a
a
a
a
a
a
a
a
a
a
a
a
"}
(17,1,1) = {"
a
a
a
a
a
a
a
a
a
a
a
a
a
a
a
a
a
"}
