//MAP CONVERTED BY dmm2tgm.py THIS HEADER COMMENT PREVENTS RECONVERSION, DO NOT REMOVE
"a" = (
/turf/template_noop,
/area/template_noop)
"o" = (
/obj/random/landmine,
/turf/simulated/floor/outdoors/crystal_planet/purplesand,
/area/submap/crystalcore/purple/fifteen)
"G" = (
/turf/simulated/floor/outdoors/crystal_planet/purplesand,
/area/submap/crystalcore/purple/fifteen)

(1,1,1) = {"
a
a
a
a
a
a
G
G
G
a
a
a
a
a
a
"}
(2,1,1) = {"
a
a
a
a
a
G
G
G
o
G
a
a
a
a
a
"}
(3,1,1) = {"
a
a
a
a
G
o
G
G
G
G
G
a
a
a
a
"}
(4,1,1) = {"
a
a
a
G
G
G
G
o
G
G
G
G
a
a
a
"}
(5,1,1) = {"
a
a
G
G
G
G
G
G
G
G
o
G
G
a
a
"}
(6,1,1) = {"
a
G
G
G
G
G
o
G
G
G
G
G
G
G
a
"}
(7,1,1) = {"
G
G
G
G
o
G
G
G
G
G
G
G
G
o
G
"}
(8,1,1) = {"
G
o
G
G
G
G
G
G
G
G
G
G
G
G
G
"}
(9,1,1) = {"
G
G
G
G
G
G
G
G
G
o
G
G
G
G
G
"}
(10,1,1) = {"
a
G
G
G
o
G
G
G
G
G
G
G
G
G
a
"}
(11,1,1) = {"
a
a
G
G
G
G
G
o
G
G
G
o
G
a
a
"}
(12,1,1) = {"
a
a
a
G
G
G
G
G
G
G
G
G
a
a
a
"}
(13,1,1) = {"
a
a
a
a
G
G
G
G
o
G
G
a
a
a
a
"}
(14,1,1) = {"
a
a
a
a
a
G
G
o
G
G
a
a
a
a
a
"}
(15,1,1) = {"
a
a
a
a
a
a
G
G
G
a
a
a
a
a
a
"}
