//MAP CONVERTED BY dmm2tgm.py THIS HEADER COMMENT PREVENTS RECONVERSION, DO NOT REMOVE
"a" = (
/turf/template_noop,
/area/template_noop)
"w" = (
/obj/random/outcrop,
/turf/simulated/floor/outdoors/crystal_planet/purplesand,
/area/submap/crystalcore/purple/fourteen)
"z" = (
/turf/simulated/wall/uranium,
/area/submap/crystalcore/purple/fourteen)
"V" = (
/turf/simulated/mineral/purplecrystal,
/area/submap/crystalcore/purple/fourteen)

(1,1,1) = {"
a
a
a
a
a
a
a
a
a
a
a
a
a
a
a
"}
(2,1,1) = {"
a
a
a
a
a
a
a
V
a
a
a
a
a
a
a
"}
(3,1,1) = {"
a
a
a
a
a
a
V
V
V
a
a
a
a
a
a
"}
(4,1,1) = {"
a
a
a
a
a
V
V
w
V
V
a
a
a
a
a
"}
(5,1,1) = {"
a
a
a
a
V
V
w
w
w
V
V
a
a
a
a
"}
(6,1,1) = {"
a
a
a
V
V
w
w
w
w
w
V
V
a
a
a
"}
(7,1,1) = {"
a
a
V
V
w
w
w
w
w
w
w
V
V
a
a
"}
(8,1,1) = {"
a
V
V
w
w
w
w
z
w
w
w
w
V
V
a
"}
(9,1,1) = {"
a
a
V
V
w
w
w
w
w
w
w
V
V
a
a
"}
(10,1,1) = {"
a
a
a
V
V
w
w
w
w
w
V
V
a
a
a
"}
(11,1,1) = {"
a
a
a
a
V
V
w
w
w
V
V
a
a
a
a
"}
(12,1,1) = {"
a
a
a
a
a
V
V
w
V
V
a
a
a
a
a
"}
(13,1,1) = {"
a
a
a
a
a
a
V
V
V
a
a
a
a
a
a
"}
(14,1,1) = {"
a
a
a
a
a
a
a
V
a
a
a
a
a
a
a
"}
(15,1,1) = {"
a
a
a
a
a
a
a
a
a
a
a
a
a
a
a
"}
