//MAP CONVERTED BY dmm2tgm.py THIS HEADER COMMENT PREVENTS RECONVERSION, DO NOT REMOVE
"a" = (
/turf/simulated/floor/outdoors/crystal_planet/purplesand,
/area/submap/crystalcore/purple/four)
"l" = (
/turf/template_noop,
/area/template_noop)
"r" = (
/mob/living/simple_mob/mechanical/mining_drone,
/turf/simulated/floor/lava/warm,
/area/submap/crystalcore/purple/four)
"S" = (
/obj/random/outcrop,
/turf/simulated/floor/outdoors/crystal_planet/purplesand,
/area/submap/crystalcore/purple/four)
"Z" = (
/turf/simulated/floor/lava/warm,
/area/submap/crystalcore/purple/four)

(1,1,1) = {"
l
l
l
l
l
l
l
l
l
l
l
l
l
l
l
l
l
l
l
l
l
l
l
l
l
l
l
l
l
l
l
l
l
l
l
"}
(2,1,1) = {"
l
l
l
l
l
l
l
a
a
a
a
l
l
l
l
l
l
l
l
l
l
l
l
l
l
l
l
l
l
l
l
l
l
l
l
"}
(3,1,1) = {"
l
l
l
l
l
l
a
a
a
a
a
a
l
l
l
l
l
l
l
l
l
l
l
l
l
l
l
l
l
l
l
l
l
l
l
"}
(4,1,1) = {"
l
l
l
l
l
a
a
a
a
S
a
a
a
l
l
l
l
l
l
l
l
l
l
l
l
l
l
l
l
l
l
l
l
l
l
"}
(5,1,1) = {"
l
l
l
l
a
S
a
a
a
a
a
a
a
a
l
l
l
l
l
l
l
l
l
l
l
l
l
l
l
l
l
l
l
l
l
"}
(6,1,1) = {"
l
l
l
a
a
a
a
a
a
a
a
a
S
a
a
a
a
S
a
a
a
l
l
l
l
l
l
l
l
l
l
l
l
l
l
"}
(7,1,1) = {"
l
l
l
a
a
a
a
a
a
a
a
a
a
a
a
a
a
a
a
a
S
a
l
l
l
l
l
l
l
l
l
l
l
l
l
"}
(8,1,1) = {"
l
l
a
a
a
a
a
a
a
a
a
a
a
a
a
a
a
a
a
a
a
a
a
l
l
l
l
l
l
l
l
l
l
l
l
"}
(9,1,1) = {"
l
l
a
S
a
a
a
a
S
a
a
a
a
a
a
S
a
a
a
a
a
a
a
a
l
l
l
l
l
l
l
l
l
l
l
"}
(10,1,1) = {"
l
a
a
a
a
a
a
a
a
a
a
a
a
a
a
a
a
a
S
a
a
a
a
a
a
a
a
l
l
l
l
l
l
l
l
"}
(11,1,1) = {"
l
a
a
a
a
a
a
a
a
Z
a
S
a
a
a
a
a
a
a
a
a
a
a
a
S
a
a
a
l
l
l
l
l
l
l
"}
(12,1,1) = {"
l
a
a
a
S
a
a
a
Z
Z
Z
Z
a
a
Z
a
a
a
a
a
a
a
a
a
a
a
a
a
a
l
l
l
l
l
l
"}
(13,1,1) = {"
l
a
a
a
a
a
a
Z
Z
Z
Z
Z
Z
Z
Z
Z
Z
a
a
a
S
a
a
a
a
a
a
a
a
l
l
l
l
l
l
"}
(14,1,1) = {"
l
a
a
a
a
a
a
a
Z
Z
Z
Z
Z
Z
Z
Z
Z
Z
a
a
a
a
a
a
a
a
a
S
a
a
l
l
l
l
l
"}
(15,1,1) = {"
l
l
a
a
a
S
a
a
Z
Z
Z
Z
Z
Z
Z
Z
Z
Z
Z
a
a
a
a
S
a
a
a
a
a
a
l
l
l
l
l
"}
(16,1,1) = {"
l
l
a
a
a
a
a
S
a
Z
Z
Z
Z
Z
Z
r
Z
Z
Z
a
a
a
a
a
a
a
a
a
a
a
a
l
l
l
l
"}
(17,1,1) = {"
l
l
S
a
a
a
a
a
a
a
Z
Z
Z
Z
Z
Z
Z
Z
Z
a
a
a
S
a
a
a
a
a
a
a
S
a
l
l
l
"}
(18,1,1) = {"
l
l
a
a
a
a
a
a
a
a
a
Z
Z
Z
Z
Z
Z
Z
a
a
a
a
a
a
a
a
a
a
a
a
a
a
l
l
l
"}
(19,1,1) = {"
l
l
a
a
a
S
a
a
a
a
a
a
Z
Z
Z
Z
Z
a
a
a
a
a
a
a
a
Z
Z
a
S
a
a
a
a
l
l
"}
(20,1,1) = {"
l
l
a
a
a
a
a
a
a
a
a
a
a
Z
a
a
a
a
a
a
a
S
a
a
Z
Z
Z
a
a
a
a
a
a
l
l
"}
(21,1,1) = {"
l
l
a
a
a
a
a
a
a
S
a
a
a
a
a
a
a
a
a
a
a
a
a
Z
Z
Z
Z
a
a
a
a
a
l
l
l
"}
(22,1,1) = {"
l
l
S
a
a
a
a
a
a
a
a
S
a
a
a
a
a
a
a
S
a
Z
Z
Z
r
Z
a
a
a
a
a
a
l
l
l
"}
(23,1,1) = {"
l
l
a
a
a
a
S
a
a
a
a
a
a
a
a
a
S
a
a
a
a
Z
Z
Z
Z
a
a
a
a
a
a
a
l
l
l
"}
(24,1,1) = {"
l
l
a
a
S
a
a
a
a
a
a
a
a
a
a
a
a
a
a
a
a
a
a
Z
a
a
a
a
a
S
a
l
l
l
l
"}
(25,1,1) = {"
l
a
a
a
a
a
a
a
a
a
a
a
Z
Z
a
a
a
a
a
a
a
a
a
a
a
a
S
a
a
a
l
l
l
l
l
"}
(26,1,1) = {"
l
a
a
a
a
a
a
a
a
Z
Z
Z
Z
Z
Z
a
a
a
S
a
a
S
a
a
a
a
a
a
a
l
l
l
l
l
l
"}
(27,1,1) = {"
l
a
a
a
a
S
a
a
a
Z
Z
r
Z
Z
Z
a
a
a
a
a
a
a
a
a
S
a
a
a
l
l
l
l
l
l
l
"}
(28,1,1) = {"
l
a
a
a
a
a
a
a
a
a
Z
Z
Z
a
a
a
a
a
a
a
a
a
a
a
a
a
a
l
l
l
l
l
l
l
l
"}
(29,1,1) = {"
l
l
a
S
a
a
a
a
a
a
Z
Z
a
a
a
a
a
a
a
a
a
a
S
a
a
a
a
l
l
l
l
l
l
l
l
"}
(30,1,1) = {"
l
l
l
a
a
a
a
a
S
a
a
a
a
a
a
a
S
a
a
a
a
a
a
a
a
a
l
l
l
l
l
l
l
l
l
"}
(31,1,1) = {"
l
l
l
l
l
a
a
a
a
a
a
a
a
a
a
a
a
a
a
a
a
a
a
a
a
l
l
l
l
l
l
l
l
l
l
"}
(32,1,1) = {"
l
l
l
l
l
l
a
a
a
a
a
a
a
S
a
a
a
a
a
l
a
a
a
a
l
l
l
l
l
l
l
l
l
l
l
"}
(33,1,1) = {"
l
l
l
l
l
l
l
a
a
a
S
a
a
a
a
a
a
l
l
l
l
l
l
l
l
l
l
l
l
l
l
l
l
l
l
"}
(34,1,1) = {"
l
l
l
l
l
l
l
l
l
a
a
a
a
a
a
l
l
l
l
l
l
l
l
l
l
l
l
l
l
l
l
l
l
l
l
"}
(35,1,1) = {"
l
l
l
l
l
l
l
l
l
l
l
l
l
l
l
l
l
l
l
l
l
l
l
l
l
l
l
l
l
l
l
l
l
l
l
"}
