//MAP CONVERTED BY dmm2tgm.py THIS HEADER COMMENT PREVENTS RECONVERSION, DO NOT REMOVE
"a" = (
/turf/template_noop,
/area/template_noop)
"F" = (
/obj/machinery/crystal,
/turf/simulated/floor/outdoors/crystal_planet/purplesand,
/area/submap/crystalcore/purple/nine)
"G" = (
/obj/machinery/crystal,
/turf/simulated/floor/outdoors/crystal_planet/purplesand,
/area/template_noop)
"I" = (
/turf/simulated/floor/outdoors/crystal_planet/purplesand,
/area/template_noop)
"K" = (
/turf/template_noop,
/area/submap/crystalcore/purple/nine)
"M" = (
/obj/item/weapon/ore/diamond,
/turf/simulated/floor/outdoors/crystal_planet/purplesand,
/area/submap/crystalcore/purple/nine)
"T" = (
/turf/simulated/floor/outdoors/crystal_planet/purplesand,
/area/submap/crystalcore/purple/nine)

(1,1,1) = {"
a
a
a
a
a
a
a
a
a
a
a
a
a
a
a
a
a
a
a
a
a
a
a
a
a
a
a
"}
(2,1,1) = {"
a
a
a
a
a
a
a
a
a
a
a
a
T
T
T
T
T
a
a
a
a
a
a
a
a
a
a
"}
(3,1,1) = {"
a
a
a
a
a
a
a
a
a
T
T
F
T
T
T
T
F
T
T
T
a
a
a
a
a
a
a
"}
(4,1,1) = {"
a
a
a
a
a
a
a
a
T
T
T
T
T
T
T
T
T
T
T
M
I
a
a
a
a
a
a
"}
(5,1,1) = {"
a
a
a
a
a
a
a
F
T
T
T
T
M
T
T
T
T
T
T
T
T
T
F
a
a
a
a
"}
(6,1,1) = {"
a
a
a
a
a
T
T
T
T
T
T
T
T
T
T
T
T
T
F
T
T
T
T
a
a
a
a
"}
(7,1,1) = {"
a
a
a
a
T
T
T
T
T
T
T
T
T
T
F
T
T
T
T
T
T
T
T
a
a
a
a
"}
(8,1,1) = {"
a
a
a
T
F
T
T
M
T
T
T
T
T
T
T
T
T
T
M
T
T
T
T
a
a
a
a
"}
(9,1,1) = {"
a
a
a
T
T
T
T
T
T
F
T
T
T
T
T
T
T
T
T
T
T
F
a
a
a
a
a
"}
(10,1,1) = {"
a
a
a
T
T
T
T
T
T
T
T
T
T
T
M
T
T
T
T
T
T
T
a
a
a
a
a
"}
(11,1,1) = {"
a
a
a
T
T
T
T
T
T
T
T
T
T
T
T
T
T
T
T
T
T
T
T
a
a
a
a
"}
(12,1,1) = {"
a
a
T
T
T
T
T
M
T
T
M
T
T
T
T
T
T
T
T
T
M
T
T
T
a
a
a
"}
(13,1,1) = {"
a
a
T
T
T
T
T
T
T
T
T
T
T
T
F
T
T
T
T
F
T
T
T
F
a
a
a
"}
(14,1,1) = {"
a
a
T
F
T
T
T
T
T
T
T
T
T
T
T
T
T
T
T
T
T
T
T
T
a
a
a
"}
(15,1,1) = {"
a
a
a
T
T
T
T
F
T
T
T
T
T
T
T
T
T
T
T
T
T
T
T
T
a
a
a
"}
(16,1,1) = {"
a
a
a
T
T
T
T
T
T
T
T
T
M
T
T
T
T
T
T
T
T
T
T
a
a
a
a
"}
(17,1,1) = {"
a
a
a
T
T
M
T
T
T
T
T
T
T
T
T
T
T
F
T
T
M
T
T
a
a
a
a
"}
(18,1,1) = {"
a
a
a
a
T
T
T
T
T
T
T
T
F
T
T
T
T
T
T
T
T
T
a
a
a
a
a
"}
(19,1,1) = {"
a
a
a
a
T
T
T
T
T
T
T
T
T
T
T
T
T
T
T
T
T
T
a
a
a
a
a
"}
(20,1,1) = {"
a
a
a
a
a
F
T
T
M
T
T
T
T
T
T
T
M
T
T
T
T
F
a
a
a
a
a
"}
(21,1,1) = {"
a
a
a
a
a
a
T
T
T
T
T
T
T
T
T
T
T
T
T
T
T
T
a
a
a
a
a
"}
(22,1,1) = {"
a
a
a
a
a
a
a
T
T
T
T
T
T
F
T
T
T
T
T
T
T
a
a
a
a
a
a
"}
(23,1,1) = {"
a
a
a
a
a
a
a
a
T
F
T
T
T
T
T
T
T
T
T
T
a
a
a
a
a
a
a
"}
(24,1,1) = {"
a
a
a
a
a
a
a
a
a
a
T
T
T
T
T
M
T
T
G
K
a
a
a
a
a
a
a
"}
(25,1,1) = {"
a
a
a
a
a
a
a
a
a
a
a
a
T
T
T
T
T
T
a
a
a
a
a
a
a
a
a
"}
(26,1,1) = {"
a
a
a
a
a
a
a
a
a
a
a
a
a
a
a
a
a
a
a
a
a
a
a
a
a
a
a
"}
(27,1,1) = {"
a
a
a
a
a
a
a
a
a
a
a
a
a
a
a
a
a
a
a
a
a
a
a
a
a
a
a
"}
