//MAP CONVERTED BY dmm2tgm.py THIS HEADER COMMENT PREVENTS RECONVERSION, DO NOT REMOVE
"a" = (
/turf/template_noop,
/area/template_noop)
"b" = (
/obj/item/weapon/ore/slag,
/turf/simulated/floor/outdoors/crystal_planet/purplesand,
/area/submap/crystalcore/purple/seven)
"k" = (
/obj/structure/boulder,
/turf/simulated/floor/outdoors/crystal_planet/purplesand,
/area/submap/crystalcore/purple/seven)
"p" = (
/obj/item/weapon/ore/verdantium,
/turf/simulated/floor/outdoors/crystal_planet/purplesand,
/area/submap/crystalcore/purple/seven)
"z" = (
/turf/template_noop,
/area/submap/crystalcore/purple/seven)
"C" = (
/obj/structure/boulder,
/obj/machinery/artifact,
/turf/simulated/floor/outdoors/crystal_planet/purplesand,
/area/submap/crystalcore/purple/seven)
"F" = (
/turf/simulated/floor/outdoors/crystal_planet/purplesand,
/area/submap/crystalcore/purple/seven)
"Q" = (
/obj/effect/decal/mecha_wreckage/ripley,
/obj/structure/boulder,
/turf/simulated/floor/outdoors/crystal_planet/purplesand,
/area/submap/crystalcore/purple/seven)
"S" = (
/turf/simulated/mineral/purplecrystal,
/area/submap/crystalcore/purple/seven)

(1,1,1) = {"
a
a
a
a
a
a
a
a
a
a
a
a
a
a
a
a
a
a
a
a
a
a
a
a
a
a
a
a
a
a
a
a
a
a
a
"}
(2,1,1) = {"
a
a
a
a
a
a
a
a
a
a
a
a
a
a
a
a
a
a
a
a
a
a
a
a
a
a
a
a
a
a
a
a
a
a
a
"}
(3,1,1) = {"
a
a
a
a
a
a
a
a
a
a
a
a
a
a
a
a
a
a
a
a
a
a
a
a
a
a
a
a
a
a
a
a
a
a
a
"}
(4,1,1) = {"
a
a
a
a
a
a
a
a
a
z
z
z
z
z
a
a
a
a
a
a
a
a
a
a
a
a
a
a
a
a
a
a
a
a
a
"}
(5,1,1) = {"
a
a
a
a
a
a
a
a
a
z
F
F
F
z
a
a
a
a
a
a
a
a
a
a
a
a
a
a
a
a
a
a
a
a
a
"}
(6,1,1) = {"
a
a
a
a
a
a
a
a
a
z
F
F
b
z
a
a
a
a
a
a
a
a
a
a
a
a
a
a
a
a
a
a
a
a
a
"}
(7,1,1) = {"
a
a
a
a
a
a
a
a
a
z
F
F
F
z
a
a
a
a
a
a
a
a
a
a
a
a
a
a
a
a
a
a
a
a
a
"}
(8,1,1) = {"
a
a
a
a
a
a
a
a
a
z
F
k
F
z
a
a
a
a
a
a
a
a
a
a
a
a
a
a
a
a
a
a
a
a
a
"}
(9,1,1) = {"
a
a
a
a
a
a
a
a
a
z
p
F
F
z
a
a
a
a
a
a
z
z
z
z
z
a
a
a
a
a
a
a
a
a
a
"}
(10,1,1) = {"
a
a
a
a
a
a
a
a
a
z
F
F
F
z
a
a
a
a
a
a
z
F
F
F
z
a
a
a
a
a
a
a
a
a
a
"}
(11,1,1) = {"
a
a
a
a
a
a
a
a
a
z
F
F
k
z
a
a
a
a
a
a
z
F
F
k
z
a
a
a
a
a
a
a
a
a
a
"}
(12,1,1) = {"
a
a
a
a
a
a
z
z
z
z
F
F
F
z
z
z
z
z
z
z
z
F
F
F
z
z
z
z
z
a
a
a
a
a
a
"}
(13,1,1) = {"
a
a
a
a
a
a
z
F
F
k
F
F
F
F
F
F
k
F
F
F
F
p
F
F
F
F
F
F
z
a
a
a
a
a
a
"}
(14,1,1) = {"
a
a
a
a
a
a
z
F
F
F
F
b
F
F
F
F
F
b
F
F
F
F
F
F
F
F
F
F
z
a
a
a
a
a
a
"}
(15,1,1) = {"
a
a
a
a
a
a
z
F
k
F
F
F
F
F
F
F
F
F
b
F
F
F
F
F
F
k
F
F
z
a
a
a
a
a
a
"}
(16,1,1) = {"
a
a
a
a
a
a
z
z
z
z
F
F
F
z
z
z
z
z
z
z
S
F
F
F
S
z
z
z
z
a
a
a
a
a
a
"}
(17,1,1) = {"
a
a
a
a
a
a
a
a
a
z
F
F
F
z
a
a
a
a
a
a
S
k
F
F
S
a
a
a
a
a
a
a
a
a
a
"}
(18,1,1) = {"
a
a
a
a
a
a
a
a
a
z
F
F
F
z
a
a
a
a
a
a
S
F
F
F
S
a
a
a
a
a
a
a
a
a
a
"}
(19,1,1) = {"
a
a
a
a
a
a
a
a
a
z
F
F
F
z
a
a
a
a
a
a
S
F
F
F
S
a
a
a
a
a
a
a
a
a
a
"}
(20,1,1) = {"
a
a
a
a
a
a
a
a
a
z
F
F
k
z
a
a
a
a
a
a
S
F
F
F
S
a
a
a
a
a
a
a
a
a
a
"}
(21,1,1) = {"
a
a
a
a
a
a
a
a
a
z
b
F
F
z
a
a
a
a
a
a
S
F
F
p
S
a
a
a
a
a
a
a
a
a
a
"}
(22,1,1) = {"
a
a
a
a
a
a
a
a
a
z
F
F
F
z
a
a
a
a
a
a
S
F
F
F
S
a
a
a
a
a
a
a
a
a
a
"}
(23,1,1) = {"
a
a
a
a
a
a
a
a
a
z
F
F
F
z
a
a
a
a
a
a
S
F
F
F
S
a
a
a
a
a
a
a
a
a
a
"}
(24,1,1) = {"
a
a
a
a
a
a
a
a
a
z
F
p
F
z
a
a
a
a
a
a
S
F
b
F
S
a
a
a
a
a
a
a
a
a
a
"}
(25,1,1) = {"
a
a
a
a
a
a
a
a
a
z
F
F
F
z
a
a
a
a
a
a
S
k
F
F
S
a
a
a
a
a
a
a
a
a
a
"}
(26,1,1) = {"
a
a
a
a
a
a
a
a
a
z
F
F
k
z
a
a
a
a
a
a
S
k
F
k
S
a
a
a
a
a
a
a
a
a
a
"}
(27,1,1) = {"
a
a
a
a
a
a
a
a
a
z
F
F
F
z
a
a
a
a
a
a
S
k
Q
k
S
a
a
a
a
a
a
a
a
a
a
"}
(28,1,1) = {"
a
a
a
a
a
a
a
a
a
z
k
F
F
z
a
a
a
a
a
a
S
k
C
k
S
a
a
a
a
a
a
a
a
a
a
"}
(29,1,1) = {"
a
a
a
a
a
a
a
a
a
z
F
F
F
z
a
a
a
a
a
a
S
S
S
S
S
a
a
a
a
a
a
a
a
a
a
"}
(30,1,1) = {"
a
a
a
a
a
a
a
a
a
z
F
F
F
z
a
a
a
a
a
a
a
a
a
a
a
a
a
a
a
a
a
a
a
a
a
"}
(31,1,1) = {"
a
a
a
a
a
a
a
a
a
z
F
k
F
z
a
a
a
a
a
a
a
a
a
a
a
a
a
a
a
a
a
a
a
a
a
"}
(32,1,1) = {"
a
a
a
a
a
a
a
a
a
z
z
z
z
z
a
a
a
a
a
a
a
a
a
a
a
a
a
a
a
a
a
a
a
a
a
"}
(33,1,1) = {"
a
a
a
a
a
a
a
a
a
a
a
a
a
a
a
a
a
a
a
a
a
a
a
a
a
a
a
a
a
a
a
a
a
a
a
"}
(34,1,1) = {"
a
a
a
a
a
a
a
a
a
a
a
a
a
a
a
a
a
a
a
a
a
a
a
a
a
a
a
a
a
a
a
a
a
a
a
"}
(35,1,1) = {"
a
a
a
a
a
a
a
a
a
a
a
a
a
a
a
a
a
a
a
a
a
a
a
a
a
a
a
a
a
a
a
a
a
a
a
"}
