//MAP CONVERTED BY dmm2tgm.py THIS HEADER COMMENT PREVENTS RECONVERSION, DO NOT REMOVE
"a" = (
/turf/template_noop,
/area/template_noop)
"e" = (
/obj/structure/ghost_pod/manual/cursedblade,
/turf/simulated/floor/outdoors/crystal_planet/purplesand,
/area/submap/crystalcore/purple/six)
"t" = (
/turf/simulated/floor/outdoors/crystal_planet/purplesand,
/area/submap/crystalcore/purple/six)
"Q" = (
/turf/simulated/floor/lava/warm,
/area/submap/crystalcore/purple/six)

(1,1,1) = {"
a
a
a
a
a
a
a
a
Q
Q
Q
Q
Q
Q
Q
a
a
a
a
a
a
a
a
a
a
a
"}
(2,1,1) = {"
a
a
a
a
a
a
a
Q
Q
Q
Q
Q
Q
Q
Q
Q
a
a
a
a
a
a
a
a
a
a
"}
(3,1,1) = {"
a
a
a
a
a
a
Q
Q
Q
Q
Q
Q
Q
Q
Q
Q
Q
Q
a
a
a
a
a
a
a
a
"}
(4,1,1) = {"
a
a
a
a
Q
Q
Q
Q
Q
Q
t
Q
Q
Q
Q
Q
Q
Q
Q
a
a
a
a
a
a
a
"}
(5,1,1) = {"
a
a
a
Q
Q
Q
Q
Q
t
t
t
t
t
t
Q
Q
Q
Q
Q
Q
a
a
a
a
a
a
"}
(6,1,1) = {"
a
a
Q
Q
Q
Q
Q
t
t
t
t
t
t
t
t
Q
Q
Q
Q
Q
Q
a
a
a
a
a
"}
(7,1,1) = {"
a
a
Q
Q
Q
t
t
t
t
t
t
t
t
t
t
t
Q
Q
Q
Q
Q
Q
a
a
a
a
"}
(8,1,1) = {"
a
a
Q
Q
t
t
t
t
t
t
Q
t
t
t
t
t
t
Q
Q
Q
Q
Q
Q
a
a
a
"}
(9,1,1) = {"
a
Q
Q
Q
t
t
t
t
t
Q
Q
Q
Q
t
t
t
t
Q
Q
Q
Q
Q
Q
a
a
a
"}
(10,1,1) = {"
a
Q
Q
t
t
t
t
Q
Q
Q
Q
Q
Q
Q
t
t
t
Q
Q
Q
Q
Q
t
t
a
a
"}
(11,1,1) = {"
a
Q
t
t
t
Q
Q
Q
Q
Q
Q
Q
Q
Q
t
t
t
Q
Q
Q
Q
Q
t
t
a
a
"}
(12,1,1) = {"
a
Q
t
t
t
Q
Q
Q
Q
Q
Q
Q
t
t
t
t
t
Q
Q
Q
Q
t
t
t
a
a
"}
(13,1,1) = {"
a
t
t
t
Q
Q
Q
Q
Q
Q
Q
e
t
t
t
t
Q
Q
Q
Q
Q
t
t
t
t
a
"}
(14,1,1) = {"
a
t
t
t
Q
Q
Q
Q
Q
Q
Q
Q
t
t
t
t
Q
Q
Q
Q
Q
t
t
t
t
a
"}
(15,1,1) = {"
a
t
t
t
Q
Q
Q
Q
Q
Q
Q
Q
Q
Q
Q
Q
Q
Q
Q
Q
Q
t
t
t
t
a
"}
(16,1,1) = {"
a
t
t
t
Q
Q
Q
Q
Q
Q
Q
Q
Q
Q
Q
Q
Q
Q
Q
Q
t
t
t
a
a
a
"}
(17,1,1) = {"
a
t
t
t
t
Q
Q
Q
Q
Q
Q
Q
Q
Q
Q
Q
Q
Q
Q
Q
t
t
a
a
a
a
"}
(18,1,1) = {"
a
t
t
t
t
Q
Q
Q
Q
Q
Q
Q
Q
Q
Q
Q
Q
Q
t
t
t
t
a
a
a
a
"}
(19,1,1) = {"
a
a
t
t
t
t
Q
Q
Q
Q
Q
Q
Q
Q
Q
Q
Q
Q
t
t
t
t
a
a
a
a
"}
(20,1,1) = {"
a
a
t
t
t
t
t
t
Q
Q
Q
Q
Q
Q
Q
Q
Q
t
t
t
t
a
a
a
a
a
"}
(21,1,1) = {"
a
a
a
t
t
t
t
t
t
t
Q
Q
Q
Q
Q
t
t
t
t
t
a
a
a
a
a
a
"}
(22,1,1) = {"
a
a
a
t
t
t
t
t
t
t
t
t
t
Q
t
t
t
t
t
a
a
a
a
a
a
a
"}
(23,1,1) = {"
a
a
a
a
t
t
t
t
t
t
t
t
t
t
t
t
t
t
a
a
a
a
a
a
a
a
"}
(24,1,1) = {"
a
a
a
a
a
t
t
t
t
t
t
t
t
t
t
t
a
a
a
a
a
a
a
a
a
a
"}
(25,1,1) = {"
a
a
a
a
a
a
t
t
t
t
t
t
t
t
a
a
a
a
a
a
a
a
a
a
a
a
"}
(26,1,1) = {"
a
a
a
a
a
a
a
a
t
t
a
a
a
a
a
a
a
a
a
a
a
a
a
a
a
a
"}
