//MAP CONVERTED BY dmm2tgm.py THIS HEADER COMMENT PREVENTS RECONVERSION, DO NOT REMOVE
"a" = (
/turf/template_noop,
/area/template_noop)
"E" = (
/turf/simulated/floor/outdoors/crystal_planet/purplesand,
/area/submap/crystalcore/purple/thirteen)
"K" = (
/obj/random/outcrop,
/turf/simulated/floor/outdoors/crystal_planet/purplesand,
/area/submap/crystalcore/purple/thirteen)
"N" = (
/obj/item/weapon/ore/hydrogen,
/turf/simulated/floor/outdoors/crystal_planet/purplesand,
/area/submap/crystalcore/purple/thirteen)
"S" = (
/turf/simulated/floor/lava/warm,
/area/submap/crystalcore/purple/thirteen)

(1,1,1) = {"
a
a
a
a
a
a
a
E
a
a
a
a
a
a
a
"}
(2,1,1) = {"
a
a
a
a
a
a
E
E
K
a
a
a
a
a
a
"}
(3,1,1) = {"
a
a
a
a
a
E
E
E
E
E
a
a
a
a
a
"}
(4,1,1) = {"
a
a
a
a
K
E
E
E
E
E
E
a
a
a
a
"}
(5,1,1) = {"
a
a
a
E
E
N
E
E
K
E
E
E
a
a
a
"}
(6,1,1) = {"
a
a
E
E
E
E
E
E
S
E
E
E
K
a
a
"}
(7,1,1) = {"
a
E
E
E
E
K
E
S
S
S
E
E
E
E
a
"}
(8,1,1) = {"
E
E
K
E
E
E
S
S
S
S
S
E
E
E
E
"}
(9,1,1) = {"
a
E
E
E
E
S
S
S
S
S
S
S
E
E
a
"}
(10,1,1) = {"
a
a
E
K
E
E
S
S
S
S
S
S
S
a
a
"}
(11,1,1) = {"
a
a
a
E
E
E
E
S
S
S
S
S
a
a
a
"}
(12,1,1) = {"
a
a
a
a
E
E
E
K
S
S
S
a
a
a
a
"}
(13,1,1) = {"
a
a
a
a
a
E
N
E
E
S
a
a
a
a
a
"}
(14,1,1) = {"
a
a
a
a
a
a
E
E
E
a
a
a
a
a
a
"}
(15,1,1) = {"
a
a
a
a
a
a
a
K
a
a
a
a
a
a
a
"}
