//MAP CONVERTED BY dmm2tgm.py THIS HEADER COMMENT PREVENTS RECONVERSION, DO NOT REMOVE
"a" = (
/turf/simulated/wall/resin,
/area/submap/thehive)
"b" = (
/obj/effect/alien/weeds,
/mob/living/simple_mob/animal/space/alien/queen/empress/mother,
/turf/simulated/mineral/floor/ignore_mapgen/sif,
/area/submap/thehive)
"d" = (
/turf/simulated/mineral,
/area/submap/thehive)
"f" = (
/obj/structure/table/marble,
/obj/item/perfect_tele/frontier,
/turf/simulated/floor,
/area/submap/thehive)
"g" = (
/turf/simulated/floor,
/area/submap/thehive)
"h" = (
/obj/structure/table/marble,
/obj/item/defib_kit/compact,
/turf/simulated/floor,
/area/submap/thehive)
"i" = (
/obj/effect/alien/weeds,
/obj/structure/closet/secure_closet/egg/xenomorph,
/obj/item/stolenpackage,
/obj/item/gun/launcher/spikethrower,
/turf/simulated/mineral/floor/ignore_mapgen/sif,
/area/submap/thehive)
"k" = (
/obj/machinery/door/airlock,
/turf/simulated/floor,
/area/submap/thehive)
"l" = (
/obj/effect/alien/weeds,
/obj/structure/closet/secure_closet/egg/xenomorph,
/obj/item/stolenpackage,
/obj/item/organ/internal/augment/armmounted/taser,
/turf/simulated/mineral/floor/ignore_mapgen/sif,
/area/submap/thehive)
"m" = (
/turf/simulated/mineral/floor/ignore_mapgen/sif,
/area/submap/thehive)
"n" = (
/mob/living/simple_mob/humanoid/merc/ranged/space/shotgun{
	faction = "xeno";
	name = "xeno whisperer"
	},
/turf/simulated/floor,
/area/submap/thehive)
"o" = (
/obj/effect/alien/weeds,
/mob/living/simple_mob/animal/space/alien/sentinel,
/turf/simulated/mineral/floor/ignore_mapgen/sif,
/area/submap/thehive)
"p" = (
/obj/effect/alien/weeds,
/obj/effect/alien/weeds,
/turf/simulated/mineral/floor/ignore_mapgen/sif,
/area/submap/thehive)
"r" = (
/obj/structure/cable{
	d2 = 8;
	icon_state = "0-8"
	},
/obj/machinery/power/shield_generator/upgraded,
/turf/simulated/floor,
/area/submap/thehive)
"s" = (
/obj/effect/alien/weeds,
/obj/structure/closet/secure_closet/egg/xenomorph,
/obj/item/stolenpackage,
/turf/simulated/mineral/floor/ignore_mapgen/sif,
/area/submap/thehive)
"t" = (
/obj/structure/cable{
	d1 = 4;
	d2 = 8;
	icon_state = "4-8"
	},
/turf/simulated/floor,
/area/submap/thehive)
"u" = (
/turf/simulated/wall/concrete,
/area/submap/thehive)
"v" = (
/obj/effect/alien/weeds,
/mob/living/simple_mob/animal/space/alien/drone,
/turf/simulated/mineral/floor/ignore_mapgen/sif,
/area/submap/thehive)
"w" = (
/obj/effect/alien/weeds,
/obj/structure/closet/secure_closet/egg/xenomorph,
/obj/item/stolenpackage,
/obj/item/gun/energy/hooklauncher,
/turf/simulated/mineral/floor/ignore_mapgen/sif,
/area/submap/thehive)
"y" = (
/turf/template_noop,
/area/submap/thehive)
"B" = (
/obj/effect/alien/weeds,
/obj/structure/closet/secure_closet/egg/xenomorph,
/obj/item/stolenpackage,
/obj/item/organ/internal/augment/armmounted/shoulder/surge,
/turf/simulated/mineral/floor/ignore_mapgen/sif,
/area/submap/thehive)
"C" = (
/obj/effect/alien/weeds,
/obj/effect/alien/weeds,
/mob/living/simple_mob/animal/space/alien/drone,
/turf/simulated/mineral/floor/ignore_mapgen/sif,
/area/submap/thehive)
"H" = (
/obj/effect/alien/weeds,
/mob/living/simple_mob/animal/space/alien/sentinel/praetorian,
/turf/simulated/mineral/floor/ignore_mapgen/sif,
/area/submap/thehive)
"I" = (
/obj/effect/alien/weeds,
/obj/structure/closet/secure_closet/egg/xenomorph,
/obj/item/stolenpackage,
/obj/item/storage/backpack/holding,
/turf/simulated/mineral/floor/ignore_mapgen/sif,
/area/submap/thehive)
"J" = (
/obj/structure/table/marble,
/obj/item/storage/backpack/holding/duffle,
/turf/simulated/floor,
/area/submap/thehive)
"L" = (
/obj/effect/alien/weeds,
/turf/simulated/mineral,
/area/submap/thehive)
"S" = (
/obj/effect/alien/weeds,
/obj/structure/closet/secure_closet/egg/xenomorph,
/obj/item/stolenpackage,
/obj/item/storage/backpack/holding/slime,
/turf/simulated/mineral/floor/ignore_mapgen/sif,
/area/submap/thehive)
"T" = (
/obj/machinery/power/port_gen/pacman/super,
/obj/structure/cable{
	d2 = 4;
	icon_state = "0-4"
	},
/turf/simulated/floor,
/area/submap/thehive)
"W" = (
/obj/effect/alien/weeds,
/turf/simulated/mineral/floor/ignore_mapgen/sif,
/area/submap/thehive)
"Y" = (
/obj/structure/table/marble,
/obj/item/bluespaceradio,
/turf/simulated/floor,
/area/submap/thehive)

(1,1,1) = {"
y
y
y
y
y
y
y
y
y
y
d
d
d
d
d
d
d
d
d
d
d
d
d
d
d
d
d
d
y
y
y
y
y
y
y
y
y
y
y
y
"}
(2,1,1) = {"
y
y
y
y
y
y
y
y
y
d
d
d
a
a
a
d
d
d
d
d
d
a
a
a
d
d
d
d
d
y
y
y
y
y
y
y
y
y
y
y
"}
(3,1,1) = {"
y
y
y
y
y
y
y
y
d
d
d
a
I
s
i
a
d
d
d
a
a
W
W
W
a
a
a
d
d
d
d
y
y
y
y
y
y
y
y
y
"}
(4,1,1) = {"
y
y
y
y
y
y
m
a
d
d
a
s
W
W
H
W
a
a
a
W
W
W
W
W
v
W
W
a
d
d
d
d
y
y
y
y
y
y
y
y
"}
(5,1,1) = {"
y
y
y
y
y
m
m
m
a
d
a
s
b
W
W
W
W
W
W
v
W
a
W
W
o
W
W
W
a
d
d
d
d
y
y
y
y
y
y
y
"}
(6,1,1) = {"
y
y
y
y
y
m
m
W
a
d
a
B
W
W
W
o
W
W
W
o
W
W
v
W
W
W
a
W
W
a
a
d
d
d
y
y
y
y
y
y
"}
(7,1,1) = {"
y
y
y
y
y
m
W
W
W
a
d
a
W
H
W
W
W
a
W
W
W
W
a
a
W
W
W
W
W
W
W
a
d
d
d
y
y
y
y
y
"}
(8,1,1) = {"
y
y
y
y
y
a
a
W
W
a
d
d
a
W
W
v
u
u
k
k
u
u
d
d
a
W
W
o
W
v
W
a
d
d
d
y
y
y
y
y
"}
(9,1,1) = {"
y
y
y
y
d
d
a
W
W
W
a
d
d
a
W
W
u
T
g
g
h
u
d
d
d
a
W
v
W
W
W
W
a
d
d
d
y
y
y
y
"}
(10,1,1) = {"
y
y
y
y
d
d
d
a
W
v
W
a
d
d
a
a
u
t
n
g
f
u
a
d
d
d
a
W
W
a
W
W
a
d
d
d
y
y
y
y
"}
(11,1,1) = {"
y
y
y
d
d
d
d
a
v
o
W
W
a
d
d
d
u
t
g
g
J
u
a
a
d
d
a
W
W
W
W
W
W
a
d
d
y
y
y
y
"}
(12,1,1) = {"
y
y
y
d
d
d
d
d
a
W
W
W
W
a
d
d
u
r
g
g
Y
u
W
W
a
d
d
a
W
W
o
v
W
a
d
d
y
y
y
y
"}
(13,1,1) = {"
y
y
y
y
d
d
d
d
a
W
W
a
W
v
a
d
u
u
k
k
u
u
W
W
a
d
d
d
a
W
v
W
W
W
a
a
y
y
y
y
"}
(14,1,1) = {"
y
y
y
y
d
d
d
d
d
a
W
p
W
W
W
a
a
W
W
W
W
W
W
W
W
a
a
d
d
a
W
W
W
W
W
m
y
y
y
y
"}
(15,1,1) = {"
y
y
y
y
d
d
d
d
d
a
L
C
W
o
W
W
W
W
v
W
o
W
W
W
H
W
S
a
d
a
W
W
W
W
W
m
y
y
y
y
"}
(16,1,1) = {"
y
y
y
y
y
d
d
d
d
d
a
a
W
W
W
v
a
W
W
W
W
W
W
W
W
W
l
a
d
d
a
a
W
W
W
m
y
y
y
y
"}
(17,1,1) = {"
y
y
y
y
y
y
d
d
d
d
d
d
a
W
W
W
W
a
W
W
a
W
H
W
W
W
s
a
d
d
d
d
a
a
a
y
y
y
y
y
"}
(18,1,1) = {"
y
y
y
y
y
y
y
d
d
d
d
d
d
a
a
W
W
W
W
a
d
a
a
w
s
s
a
d
d
d
d
d
d
d
y
y
y
y
y
y
"}
(19,1,1) = {"
y
y
y
y
y
y
y
y
d
d
d
d
d
d
d
a
a
a
a
d
d
d
d
a
a
a
d
d
d
d
d
d
d
y
y
y
y
y
y
y
"}
(20,1,1) = {"
y
y
y
y
y
y
y
y
y
d
d
d
d
d
d
d
d
d
d
d
d
d
d
d
d
d
d
d
d
d
d
y
y
y
y
y
y
y
y
y
"}
