//MAP CONVERTED BY dmm2tgm.py THIS HEADER COMMENT PREVENTS RECONVERSION, DO NOT REMOVE
"a" = (
/turf/template_noop,
/area/template_noop)
"b" = (
/obj/effect/floor_decal/corner/yellow/diagonal,
/obj/structure/table/steel_reinforced,
/obj/item/weapon/paper_bin,
/obj/item/weapon/pen/red,
/turf/simulated/floor/tiled/old_tile/red,
/area/shuttle/pizza_shuttle)
"c" = (
/obj/structure/grille,
/obj/structure/window/reinforced/full,
/obj/structure/window/reinforced{
	dir = 2;
	health = 1e+006;
	pixel_y = 0
	},
/obj/machinery/atmospherics/pipe/manifold/hidden/yellow{
	dir = 1
	},
/turf/simulated/floor/plating,
/area/shuttle/pizza_shuttle)
"d" = (
/obj/effect/floor_decal/corner/grey/diagonal{
	dir = 4
	},
/turf/simulated/floor/tiled/old_tile/white,
/area/shuttle/pizza_shuttle)
"e" = (
/obj/structure/grille,
/obj/structure/window/reinforced/full,
/obj/structure/window/reinforced{
	dir = 8;
	health = 1e+006;
	pixel_y = 0
	},
/turf/simulated/floor/plating,
/area/shuttle/pizza_shuttle)
"f" = (
/obj/effect/floor_decal/corner/grey/diagonal{
	dir = 4
	},
/obj/structure/closet/secure_closet/freezer/kitchen{
	req_access = null;
	locked = 0
	},
/turf/simulated/floor/tiled/white,
/area/shuttle/pizza_shuttle)
"g" = (
/obj/structure/grille,
/obj/structure/window/reinforced/full,
/obj/structure/window/reinforced{
	dir = 2;
	health = 1e+006;
	pixel_y = 0
	},
/obj/machinery/atmospherics/pipe/manifold/hidden/yellow{
	dir = 4
	},
/turf/simulated/floor/plating,
/area/shuttle/pizza_shuttle)
"h" = (
/obj/machinery/appliance/cooker/oven,
/turf/simulated/floor/tiled/old_tile/white,
/area/shuttle/pizza_shuttle)
"i" = (
/obj/effect/floor_decal/corner/yellow/diagonal,
/obj/machinery/computer/shuttle_control/explore/pizza_shuttle{
	dir = 2
	},
/turf/simulated/floor/tiled/old_tile/red,
/area/shuttle/pizza_shuttle)
"j" = (
/obj/structure/grille,
/obj/structure/window/reinforced/full,
/obj/structure/window/reinforced{
	dir = 1
	},
/turf/simulated/floor/plating,
/area/shuttle/pizza_shuttle)
"k" = (
/obj/machinery/atmospherics/pipe/simple/hidden/yellow{
	dir = 4
	},
/turf/simulated/wall/shull,
/area/shuttle/pizza_shuttle)
"l" = (
/obj/effect/floor_decal/corner/grey/diagonal{
	dir = 4
	},
/obj/structure/cable/yellow{
	d1 = 4;
	d2 = 8;
	icon_state = "4-8"
	},
/turf/simulated/floor/tiled/old_tile/white,
/area/shuttle/pizza_shuttle)
"m" = (
/obj/effect/floor_decal/corner/grey/diagonal{
	dir = 4
	},
/obj/structure/closet/crate/bin{
	anchored = 1
	},
/turf/simulated/floor/tiled/old_tile/white,
/area/shuttle/pizza_shuttle)
"n" = (
/obj/machinery/door/airlock/glass_external,
/obj/effect/map_helper/airlock/door/int_door,
/obj/machinery/atmospherics/pipe/simple/hidden{
	dir = 9
	},
/obj/structure/cable/yellow{
	d1 = 4;
	d2 = 8;
	icon_state = "4-8"
	},
/turf/simulated/floor/plating,
/area/shuttle/pizza_shuttle)
"o" = (
/obj/machinery/atmospherics/unary/vent_pump/high_volume{
	dir = 4;
	frequency = 1380;
	id_tag = "expshuttle_vent"
	},
/obj/effect/map_helper/airlock/atmos/chamber_pump,
/obj/machinery/airlock_sensor{
	pixel_y = 28;
	pixel_x = -4
	},
/obj/effect/map_helper/airlock/sensor/chamber_sensor,
/obj/machinery/embedded_controller/radio/airlock/docking_port{
	frequency = 1380;
	id_tag = "pizza_shuttle_docker";
	pixel_y = 28;
	pixel_x = 7
	},
/turf/simulated/floor/plating,
/area/shuttle/pizza_shuttle)
"p" = (
/obj/machinery/atmospherics/unary/vent_pump/high_volume{
	dir = 4;
	frequency = 1380;
	id_tag = "expshuttle_vent"
	},
/obj/effect/map_helper/airlock/atmos/chamber_pump,
/obj/structure/cable/yellow{
	d1 = 4;
	d2 = 8;
	icon_state = "4-8"
	},
/obj/effect/shuttle_landmark/shuttle_initializer/pizza_shuttle,
/obj/effect/overmap/visitable/ship/landable/pizza_shuttle,
/obj/machinery/light/small,
/turf/simulated/floor/plating,
/area/shuttle/pizza_shuttle)
"q" = (
/obj/effect/floor_decal/corner/yellow/diagonal,
/obj/structure/cable/yellow{
	d1 = 1;
	d2 = 8;
	icon_state = "1-8"
	},
/turf/simulated/floor/tiled/old_tile/red,
/area/shuttle/pizza_shuttle)
"r" = (
/obj/machinery/atmospherics/pipe/simple/hidden{
	dir = 10
	},
/turf/simulated/wall/shull,
/area/shuttle/pizza_shuttle)
"s" = (
/obj/effect/floor_decal/corner/yellow/diagonal,
/obj/structure/table/steel_reinforced,
/obj/machinery/photocopier/faxmachine{
	department = "Pizza Gut";
	req_one_access = newlist()
	},
/obj/item/toy/plushie/borgplushie/medihound{
	pixel_y = 8;
	pixel_x = 8
	},
/turf/simulated/floor/tiled/old_tile/red,
/area/shuttle/pizza_shuttle)
"t" = (
/obj/machinery/shipsensors/weak,
/turf/simulated/floor/plating/external,
/area/shuttle/pizza_shuttle)
"u" = (
/obj/structure/window/basic{
	dir = 4
	},
/obj/effect/floor_decal/corner/grey/diagonal{
	dir = 4
	},
/turf/simulated/floor/tiled/old_tile/white,
/area/shuttle/pizza_shuttle)
"v" = (
/obj/machinery/atmospherics/unary/engine{
	dir = 1
	},
/turf/simulated/shuttle/plating/airless/carry,
/area/shuttle/pizza_shuttle)
"w" = (
/obj/effect/floor_decal/corner/grey/diagonal{
	dir = 4
	},
/obj/structure/table/marble,
/obj/item/weapon/book/codex/chef_recipes,
/obj/item/clothing/head/soft/red,
/obj/item/clothing/head/soft/red,
/obj/structure/window/basic{
	dir = 4
	},
/obj/item/clothing/head/pizzaguy,
/obj/item/clothing/head/pizzaguy,
/obj/item/clothing/under/pizzaguy,
/obj/item/clothing/under/pizzaguy,
/turf/simulated/floor/tiled/old_tile/white,
/area/shuttle/pizza_shuttle)
"x" = (
/obj/effect/floor_decal/corner/yellow/diagonal,
/obj/machinery/power/smes/buildable/point_of_interest,
/obj/structure/cable/blue{
	d2 = 2;
	icon_state = "0-2"
	},
/turf/simulated/floor/tiled/old_tile/red,
/area/shuttle/pizza_shuttle)
"y" = (
/obj/machinery/atmospherics/portables_connector,
/obj/machinery/portable_atmospherics/canister/phoron,
/obj/effect/floor_decal/corner/yellow/diagonal,
/turf/simulated/floor/tiled/old_tile/red,
/area/shuttle/pizza_shuttle)
"z" = (
/obj/machinery/appliance/cooker/fryer,
/obj/machinery/light{
	dir = 8
	},
/turf/simulated/floor/tiled/old_tile/white,
/area/shuttle/pizza_shuttle)
"A" = (
/obj/effect/floor_decal/corner/grey/diagonal{
	dir = 4
	},
/obj/structure/cable/yellow{
	d1 = 4;
	d2 = 8;
	icon_state = "4-8"
	},
/obj/machinery/media/jukebox{
	pixel_y = -32;
	density = 0
	},
/obj/machinery/light,
/turf/simulated/floor/tiled/old_tile/white,
/area/shuttle/pizza_shuttle)
"B" = (
/obj/machinery/door/airlock/glass_external,
/obj/effect/map_helper/airlock/door/ext_door,
/obj/structure/cable/yellow{
	d1 = 4;
	d2 = 8;
	icon_state = "4-8"
	},
/obj/machinery/airlock_sensor/airlock_exterior/shuttle{
	dir = 6;
	pixel_x = -7;
	pixel_y = -24
	},
/obj/effect/map_helper/airlock/sensor/ext_sensor,
/turf/simulated/floor/plating,
/area/shuttle/pizza_shuttle)
"C" = (
/obj/effect/floor_decal/corner/yellow/diagonal,
/obj/structure/bed/chair/bay/chair/padded/red{
	dir = 1
	},
/turf/simulated/floor/tiled/old_tile/red,
/area/shuttle/pizza_shuttle)
"D" = (
/obj/effect/floor_decal/corner/yellow/diagonal,
/obj/item/weapon/tank/phoron,
/obj/structure/closet/crate,
/obj/item/weapon/storage/toolbox/mechanical,
/turf/simulated/floor/tiled/old_tile/red,
/area/shuttle/pizza_shuttle)
"F" = (
/obj/structure/grille,
/obj/structure/window/reinforced/full,
/obj/machinery/atmospherics/pipe/manifold/hidden{
	dir = 4
	},
/turf/simulated/floor/plating,
/area/shuttle/pizza_shuttle)
"G" = (
/obj/effect/floor_decal/corner/grey/diagonal{
	dir = 4
	},
/obj/structure/table/marble,
/obj/item/weapon/material/kitchen/rollingpin,
/obj/item/weapon/material/knife/butch,
/obj/structure/window/basic{
	dir = 4
	},
/turf/simulated/floor/tiled/old_tile/white,
/area/shuttle/pizza_shuttle)
"H" = (
/obj/effect/floor_decal/corner/grey/diagonal{
	dir = 4
	},
/obj/structure/cable/yellow{
	d1 = 4;
	d2 = 8;
	icon_state = "4-8"
	},
/obj/machinery/airlock_sensor{
	pixel_x = -24;
	pixel_y = -25
	},
/obj/effect/map_helper/airlock/sensor/int_sensor,
/turf/simulated/floor/tiled/old_tile/white,
/area/shuttle/pizza_shuttle)
"I" = (
/obj/machinery/atmospherics/binary/pump{
	dir = 2
	},
/obj/effect/floor_decal/corner/yellow/diagonal,
/turf/simulated/floor/tiled/old_tile/red,
/area/shuttle/pizza_shuttle)
"J" = (
/obj/effect/floor_decal/corner/yellow/diagonal,
/obj/structure/cable/yellow{
	d1 = 1;
	d2 = 2;
	icon_state = "1-2"
	},
/turf/simulated/floor/tiled/old_tile/red,
/area/shuttle/pizza_shuttle)
"K" = (
/obj/effect/floor_decal/corner/yellow/diagonal,
/obj/machinery/power/apc/super{
	dir = 4;
	pixel_x = 26;
	locked = 0
	},
/obj/structure/cable/blue,
/obj/structure/fuel_port,
/turf/simulated/floor/tiled/old_tile/red,
/area/shuttle/pizza_shuttle)
"L" = (
/obj/machinery/atmospherics/pipe/tank/air/full{
	start_pressure = 10000
	},
/turf/simulated/floor/tiled/old_tile/white,
/area/shuttle/pizza_shuttle)
"M" = (
/obj/effect/floor_decal/corner/yellow/diagonal,
/obj/machinery/power/terminal{
	dir = 4
	},
/obj/structure/cable/yellow{
	d2 = 2;
	icon_state = "0-2"
	},
/turf/simulated/floor/tiled/old_tile/red,
/area/shuttle/pizza_shuttle)
"N" = (
/obj/machinery/atmospherics/pipe/simple/hidden{
	dir = 5
	},
/turf/simulated/wall/shull,
/area/shuttle/pizza_shuttle)
"O" = (
/turf/simulated/wall/shull,
/area/shuttle/pizza_shuttle)
"P" = (
/obj/effect/floor_decal/corner/grey/diagonal{
	dir = 4
	},
/obj/structure/sink/kitchen{
	pixel_y = 17
	},
/turf/simulated/floor/tiled/old_tile/white,
/area/shuttle/pizza_shuttle)
"Q" = (
/obj/structure/grille,
/obj/structure/window/reinforced/full,
/obj/structure/window/reinforced{
	dir = 2;
	health = 1e+006;
	pixel_y = 0
	},
/obj/machinery/atmospherics/pipe/simple/hidden/yellow{
	dir = 6
	},
/turf/simulated/floor/plating,
/area/shuttle/pizza_shuttle)
"R" = (
/obj/effect/floor_decal/corner/grey/diagonal{
	dir = 4
	},
/obj/structure/table/marble,
/obj/structure/window/basic{
	dir = 1
	},
/obj/machinery/reagentgrinder,
/obj/item/weapon/reagent_containers/glass/beaker,
/obj/structure/window/basic{
	dir = 4
	},
/turf/simulated/floor/tiled/old_tile/white,
/area/shuttle/pizza_shuttle)
"S" = (
/obj/structure/table/marble,
/obj/item/pizzabox{
	pixel_y = 5
	},
/obj/item/pizzabox{
	pixel_y = 5
	},
/obj/item/pizzabox{
	pixel_y = 5
	},
/obj/item/pizzabox{
	pixel_y = 5
	},
/obj/item/pizzabox{
	pixel_y = 5
	},
/obj/effect/floor_decal/corner/grey/diagonal{
	dir = 4
	},
/obj/fiftyspawner/cardboard,
/turf/simulated/floor/tiled/white,
/area/shuttle/pizza_shuttle)
"T" = (
/obj/machinery/computer/ship/engines{
	dir = 8
	},
/obj/machinery/atmospherics/pipe/simple/hidden/yellow,
/obj/effect/floor_decal/corner/yellow/diagonal,
/obj/machinery/light{
	dir = 4
	},
/turf/simulated/floor/tiled/old_tile/red,
/area/shuttle/pizza_shuttle)
"U" = (
/obj/structure/window/basic{
	dir = 4
	},
/obj/structure/table/marble,
/obj/effect/floor_decal/corner/grey/diagonal{
	dir = 4
	},
/obj/item/weapon/reagent_containers/food/condiment/enzyme{
	pixel_x = -8;
	pixel_y = 5
	},
/obj/item/weapon/reagent_containers/food/condiment/small/saltshaker{
	pixel_x = -3
	},
/obj/item/weapon/reagent_containers/food/condiment/small/peppermill{
	pixel_x = 3
	},
/turf/simulated/floor/tiled/old_tile/white,
/area/shuttle/pizza_shuttle)
"V" = (
/obj/effect/floor_decal/corner/grey/diagonal{
	dir = 4
	},
/obj/structure/closet/secure_closet/freezer/fridge,
/obj/item/weapon/storage/fancy/egg_box,
/obj/item/weapon/storage/fancy/egg_box,
/obj/item/weapon/reagent_containers/food/snacks/meat,
/obj/item/weapon/reagent_containers/food/snacks/meat,
/obj/item/weapon/reagent_containers/food/snacks/meat,
/obj/item/weapon/reagent_containers/food/snacks/meat,
/obj/item/weapon/reagent_containers/food/snacks/meat,
/obj/item/weapon/reagent_containers/food/snacks/meat,
/obj/item/weapon/reagent_containers/food/snacks/meat,
/obj/fruitspawner/onion,
/obj/fruitspawner/onion,
/obj/fruitspawner/onion,
/obj/fruitspawner/onion,
/obj/fruitspawner/onion,
/obj/fruitspawner/tomato,
/obj/fruitspawner/tomato,
/obj/fruitspawner/tomato,
/obj/fruitspawner/tomato,
/obj/fruitspawner/tomato,
/obj/fruitspawner/corn,
/obj/fruitspawner/corn,
/obj/fruitspawner/corn,
/obj/fruitspawner/mushrooms,
/obj/fruitspawner/mushrooms,
/obj/fruitspawner/mushrooms,
/obj/fruitspawner/mushrooms,
/obj/fruitspawner/mushrooms,
/obj/fruitspawner/eggplant,
/obj/fruitspawner/eggplant,
/obj/fruitspawner/eggplant,
/obj/fruitspawner/carrot,
/obj/fruitspawner/carrot,
/obj/fruitspawner/carrot,
/obj/fruitspawner/spineapple,
/obj/fruitspawner/spineapple,
/obj/fruitspawner/spineapple,
/turf/simulated/floor/tiled/white,
/area/shuttle/pizza_shuttle)
"W" = (
/obj/machinery/computer/ship/helm{
	req_one_access = null
	},
/obj/effect/floor_decal/corner/yellow/diagonal,
/turf/simulated/floor/tiled/old_tile/red,
/area/shuttle/pizza_shuttle)
"X" = (
/obj/machinery/computer/ship/sensors{
	dir = 8
	},
/obj/effect/floor_decal/corner/yellow/diagonal,
/obj/machinery/light{
	dir = 4
	},
/turf/simulated/floor/tiled/old_tile/red,
/area/shuttle/pizza_shuttle)
"Y" = (
/obj/effect/floor_decal/corner/yellow/diagonal,
/turf/simulated/floor/tiled/old_tile/red,
/area/shuttle/pizza_shuttle)
"Z" = (
/obj/effect/floor_decal/corner/grey/diagonal{
	dir = 4
	},
/obj/structure/table/marble,
/obj/machinery/microwave{
	pixel_x = -4;
	pixel_y = 7
	},
/turf/simulated/floor/tiled/old_tile/white,
/area/shuttle/pizza_shuttle)

(1,1,1) = {"
a
a
a
a
a
a
a
a
a
a
a
a
a
"}
(2,1,1) = {"
a
a
O
O
O
O
O
e
B
O
a
a
a
"}
(3,1,1) = {"
a
a
O
h
z
L
N
o
p
O
a
a
a
"}
(4,1,1) = {"
a
O
O
P
d
Z
r
F
n
O
O
a
a
"}
(5,1,1) = {"
a
j
S
d
d
d
m
d
H
f
Q
v
a
"}
(6,1,1) = {"
a
j
U
u
d
d
d
d
l
V
c
v
a
"}
(7,1,1) = {"
a
j
i
b
R
G
w
d
A
O
k
t
a
"}
(8,1,1) = {"
a
j
W
C
Y
M
J
J
q
Y
c
v
a
"}
(9,1,1) = {"
a
j
s
D
X
x
K
y
T
I
g
v
a
"}
(10,1,1) = {"
a
O
O
O
O
O
O
O
O
O
O
a
a
"}
(11,1,1) = {"
a
a
a
a
a
a
a
a
a
a
a
a
a
"}
