//MAP CONVERTED BY dmm2tgm.py THIS HEADER COMMENT PREVENTS RECONVERSION, DO NOT REMOVE
"a" = (
/turf/template_noop,
/area/template_noop)
"b" = (
/turf/simulated/mineral,
/area/submap/asteroid5)
"d" = (
/turf/simulated/mineral/floor/vacuum,
/area/submap/asteroid5)
"f" = (
/obj/structure/outcrop/gold,
/turf/simulated/mineral/floor/vacuum,
/area/submap/asteroid5)
"n" = (
/obj/machinery/power/supermatter,
/turf/simulated/mineral/floor/vacuum,
/area/submap/asteroid5)
"p" = (
/obj/random/outcrop,
/turf/simulated/mineral/floor/vacuum,
/area/submap/asteroid5)
"q" = (
/obj/machinery/power/singularity_beacon/syndicate,
/turf/simulated/mineral/floor/vacuum,
/area/submap/asteroid5)
"r" = (
/obj/structure/outcrop/uranium,
/turf/simulated/mineral/floor/vacuum,
/area/submap/asteroid5)
"t" = (
/obj/structure/outcrop/diamond,
/turf/simulated/mineral/floor/vacuum,
/area/submap/asteroid5)
"v" = (
/obj/structure/outcrop/lead,
/turf/simulated/mineral/floor/vacuum,
/area/submap/asteroid5)
"z" = (
/obj/item/toy/katana,
/turf/simulated/mineral/floor/vacuum,
/area/submap/asteroid5)
"B" = (
/turf/simulated/mineral/floor/vacuum,
/area/template_noop)
"E" = (
/obj/effect/decal/cleanable/greenglow,
/turf/simulated/mineral/floor/vacuum,
/area/template_noop)
"G" = (
/obj/structure/outcrop/coal,
/turf/simulated/mineral/floor/vacuum,
/area/submap/asteroid5)
"I" = (
/obj/structure/outcrop/silver,
/turf/simulated/mineral/floor/vacuum,
/area/submap/asteroid5)

(1,1,1) = {"
a
a
a
a
a
a
a
a
a
a
a
a
a
a
a
a
a
a
a
a
a
a
a
a
a
a
a
a
a
a
a
a
a
a
a
a
a
a
a
a
"}
(2,1,1) = {"
a
a
a
a
a
a
a
a
a
a
a
a
a
a
a
a
a
a
a
a
a
a
a
a
a
a
a
a
a
a
a
b
d
r
d
a
a
a
a
a
"}
(3,1,1) = {"
a
a
a
a
a
a
a
a
a
a
a
a
a
a
a
a
a
a
a
a
a
a
a
a
a
a
a
a
a
a
a
b
d
d
d
d
b
a
a
a
"}
(4,1,1) = {"
a
a
a
a
a
a
b
b
f
d
a
a
a
a
a
a
a
a
a
a
a
a
a
a
a
a
a
a
a
v
d
d
b
p
v
d
b
b
b
a
"}
(5,1,1) = {"
a
a
a
a
a
a
b
b
b
b
b
a
a
a
a
a
a
a
a
a
a
a
a
a
a
a
a
d
d
r
d
p
b
b
b
b
b
b
b
a
"}
(6,1,1) = {"
a
a
a
a
f
d
d
b
b
b
b
b
b
b
a
a
a
a
a
a
a
a
a
a
a
a
a
d
d
d
d
d
b
b
b
b
b
b
b
a
"}
(7,1,1) = {"
a
a
a
a
d
d
d
d
b
b
b
b
b
b
p
d
d
a
a
a
a
a
a
a
a
b
b
d
d
d
d
b
b
b
b
b
b
b
b
a
"}
(8,1,1) = {"
a
a
a
a
d
d
f
p
b
b
b
b
b
b
f
d
I
a
a
a
a
a
a
a
b
d
d
d
p
b
d
d
r
d
b
b
b
b
b
a
"}
(9,1,1) = {"
a
a
a
b
I
d
d
b
b
b
I
d
d
d
b
b
b
a
a
a
a
a
a
a
d
d
v
b
b
b
d
d
d
p
b
b
p
d
a
a
"}
(10,1,1) = {"
a
a
a
b
b
b
b
b
d
d
d
d
d
d
d
p
b
a
a
a
a
a
a
b
r
d
b
b
b
b
d
d
d
v
b
b
d
d
a
a
"}
(11,1,1) = {"
a
a
b
b
b
b
b
p
d
d
f
a
a
d
d
d
d
a
a
a
a
a
a
v
d
d
b
v
d
d
r
d
d
d
b
b
b
b
a
a
"}
(12,1,1) = {"
a
a
b
b
b
b
b
d
d
a
a
a
a
f
d
f
b
a
a
a
a
a
a
d
d
b
b
d
d
d
d
d
d
d
b
b
b
a
a
a
"}
(13,1,1) = {"
a
a
b
b
b
b
d
I
a
a
a
a
a
a
a
a
a
a
a
a
a
a
a
d
d
d
d
d
d
r
d
r
d
d
b
b
b
b
a
a
"}
(14,1,1) = {"
a
a
b
b
b
I
d
d
a
a
a
a
a
a
a
a
a
a
a
a
a
a
b
d
d
d
d
b
d
d
d
d
d
d
b
b
b
b
a
a
"}
(15,1,1) = {"
a
a
b
b
b
d
d
a
a
a
a
a
a
a
a
a
a
a
a
a
a
a
d
p
b
d
d
b
p
d
b
d
d
d
b
b
b
b
a
a
"}
(16,1,1) = {"
a
b
b
b
p
d
f
a
a
a
a
a
b
a
a
a
a
a
a
a
a
a
d
r
b
d
d
b
b
b
b
v
d
d
b
b
b
b
a
a
"}
(17,1,1) = {"
a
b
b
b
d
d
d
a
a
a
a
a
a
a
a
B
B
B
B
B
a
a
v
d
b
p
d
b
b
v
d
d
d
p
b
b
b
b
b
a
"}
(18,1,1) = {"
a
b
b
b
d
I
d
a
a
a
a
a
a
a
a
B
b
b
b
b
E
a
d
d
b
b
b
b
b
d
d
d
d
b
b
b
b
p
d
a
"}
(19,1,1) = {"
a
d
I
d
d
d
a
a
b
b
a
a
a
a
B
b
b
d
b
b
E
a
d
d
b
b
b
b
v
d
d
d
b
b
v
d
b
d
d
a
"}
(20,1,1) = {"
a
d
d
d
f
d
a
a
b
b
b
a
a
B
b
b
d
n
d
b
E
a
b
d
b
b
b
b
d
d
d
b
b
b
p
d
b
d
r
a
"}
(21,1,1) = {"
a
f
d
d
d
f
a
a
b
b
b
a
a
B
b
d
q
z
b
b
B
a
b
d
d
p
b
b
d
d
d
p
b
b
b
b
b
v
d
a
"}
(22,1,1) = {"
a
d
p
b
I
d
a
a
a
a
a
a
a
B
b
b
d
b
b
B
a
a
b
d
d
d
d
d
d
b
d
d
b
b
b
b
b
b
b
a
"}
(23,1,1) = {"
a
b
b
b
d
d
a
a
a
a
a
a
a
B
b
b
b
b
B
E
a
a
a
v
d
d
d
d
d
b
d
d
b
b
b
b
b
b
b
a
"}
(24,1,1) = {"
a
a
b
b
d
d
d
a
a
a
a
a
a
a
a
b
B
E
B
a
a
a
a
a
a
d
d
d
d
d
d
d
b
b
b
b
b
b
a
a
"}
(25,1,1) = {"
a
a
b
b
p
d
d
I
d
a
a
a
a
a
a
a
a
a
a
a
a
a
a
a
a
b
p
d
r
d
r
v
b
b
b
b
b
b
a
a
"}
(26,1,1) = {"
a
a
b
b
b
b
d
d
f
a
a
a
a
a
a
a
a
a
a
a
a
a
a
a
a
a
a
v
d
d
d
d
p
d
b
a
a
a
a
a
"}
(27,1,1) = {"
a
a
b
b
b
b
d
p
d
a
a
a
a
a
a
a
a
a
a
a
a
a
a
a
a
a
a
a
a
a
a
a
a
a
a
a
a
a
a
a
"}
(28,1,1) = {"
a
a
b
b
p
d
b
b
b
a
a
a
b
b
a
a
a
a
a
a
a
a
b
a
a
a
a
a
a
a
a
a
a
a
a
a
a
a
a
a
"}
(29,1,1) = {"
a
a
a
b
d
I
b
b
b
b
b
b
b
b
a
a
a
a
G
d
t
b
b
b
a
a
a
a
a
a
a
a
a
a
a
a
a
a
a
a
"}
(30,1,1) = {"
a
a
a
a
a
a
a
b
b
b
b
b
a
a
a
a
a
a
d
d
d
p
b
b
a
a
a
a
a
a
a
a
a
a
a
a
a
a
a
a
"}
(31,1,1) = {"
a
a
a
a
a
a
a
a
a
a
a
a
a
a
a
a
a
a
d
d
d
b
b
b
b
b
b
a
a
a
a
a
a
a
a
a
a
a
a
a
"}
(32,1,1) = {"
a
a
a
a
a
a
a
a
a
a
a
a
a
a
a
a
t
d
d
p
d
b
b
b
b
b
b
b
a
a
a
a
a
a
a
a
a
a
a
a
"}
(33,1,1) = {"
a
a
a
a
a
a
a
a
a
a
a
a
a
a
a
a
d
d
d
b
b
b
b
b
b
b
b
d
a
a
a
a
a
a
a
a
a
a
a
a
"}
(34,1,1) = {"
a
a
a
a
a
a
a
a
a
a
a
a
a
a
a
G
d
d
d
t
d
d
d
d
G
b
b
p
b
a
a
a
a
a
a
a
b
b
a
a
"}
(35,1,1) = {"
a
a
a
a
a
a
a
a
a
a
a
a
a
a
a
d
d
d
d
G
d
d
t
d
d
b
b
b
b
a
a
a
a
a
a
b
b
b
a
a
"}
(36,1,1) = {"
a
a
a
a
a
a
a
a
a
a
a
a
b
b
b
t
d
p
b
b
b
d
d
d
d
b
b
b
p
a
a
a
a
a
b
b
b
b
a
a
"}
(37,1,1) = {"
a
a
a
a
a
a
a
a
a
a
a
b
p
d
d
b
b
b
b
b
b
b
d
t
b
b
b
a
a
a
a
a
a
a
b
b
b
a
a
a
"}
(38,1,1) = {"
a
a
a
a
a
a
a
a
a
a
b
t
d
d
G
b
b
b
b
b
b
G
p
b
b
b
b
a
a
a
a
a
a
a
a
a
a
a
a
a
"}
(39,1,1) = {"
a
a
a
a
a
a
a
a
a
a
a
a
G
d
p
b
a
a
a
b
b
b
b
b
a
a
a
a
a
a
a
a
a
a
a
a
a
a
a
a
"}
(40,1,1) = {"
a
a
a
a
a
a
a
a
a
a
a
a
a
a
a
a
a
a
a
a
a
a
a
a
a
a
a
a
a
a
a
a
a
a
a
a
a
a
a
a
"}
