//MAP CONVERTED BY dmm2tgm.py THIS HEADER COMMENT PREVENTS RECONVERSION, DO NOT REMOVE
"a" = (
/turf/template_noop,
/area/template_noop)
"b" = (
/turf/simulated/mineral/crystal,
/area/template_noop)
"c" = (
/turf/simulated/mineral/floor/dirt{
	oxygen = 0;
	nitrogen = 0
	},
/area/submap/asteroid2)
"d" = (
/turf/simulated/mineral/floor/icey{
	oxygen = 0;
	nitrogen = 0
	},
/area/submap/asteroid2)
"e" = (
/obj/random/outcrop,
/turf/simulated/mineral/floor/dirt{
	oxygen = 0;
	nitrogen = 0
	},
/area/submap/asteroid2)
"f" = (
/turf/simulated/floor,
/area/submap/asteroid2)
"g" = (
/obj/structure/window/plastitanium{
	dir = 1
	},
/obj/structure/window/plastitanium{
	dir = 4
	},
/obj/structure/grille/broken,
/turf/simulated/floor/outdoors/rocks{
	oxygen = 0;
	nitrogen = 0
	},
/area/submap/asteroid2)
"h" = (
/obj/machinery/atmospherics/pipe/manifold/hidden/fuel{
	dir = 8
	},
/obj/effect/floor_decal/rust,
/turf/simulated/floor,
/area/submap/asteroid2)
"i" = (
/obj/structure/salvageable/console_broken_os{
	dir = 4
	},
/turf/simulated/floor/outdoors/rocks{
	oxygen = 0;
	nitrogen = 0
	},
/area/submap/asteroid2)
"j" = (
/obj/item/clothing/under/rank/khi/eng,
/turf/simulated/floor/tiled/techfloor,
/area/submap/asteroid2)
"k" = (
/obj/structure/outcrop/platinum,
/obj/structure/grille/broken,
/turf/simulated/floor/outdoors/rocks{
	oxygen = 0;
	nitrogen = 0
	},
/area/submap/asteroid2)
"l" = (
/obj/structure/table/steel_reinforced,
/obj/item/stack/nanopaste/advanced,
/obj/item/stack/nanopaste/advanced,
/turf/simulated/floor/tiled/techfloor,
/area/submap/asteroid2)
"m" = (
/obj/structure/grille/broken,
/turf/simulated/floor/outdoors/rocks{
	oxygen = 0;
	nitrogen = 0
	},
/area/submap/asteroid2)
"n" = (
/obj/machinery/atmospherics/pipe/simple/visible/fuel,
/obj/effect/floor_decal/rust,
/turf/simulated/floor,
/area/submap/asteroid2)
"o" = (
/turf/simulated/mineral/crystal,
/area/submap/asteroid2)
"p" = (
/obj/structure/outcrop/platinum,
/turf/simulated/mineral/floor/icey{
	oxygen = 0;
	nitrogen = 0
	},
/area/submap/asteroid2)
"q" = (
/obj/effect/wingrille_spawn/reinforced,
/turf/simulated/floor/tiled/techfloor,
/area/submap/asteroid2)
"r" = (
/obj/structure/outcrop/iron,
/turf/simulated/mineral/floor/icey{
	oxygen = 0;
	nitrogen = 0
	},
/area/submap/asteroid2)
"s" = (
/obj/structure/outcrop/diamond,
/turf/simulated/mineral/floor/icey{
	oxygen = 0;
	nitrogen = 0
	},
/area/submap/asteroid2)
"t" = (
/turf/simulated/mineral/floor/icey{
	oxygen = 0;
	nitrogen = 0
	},
/area/template_noop)
"u" = (
/obj/structure/table/steel_reinforced,
/obj/item/storage/toolbox/mechanical,
/turf/simulated/floor/tiled/techfloor,
/area/submap/asteroid2)
"v" = (
/obj/random/outcrop,
/turf/simulated/mineral/floor/icey{
	oxygen = 0;
	nitrogen = 0
	},
/area/template_noop)
"w" = (
/obj/machinery/atmospherics/unary/engine/biggest{
	dir = 8
	},
/turf/template_noop,
/area/template_noop)
"x" = (
/obj/random/outcrop,
/turf/simulated/mineral/floor/icey{
	oxygen = 0;
	nitrogen = 0
	},
/area/submap/asteroid2)
"y" = (
/obj/machinery/door/airlock/voidcraft,
/turf/simulated/floor,
/area/submap/asteroid2)
"z" = (
/obj/effect/floor_decal/rust,
/turf/simulated/floor,
/area/submap/asteroid2)
"A" = (
/turf/simulated/mineral/floor/dirt{
	oxygen = 0;
	nitrogen = 0
	},
/area/template_noop)
"B" = (
/obj/structure/table/steel_reinforced,
/obj/item/gun/magnetic/railgun/flechette/pistol/khi,
/obj/item/magnetic_ammo/pistol/khi,
/turf/simulated/floor/tiled/techfloor,
/area/submap/asteroid2)
"C" = (
/turf/simulated/floor/outdoors/rocks{
	oxygen = 0;
	nitrogen = 0
	},
/area/submap/asteroid2)
"D" = (
/obj/structure/grille/broken,
/obj/effect/floor_decal/rust,
/turf/simulated/floor,
/area/submap/asteroid2)
"E" = (
/turf/simulated/floor/outdoors/ice/dark{
	nitrogen = 0;
	oxygen = 0
	},
/area/submap/asteroid2)
"F" = (
/obj/machinery/portable_atmospherics/canister/phoron/cold,
/turf/simulated/floor/tiled/techfloor,
/area/submap/asteroid2)
"G" = (
/obj/machinery/door/airlock/voidcraft/vertical,
/turf/simulated/floor/tiled/techfloor,
/area/submap/asteroid2)
"H" = (
/obj/structure/salvageable/console,
/turf/simulated/floor/outdoors/rocks{
	oxygen = 0;
	nitrogen = 0
	},
/area/submap/asteroid2)
"I" = (
/obj/structure/window/plastitanium{
	dir = 4
	},
/obj/structure/grille/broken,
/turf/simulated/floor/outdoors/rocks{
	oxygen = 0;
	nitrogen = 0
	},
/area/submap/asteroid2)
"J" = (
/obj/structure/salvageable/console{
	dir = 1
	},
/turf/simulated/floor,
/area/submap/asteroid2)
"K" = (
/obj/effect/floor_decal/rust,
/obj/machinery/optable,
/turf/simulated/floor,
/area/submap/asteroid2)
"L" = (
/turf/simulated/floor/tiled/milspec,
/area/submap/asteroid2)
"M" = (
/obj/structure/closet/walllocker_double/security/north,
/obj/item/clothing/under/rank/khi/sec,
/obj/item/clothing/under/rank/khi/sec,
/obj/item/clothing/under/rank/khi/sec,
/obj/item/clothing/under/rank/khi/sec,
/turf/simulated/floor/tiled/techfloor,
/area/submap/asteroid2)
"N" = (
/obj/structure/table/steel_reinforced,
/turf/simulated/floor/tiled/techfloor,
/area/submap/asteroid2)
"O" = (
/turf/simulated/mineral/icey,
/area/submap/asteroid2)
"P" = (
/obj/structure/salvageable/console{
	dir = 1
	},
/turf/simulated/floor/tiled/milspec,
/area/submap/asteroid2)
"Q" = (
/obj/structure/table/steel_reinforced,
/obj/item/nif,
/obj/item/storage/belt/medical/alien,
/turf/simulated/floor/tiled/techfloor,
/area/submap/asteroid2)
"R" = (
/turf/simulated/wall/rplastihull,
/area/submap/asteroid2)
"S" = (
/turf/simulated/floor/tiled/techfloor,
/area/submap/asteroid2)
"T" = (
/turf/simulated/mineral,
/area/submap/asteroid2)
"U" = (
/obj/item/paper{
	info = "Man, its great being one of the most hyper advances species known to the univere, wait what is this blue ball?"
	},
/obj/structure/prop/blackbox,
/turf/simulated/floor/tiled/milspec,
/area/submap/asteroid2)
"V" = (
/obj/effect/decal/remains/tajaran,
/obj/item/clothing/under/rank/khi/cmd,
/turf/simulated/floor/tiled/milspec,
/area/submap/asteroid2)
"W" = (
/obj/structure/outcrop/phoron,
/turf/simulated/mineral/floor/icey{
	oxygen = 0;
	nitrogen = 0
	},
/area/submap/asteroid2)
"X" = (
/obj/structure/salvageable/console,
/turf/simulated/floor/tiled/milspec,
/area/submap/asteroid2)
"Y" = (
/obj/machinery/atmospherics/pipe/simple/hidden/fuel,
/turf/simulated/floor/tiled/techfloor,
/area/submap/asteroid2)
"Z" = (
/obj/machinery/door/airlock/voidcraft/vertical,
/turf/simulated/floor,
/area/submap/asteroid2)

(1,1,1) = {"
a
a
a
a
a
a
a
a
a
a
a
a
a
a
a
a
a
a
a
a
a
a
a
a
a
a
a
a
a
a
a
a
a
a
a
a
a
a
a
a
a
a
a
a
a
a
a
a
a
a
a
a
a
a
a
a
a
a
a
a
"}
(2,1,1) = {"
a
a
a
a
a
a
a
a
a
a
a
a
a
a
a
a
a
a
a
a
a
a
a
a
a
a
a
a
a
a
a
a
a
O
a
a
a
a
a
a
a
a
a
a
a
a
a
a
a
a
a
a
a
a
a
a
a
a
a
a
"}
(3,1,1) = {"
a
a
a
a
a
a
a
a
a
a
a
a
a
a
a
a
a
a
a
a
a
a
a
a
a
a
a
a
a
O
O
O
O
O
a
a
a
a
a
a
a
a
a
a
a
a
a
a
a
a
a
a
a
a
a
a
a
a
a
a
"}
(4,1,1) = {"
a
a
a
a
a
a
a
a
a
a
a
a
a
a
a
a
a
a
a
a
a
a
a
a
a
a
a
O
O
O
O
O
o
o
a
a
a
a
a
a
a
a
a
a
a
a
a
a
a
a
a
a
a
a
a
a
a
a
a
a
"}
(5,1,1) = {"
a
a
a
a
a
a
a
a
a
a
a
a
a
a
a
a
a
a
a
a
a
a
a
a
O
O
O
O
O
O
O
o
o
a
a
a
a
a
a
a
a
a
a
a
a
a
a
a
a
a
a
a
a
a
a
a
a
a
a
a
"}
(6,1,1) = {"
a
a
a
a
a
a
a
a
a
a
a
a
a
a
a
a
a
a
a
a
a
a
a
O
O
O
O
O
O
O
o
o
a
a
a
a
a
a
a
a
a
a
a
a
a
a
a
a
a
a
a
a
a
a
a
a
a
a
a
a
"}
(7,1,1) = {"
a
a
a
a
a
a
a
a
a
a
a
a
a
a
a
a
a
a
a
a
a
O
O
O
c
x
d
x
o
o
a
a
a
a
a
a
a
a
a
a
a
a
a
a
a
a
a
o
o
o
o
O
O
a
a
a
a
a
a
a
"}
(8,1,1) = {"
a
a
a
a
a
a
a
a
a
a
a
a
a
a
a
a
a
a
a
O
O
O
e
c
d
d
d
d
o
E
c
a
a
a
a
a
a
a
a
a
a
a
a
a
a
o
o
o
o
o
O
O
O
O
a
a
a
a
a
a
"}
(9,1,1) = {"
a
a
a
a
a
a
a
a
a
a
a
a
a
a
a
a
a
a
O
O
c
c
c
c
d
d
d
O
E
c
c
a
a
a
a
a
a
a
a
a
a
a
a
a
a
o
o
o
E
E
E
d
d
O
O
a
a
a
a
a
"}
(10,1,1) = {"
a
a
a
a
a
a
a
a
a
a
a
a
a
a
a
a
a
O
O
e
c
c
c
d
d
d
O
E
E
c
c
a
a
a
a
a
t
a
a
a
a
a
a
a
o
d
d
d
d
E
E
d
d
x
O
O
O
a
a
a
"}
(11,1,1) = {"
a
a
a
a
a
a
a
a
a
a
a
a
a
a
a
a
O
O
c
c
c
d
d
d
x
O
O
E
c
c
a
a
a
a
a
t
t
a
a
a
a
a
a
a
o
d
d
d
d
d
d
d
d
d
O
O
O
a
a
a
"}
(12,1,1) = {"
a
a
a
a
a
a
a
a
a
a
a
a
a
a
a
O
O
c
c
c
c
d
d
d
O
O
E
c
c
a
a
a
a
a
a
a
a
a
a
a
a
a
a
a
o
d
d
x
d
x
x
d
d
x
d
O
O
o
a
a
"}
(13,1,1) = {"
a
a
a
a
a
a
a
a
a
a
a
a
a
O
O
O
e
c
c
d
d
d
O
O
E
E
c
c
a
t
a
a
a
a
a
a
a
a
a
a
a
a
a
a
o
o
d
x
d
d
d
d
d
x
d
d
d
o
a
a
"}
(14,1,1) = {"
a
a
a
a
a
a
a
a
a
a
a
a
o
o
c
c
c
d
d
d
x
O
O
c
c
c
c
a
a
a
a
a
a
a
a
a
a
a
a
a
a
a
a
a
o
o
d
d
d
c
c
c
x
d
d
d
d
o
a
a
"}
(15,1,1) = {"
a
a
a
a
a
a
a
a
a
a
a
o
o
c
c
d
d
d
x
d
O
o
c
c
a
a
a
a
a
a
a
a
a
a
a
a
a
a
a
a
a
a
a
a
o
o
d
d
d
c
c
c
c
d
d
d
x
o
a
a
"}
(16,1,1) = {"
a
a
a
a
a
a
a
a
a
a
o
o
e
e
d
d
d
d
O
O
o
o
a
a
a
a
a
a
a
a
a
a
a
a
a
a
a
a
a
a
a
a
a
a
o
o
x
d
d
d
c
c
c
d
d
d
d
o
a
a
"}
(17,1,1) = {"
a
a
a
a
a
a
a
a
a
o
o
c
c
d
d
d
d
O
o
o
o
a
a
a
a
a
a
a
a
a
a
a
a
a
a
a
a
a
a
a
a
a
a
a
a
o
o
d
d
d
d
d
d
d
d
d
d
o
a
a
"}
(18,1,1) = {"
a
a
a
a
a
a
a
o
o
o
c
c
d
d
d
O
O
b
a
a
a
a
a
a
a
a
a
a
a
a
a
t
a
a
a
a
a
a
a
a
a
a
a
a
a
o
o
d
d
x
d
d
d
d
d
d
o
o
a
a
"}
(19,1,1) = {"
a
a
a
a
a
a
o
o
o
c
d
d
d
d
O
o
b
b
a
a
a
a
a
a
a
a
a
a
a
a
a
a
a
a
a
a
a
a
a
a
a
a
a
a
a
O
O
d
d
d
d
d
d
d
d
d
o
a
a
a
"}
(20,1,1) = {"
a
a
a
a
a
o
o
o
c
e
d
d
O
O
o
o
a
a
a
a
a
a
a
a
a
a
a
a
a
a
a
a
a
a
a
a
a
a
a
a
a
a
a
a
a
O
O
O
O
d
d
x
d
d
d
o
o
a
a
a
"}
(21,1,1) = {"
a
a
a
a
a
o
o
c
d
d
d
O
O
o
o
a
a
a
a
a
a
a
a
a
a
a
a
a
a
a
a
a
a
a
a
x
a
a
a
a
a
a
a
a
a
O
O
O
O
o
d
d
d
d
o
o
a
a
a
a
"}
(22,1,1) = {"
a
a
a
a
o
o
c
c
d
d
o
O
o
o
a
a
a
a
a
a
a
a
d
x
d
d
a
a
a
a
a
a
a
a
a
a
a
a
a
a
a
a
a
a
a
a
a
a
o
o
o
o
o
o
o
a
a
a
a
a
"}
(23,1,1) = {"
a
a
a
o
o
e
c
d
d
d
O
o
a
a
a
a
a
a
a
a
a
d
d
d
d
d
a
d
d
r
d
a
a
a
a
a
a
a
a
a
a
a
a
a
a
a
a
a
a
a
a
a
a
a
a
a
a
a
a
a
"}
(24,1,1) = {"
a
a
a
o
o
c
d
d
x
O
O
a
a
a
a
a
a
a
a
a
d
r
d
d
p
x
d
d
d
d
d
d
a
a
x
a
a
a
a
a
a
a
a
a
a
a
a
a
a
a
a
a
a
a
a
a
a
a
a
a
"}
(25,1,1) = {"
a
a
o
o
c
d
d
O
O
O
a
a
a
a
a
a
a
a
a
a
d
d
W
o
o
o
o
d
d
r
d
d
d
a
a
a
a
a
a
a
a
a
a
a
a
a
a
a
a
a
a
a
a
a
a
a
a
a
a
a
"}
(26,1,1) = {"
a
a
a
O
d
d
d
O
O
a
a
a
a
a
a
a
a
a
a
r
d
d
d
o
o
o
o
x
d
d
d
d
r
a
a
a
a
a
a
a
a
a
a
a
a
a
a
a
a
a
a
a
a
a
a
a
a
a
a
a
"}
(27,1,1) = {"
a
a
a
O
O
O
O
O
a
a
a
a
a
a
a
a
a
a
a
d
d
d
o
o
o
o
o
p
W
r
d
x
d
d
r
a
a
a
a
a
a
a
a
a
a
a
a
a
a
a
a
a
a
a
a
a
a
a
a
a
"}
(28,1,1) = {"
a
a
a
a
a
a
a
a
a
a
a
a
a
a
a
a
a
a
a
d
x
o
o
o
o
p
o
o
o
o
o
T
d
d
d
a
a
a
a
a
a
a
a
a
a
a
a
a
a
a
a
a
a
a
a
a
a
a
a
a
"}
(29,1,1) = {"
a
a
a
a
a
a
a
a
a
a
a
a
a
a
a
a
a
a
a
d
d
d
o
o
o
s
o
o
o
o
d
d
d
o
d
d
a
a
a
a
a
a
a
a
a
a
a
a
a
a
a
a
a
a
a
a
a
a
a
a
"}
(30,1,1) = {"
a
a
a
a
t
a
a
a
a
a
a
a
a
a
a
a
a
a
a
a
d
p
p
o
o
x
d
o
o
d
p
o
o
o
x
d
a
a
a
a
a
a
a
a
a
a
a
a
a
a
a
a
a
a
a
a
a
a
a
a
"}
(31,1,1) = {"
a
a
a
a
a
a
a
t
a
a
a
a
a
a
a
a
a
a
a
a
d
d
d
o
o
o
d
d
d
d
r
o
o
o
r
d
a
a
a
a
a
a
a
a
a
a
a
a
a
a
a
a
a
a
a
a
a
a
a
a
"}
(32,1,1) = {"
a
a
a
a
a
a
a
a
a
a
a
a
a
a
a
a
a
a
a
a
a
d
x
d
d
o
W
s
x
d
o
o
o
d
o
d
a
a
a
a
a
a
a
a
a
a
a
a
a
a
a
a
a
a
a
a
a
a
a
a
"}
(33,1,1) = {"
a
a
a
a
a
a
a
a
a
a
a
a
a
a
a
a
a
a
a
a
a
d
d
d
d
W
o
o
o
o
o
o
o
o
o
d
d
a
a
a
a
a
a
a
a
a
a
a
a
a
a
a
a
a
a
a
a
a
a
a
"}
(34,1,1) = {"
a
t
a
a
a
a
a
a
a
a
a
a
a
a
a
a
a
a
a
a
a
r
d
d
r
d
o
o
o
o
o
o
d
o
o
o
x
a
a
a
a
a
a
a
a
a
a
a
a
a
a
a
a
a
a
a
a
a
a
a
"}
(35,1,1) = {"
a
a
a
t
a
a
a
a
a
a
a
a
a
t
a
a
a
a
a
a
a
a
a
o
o
o
o
R
g
I
m
k
p
o
O
O
d
a
a
a
a
a
a
a
a
a
a
a
a
a
a
a
a
a
a
a
a
a
a
a
"}
(36,1,1) = {"
a
a
a
a
a
a
a
a
a
a
a
a
a
a
a
a
a
a
a
a
a
a
a
b
b
d
R
H
L
i
C
J
R
d
W
d
d
a
a
a
a
a
a
a
a
a
a
a
a
a
a
a
a
a
a
a
a
a
a
a
"}
(37,1,1) = {"
a
a
a
a
a
a
a
a
a
a
a
a
a
a
a
a
a
a
a
a
d
a
b
b
a
r
R
X
L
L
V
P
R
d
d
a
a
a
a
a
a
a
a
a
a
a
a
a
a
a
a
a
a
a
a
a
a
a
a
a
"}
(38,1,1) = {"
a
a
a
a
a
a
a
a
a
a
a
a
a
a
a
a
t
a
a
a
x
d
a
b
a
a
R
L
z
z
L
L
z
d
a
a
a
a
a
a
a
a
a
a
a
a
b
t
A
a
a
a
a
a
a
a
a
a
a
a
"}
(39,1,1) = {"
a
a
a
a
a
a
a
a
a
a
a
a
t
a
t
a
a
a
a
a
a
a
a
a
a
a
R
U
L
z
L
L
R
d
a
a
a
a
a
a
a
a
a
a
a
a
b
A
A
a
a
a
a
a
a
a
a
a
a
a
"}
(40,1,1) = {"
a
a
a
a
a
a
a
a
a
a
a
a
a
a
a
a
a
a
a
v
a
a
a
a
a
a
R
R
q
G
q
R
R
a
a
a
a
a
a
a
a
a
a
a
a
a
a
a
a
a
a
a
t
a
a
a
a
a
a
a
"}
(41,1,1) = {"
a
a
a
a
a
a
a
a
a
a
a
a
a
a
a
a
a
a
a
a
a
a
a
a
a
a
a
R
S
S
S
R
a
a
a
a
a
a
a
a
a
a
a
a
d
O
O
a
a
a
a
a
A
a
a
a
a
a
a
a
"}
(42,1,1) = {"
a
a
t
a
a
a
a
t
a
a
a
a
a
a
t
a
a
a
a
a
a
a
a
a
a
a
a
D
S
S
z
D
a
a
a
a
a
a
a
a
a
a
a
d
O
O
O
O
a
a
a
a
a
a
a
a
a
a
a
a
"}
(43,1,1) = {"
a
a
t
a
a
a
a
a
a
a
a
a
a
a
a
a
a
a
a
a
a
a
a
a
a
a
R
R
u
S
z
R
R
a
a
a
a
a
a
a
a
a
a
d
O
e
c
O
O
a
a
a
a
a
a
a
a
a
a
a
"}
(44,1,1) = {"
a
a
a
a
a
a
a
a
a
b
a
a
t
t
a
a
a
a
a
a
a
a
a
a
a
R
R
N
N
z
f
l
R
R
a
a
a
a
a
a
a
a
a
d
O
c
x
d
O
a
a
a
a
a
a
a
a
a
a
a
"}
(45,1,1) = {"
a
a
a
a
a
a
a
a
a
t
a
a
a
a
a
a
a
a
a
a
a
a
a
a
a
R
M
S
S
z
z
Q
K
R
a
a
a
a
a
a
a
a
d
O
O
c
d
d
O
O
a
a
a
a
a
a
a
a
a
a
"}
(46,1,1) = {"
a
a
a
a
a
a
a
a
t
t
t
A
a
a
a
a
a
a
a
a
a
a
a
a
a
y
S
S
S
S
S
S
z
y
a
a
a
a
a
a
a
a
d
O
e
c
d
d
d
O
O
a
a
a
a
a
a
a
a
a
"}
(47,1,1) = {"
a
a
a
a
a
a
a
a
a
A
A
a
a
a
a
a
a
a
b
a
b
a
a
a
a
D
B
S
S
S
S
z
j
D
a
a
a
a
a
a
a
a
d
O
e
d
d
d
x
x
O
a
a
a
a
a
a
a
a
a
"}
(48,1,1) = {"
a
a
a
a
a
a
a
a
a
a
a
a
a
a
a
a
a
a
t
a
t
a
a
a
a
D
B
n
z
Y
h
z
F
D
a
a
a
a
a
b
a
a
d
O
c
d
d
d
x
O
O
a
a
a
a
a
a
a
a
a
"}
(49,1,1) = {"
a
a
a
a
a
a
a
a
a
a
a
a
a
t
a
a
a
t
t
a
A
A
a
a
a
R
B
S
S
S
S
S
F
R
a
a
a
a
a
t
a
a
d
O
c
d
d
d
d
O
o
a
a
a
a
a
a
a
a
a
"}
(50,1,1) = {"
a
a
a
a
a
a
a
a
a
a
a
a
a
a
a
a
a
a
A
a
a
a
a
a
a
R
R
R
Z
R
R
R
R
R
a
a
a
a
a
t
A
a
d
O
c
x
d
d
O
O
o
a
a
a
a
a
a
a
a
a
"}
(51,1,1) = {"
a
a
a
a
a
a
a
a
a
a
a
a
a
a
a
a
a
a
a
a
a
a
a
a
a
a
a
w
a
a
a
a
a
w
a
a
a
a
a
A
A
a
d
O
e
d
d
d
O
o
o
a
a
a
a
a
a
a
a
a
"}
(52,1,1) = {"
a
a
a
a
a
a
a
a
a
t
a
a
a
a
a
a
a
a
a
a
a
a
a
a
a
a
a
a
a
a
a
a
a
a
a
a
a
a
a
a
a
a
a
d
O
d
d
O
O
o
a
a
a
a
a
a
a
a
a
a
"}
(53,1,1) = {"
a
t
a
a
t
a
a
a
a
a
a
a
a
a
a
a
a
a
a
a
a
a
a
a
a
a
a
a
a
a
a
a
a
a
a
a
a
a
a
a
a
a
a
d
O
d
d
O
o
o
a
a
a
a
a
a
a
a
a
a
"}
(54,1,1) = {"
a
t
a
a
a
a
a
t
a
a
a
a
a
a
a
a
a
a
a
a
a
a
a
a
a
a
a
a
a
a
a
a
a
a
a
a
a
a
a
a
a
a
a
d
O
d
d
O
o
a
a
a
a
a
a
a
a
a
a
a
"}
(55,1,1) = {"
a
a
a
a
a
a
a
a
a
a
a
a
a
a
a
a
a
a
a
a
a
a
a
a
a
a
a
a
a
a
a
a
a
a
a
a
a
a
a
a
a
a
a
d
O
O
d
O
o
a
a
a
a
a
a
a
a
a
a
a
"}
(56,1,1) = {"
a
a
a
a
a
a
a
a
a
a
a
a
a
a
a
a
a
a
a
a
a
a
a
a
a
a
a
a
a
a
a
a
a
a
a
a
a
a
a
a
a
a
a
a
d
O
O
o
o
a
a
a
a
a
a
a
a
a
a
a
"}
(57,1,1) = {"
a
a
t
a
a
a
a
a
a
a
a
a
a
a
a
a
a
a
a
a
a
a
a
a
a
a
a
a
a
a
a
a
a
a
a
a
a
a
a
a
a
a
a
a
d
O
O
o
a
a
a
a
a
a
a
a
a
a
a
a
"}
(58,1,1) = {"
a
a
a
a
a
a
a
a
a
a
a
a
a
a
a
a
a
a
a
a
a
a
a
a
a
a
a
a
a
a
a
a
a
a
a
a
a
a
a
a
a
a
a
a
a
o
o
o
a
a
a
a
a
a
a
a
a
a
a
a
"}
(59,1,1) = {"
a
t
a
a
a
a
a
a
a
a
a
a
a
a
a
a
a
a
a
a
a
a
a
a
a
a
a
a
a
a
a
a
a
a
a
a
a
a
a
a
a
a
a
a
a
a
a
a
a
a
a
a
a
a
a
a
a
a
a
a
"}
(60,1,1) = {"
a
a
a
a
a
a
a
a
a
a
a
a
a
a
a
a
a
a
a
a
a
a
a
a
a
a
a
a
a
a
a
a
a
a
a
a
a
a
a
a
a
a
a
a
a
a
a
a
a
a
a
a
a
a
a
a
a
a
a
a
"}
