//MAP CONVERTED BY dmm2tgm.py THIS HEADER COMMENT PREVENTS RECONVERSION, DO NOT REMOVE
"a" = (
/turf/template_noop,
/area/template_noop)
"b" = (
/obj/random/outcrop,
/turf/simulated/mineral/floor/vacuum,
/area/submap/asteroid1)
"c" = (
/turf/simulated/mineral/vacuum,
/area/submap/asteroid1)
"f" = (
/obj/effect/decal/cleanable/greenglow,
/turf/simulated/mineral/floor/vacuum,
/area/submap/asteroid1)
"g" = (
/obj/structure/outcrop/phoron,
/turf/simulated/mineral/floor/vacuum,
/area/submap/asteroid1)
"m" = (
/obj/item/flashlight/flare,
/turf/simulated/mineral/floor/vacuum,
/area/submap/asteroid1)
"o" = (
/obj/structure/ore_box,
/turf/simulated/mineral/floor/vacuum,
/area/submap/asteroid1)
"r" = (
/obj/item/gun/projectile/shotgun/doublebarrel/flare,
/turf/simulated/mineral/floor/vacuum,
/area/submap/asteroid1)
"t" = (
/obj/structure/outcrop/gold,
/turf/simulated/mineral/floor/vacuum,
/area/submap/asteroid1)
"u" = (
/obj/item/pickaxe,
/turf/simulated/mineral/floor/vacuum,
/area/submap/asteroid1)
"w" = (
/obj/item/ore/hydrogen,
/turf/simulated/mineral/floor/vacuum,
/area/submap/asteroid1)
"x" = (
/obj/item/ore/diamond,
/turf/simulated/mineral/floor/vacuum,
/area/submap/asteroid1)
"A" = (
/obj/item/ore/hydrogen,
/obj/item/ore/hydrogen,
/turf/simulated/mineral/floor/vacuum,
/area/submap/asteroid1)
"C" = (
/obj/item/gps/mining/on,
/turf/simulated/mineral/floor/vacuum,
/area/submap/asteroid1)
"I" = (
/obj/item/ore/verdantium,
/turf/simulated/mineral/floor/vacuum,
/area/submap/asteroid1)
"J" = (
/turf/template_noop,
/area/submap/asteroid1)
"L" = (
/obj/effect/decal/remains,
/turf/simulated/mineral/floor/vacuum,
/area/submap/asteroid1)
"P" = (
/obj/structure/outcrop/diamond,
/turf/simulated/mineral/floor/vacuum,
/area/submap/asteroid1)
"R" = (
/obj/machinery/floodlight,
/turf/simulated/mineral/floor/vacuum,
/area/submap/asteroid1)
"S" = (
/obj/item/pickaxe/diamonddrill,
/turf/simulated/mineral/floor/vacuum,
/area/submap/asteroid1)
"V" = (
/obj/structure/outcrop/uranium,
/turf/simulated/mineral/floor/vacuum,
/area/submap/asteroid1)
"Z" = (
/turf/simulated/mineral/floor/vacuum,
/area/submap/asteroid1)

(1,1,1) = {"
a
a
a
a
a
a
a
a
a
a
a
a
a
a
a
a
a
a
a
a
a
a
a
a
a
a
a
a
a
a
a
a
a
a
a
a
a
a
a
a
a
a
a
a
a
a
a
a
a
a
a
a
a
a
a
a
a
a
a
a
"}
(2,1,1) = {"
a
a
a
a
a
a
a
a
a
a
a
a
a
a
a
a
a
a
a
a
a
a
a
a
a
a
a
a
a
a
a
a
a
a
a
a
a
a
a
a
a
a
a
a
a
a
a
a
a
a
a
a
a
a
a
a
a
a
a
a
"}
(3,1,1) = {"
a
a
a
a
a
a
a
a
a
a
a
a
a
a
a
a
a
a
a
a
a
a
a
a
a
a
a
a
a
a
a
a
a
a
a
a
a
a
a
a
a
a
a
a
a
a
a
a
a
a
a
a
a
a
a
a
a
a
a
a
"}
(4,1,1) = {"
a
a
a
a
a
a
a
a
a
a
a
a
a
a
a
a
a
a
a
a
a
a
a
a
a
a
a
a
a
a
a
a
a
a
a
a
a
a
a
a
a
a
a
a
a
a
a
a
a
a
a
a
a
a
a
a
a
a
a
a
"}
(5,1,1) = {"
a
a
a
a
a
a
a
a
a
a
a
a
a
a
a
a
a
a
a
a
a
a
a
a
a
a
a
a
a
a
a
a
a
a
a
a
a
a
a
a
a
a
a
a
a
a
a
a
a
a
a
a
a
a
a
a
a
a
a
a
"}
(6,1,1) = {"
a
a
a
a
a
a
a
a
a
a
a
a
a
a
a
a
a
a
a
a
a
a
a
a
a
a
a
a
a
a
a
a
a
a
a
a
a
a
a
a
a
a
a
a
a
a
a
a
a
a
a
a
a
a
a
a
a
a
a
a
"}
(7,1,1) = {"
a
a
a
a
a
a
a
a
a
a
a
a
a
a
a
a
a
a
a
a
a
a
a
a
a
a
a
a
a
a
a
a
a
a
a
a
a
a
a
a
a
a
a
a
a
a
a
a
a
a
a
a
a
a
a
a
a
a
a
a
"}
(8,1,1) = {"
a
a
a
a
a
a
a
a
a
a
a
a
a
a
a
a
a
a
a
a
a
a
a
a
a
a
a
a
a
a
a
a
a
a
a
a
a
a
a
a
a
a
a
a
a
a
a
a
a
a
a
a
a
a
a
a
a
a
a
a
"}
(9,1,1) = {"
a
a
a
a
a
a
a
a
a
a
a
a
a
a
a
a
a
a
a
a
a
a
a
c
c
c
c
a
a
a
a
a
a
a
a
a
a
a
a
a
a
a
a
a
a
a
a
a
a
a
a
a
a
a
a
a
a
a
a
a
"}
(10,1,1) = {"
a
a
a
a
a
a
a
a
a
a
a
a
a
a
a
a
a
a
a
a
a
a
c
c
c
c
c
a
a
a
a
a
a
a
a
a
a
a
a
a
a
a
a
a
a
a
a
a
a
a
a
a
a
a
a
a
a
a
a
a
"}
(11,1,1) = {"
a
a
a
a
a
a
a
a
a
a
a
a
a
a
a
a
a
a
a
a
a
a
c
c
c
c
c
c
c
a
a
a
Z
a
a
a
a
a
a
c
c
c
c
c
c
a
a
a
a
a
a
a
a
a
a
a
a
a
a
a
"}
(12,1,1) = {"
a
a
a
a
a
a
a
a
a
a
a
a
a
a
a
a
a
a
a
a
a
c
c
c
c
c
c
c
c
c
a
a
Z
Z
a
a
a
c
c
c
c
c
c
c
c
c
c
c
a
a
a
a
a
a
a
a
a
a
a
a
"}
(13,1,1) = {"
a
a
a
a
a
a
a
a
a
a
a
a
a
a
a
a
a
a
a
a
a
c
c
c
c
c
c
c
c
c
c
Z
R
Z
Z
a
a
c
c
c
c
c
c
c
c
Z
b
c
c
a
a
a
a
a
a
a
a
a
a
a
"}
(14,1,1) = {"
a
a
a
a
a
a
a
a
a
a
a
a
a
a
a
a
a
a
a
a
c
c
c
c
c
c
c
c
c
c
c
b
Z
Z
m
Z
c
c
c
c
c
c
c
Z
Z
Z
Z
c
c
a
a
a
a
a
a
a
a
a
a
a
"}
(15,1,1) = {"
a
a
a
a
a
a
a
a
a
a
a
a
a
a
a
a
a
a
a
c
c
c
c
c
c
c
c
c
c
c
c
c
b
Z
o
g
c
c
c
c
c
w
A
w
Z
c
c
c
a
a
a
a
a
a
a
a
a
a
a
a
"}
(16,1,1) = {"
a
a
a
a
a
a
a
a
a
a
a
a
a
a
a
c
c
c
c
c
c
c
c
c
c
c
c
c
c
c
c
c
b
Z
Z
Z
c
c
c
c
c
w
A
b
c
c
c
a
a
a
a
a
a
a
a
a
a
a
a
a
"}
(17,1,1) = {"
a
a
a
a
a
a
a
a
a
a
a
a
a
c
c
c
c
c
c
c
c
c
c
c
c
c
c
c
c
c
c
c
g
Z
Z
Z
c
c
c
c
b
Z
c
c
c
a
a
a
a
a
a
a
a
a
a
a
a
a
a
a
"}
(18,1,1) = {"
a
a
a
a
a
a
a
a
a
a
a
a
c
c
c
c
c
c
c
c
c
c
c
Z
Z
c
c
c
c
c
c
c
c
Z
Z
b
c
c
c
c
Z
Z
c
c
a
a
a
a
a
a
a
a
a
a
a
a
a
a
a
a
"}
(19,1,1) = {"
a
a
a
a
a
a
a
a
a
a
a
c
c
c
c
c
c
c
c
c
c
c
Z
Z
Z
c
c
c
c
c
c
c
c
Z
Z
c
c
c
c
c
x
I
c
c
a
a
a
a
a
a
a
a
a
a
a
a
a
a
a
a
"}
(20,1,1) = {"
a
a
a
a
a
a
a
a
a
a
c
c
c
c
c
c
c
c
c
c
c
c
c
Z
Z
c
c
c
c
c
c
Z
c
Z
Z
c
c
c
c
c
Z
b
c
c
c
a
a
a
a
a
a
a
a
a
a
a
a
a
a
a
"}
(21,1,1) = {"
a
a
a
a
a
a
a
a
a
c
c
c
c
c
c
c
c
c
c
c
c
c
c
Z
c
c
c
c
c
c
Z
Z
c
Z
c
c
c
c
c
c
Z
c
c
c
c
a
a
a
a
a
a
a
a
a
a
a
a
a
a
a
"}
(22,1,1) = {"
a
a
a
a
a
a
a
a
c
c
c
c
c
c
c
c
c
c
c
c
c
c
c
c
c
c
c
c
c
Z
Z
Z
c
Z
c
c
c
c
c
Z
Z
c
c
c
c
c
a
a
a
a
a
a
a
a
a
a
a
a
a
a
"}
(23,1,1) = {"
a
a
a
a
a
a
a
a
c
c
c
c
c
c
c
c
c
c
c
c
c
c
c
c
c
c
c
c
Z
Z
Z
Z
c
Z
c
c
c
c
c
Z
Z
c
c
c
c
c
a
a
a
a
a
a
a
a
a
a
a
a
a
a
"}
(24,1,1) = {"
a
a
a
a
a
a
a
a
c
c
c
c
c
c
c
c
c
c
c
c
c
c
c
c
c
c
c
c
Z
c
c
Z
Z
Z
c
c
c
c
I
m
Z
c
c
c
c
c
a
a
a
a
a
a
a
a
a
a
a
a
a
a
"}
(25,1,1) = {"
a
a
a
a
a
a
a
a
c
c
c
c
c
c
c
c
c
c
c
c
c
c
c
c
c
c
c
c
Z
c
Z
g
Z
Z
c
c
c
c
b
Z
c
c
c
c
c
c
a
a
a
a
a
a
a
a
a
a
a
a
a
a
"}
(26,1,1) = {"
a
a
a
a
a
a
a
a
a
c
c
c
c
c
c
c
c
c
c
c
c
c
c
c
c
c
c
c
g
Z
b
Z
Z
m
Z
b
c
c
c
Z
c
c
c
c
c
c
a
a
a
a
a
a
a
a
a
a
a
a
a
a
"}
(27,1,1) = {"
a
a
a
a
a
a
a
a
a
a
c
c
c
c
c
c
c
c
c
c
c
b
c
c
c
c
Z
P
c
t
o
g
u
C
Z
c
c
c
Z
Z
c
c
c
c
c
c
a
a
a
a
a
a
a
a
a
a
a
a
a
a
"}
(28,1,1) = {"
a
a
a
a
a
a
a
a
a
c
c
c
c
c
c
c
c
c
c
c
c
g
c
c
c
c
V
c
c
c
Z
Z
r
L
Z
Z
c
Z
Z
Z
c
c
c
c
c
c
a
a
a
a
a
a
a
a
a
a
a
a
a
a
"}
(29,1,1) = {"
a
a
a
a
a
a
a
a
c
c
c
c
c
c
c
c
c
c
c
c
c
Z
Z
c
c
g
Z
c
c
P
Z
Z
Z
Z
Z
Z
Z
Z
Z
Z
c
c
c
c
c
c
a
a
a
a
a
a
a
a
a
a
a
a
a
a
"}
(30,1,1) = {"
a
a
a
a
a
a
a
a
c
c
c
c
c
c
c
c
c
c
c
c
c
c
Z
Z
c
c
t
b
Z
Z
x
Z
c
Z
Z
m
Z
Z
Z
c
c
c
c
c
c
c
a
a
a
a
a
a
a
a
a
a
a
a
a
a
"}
(31,1,1) = {"
a
a
a
a
a
a
a
a
c
c
c
c
c
c
c
c
c
c
c
c
c
c
Z
Z
Z
Z
Z
Z
Z
Z
Z
V
c
Z
Z
Z
Z
c
c
c
c
c
c
c
c
a
a
a
a
a
a
a
a
a
a
a
a
a
a
a
"}
(32,1,1) = {"
a
a
a
a
a
a
a
a
c
c
c
c
c
c
c
c
c
c
c
c
c
c
b
t
R
x
P
Z
Z
R
Z
c
c
Z
Z
Z
Z
c
c
c
c
c
a
a
a
a
a
a
a
a
a
a
a
a
a
a
a
a
a
a
"}
(33,1,1) = {"
a
a
a
a
a
a
a
a
a
a
c
c
c
c
c
c
c
c
c
c
c
c
c
c
Z
Z
P
V
Z
Z
c
c
Z
Z
P
Z
Z
c
c
c
a
a
a
a
a
a
a
a
a
a
a
a
a
a
a
a
a
a
a
a
"}
(34,1,1) = {"
a
a
a
a
a
a
a
a
a
a
c
c
c
c
c
c
c
c
c
c
c
c
g
c
Z
Z
Z
Z
c
P
Z
Z
Z
Z
c
g
Z
c
c
a
a
a
a
a
a
a
a
a
a
a
a
a
a
a
a
a
a
a
a
a
"}
(35,1,1) = {"
a
a
a
a
a
a
a
a
a
a
c
c
c
c
c
c
c
c
c
c
c
c
c
Z
Z
Z
V
Z
c
c
V
Z
Z
Z
Z
Z
Z
c
c
a
a
a
a
a
a
a
a
a
a
a
a
a
a
a
a
a
a
a
a
a
"}
(36,1,1) = {"
a
a
a
a
a
a
a
a
a
c
c
c
c
c
c
c
c
c
c
Z
Z
c
c
Z
Z
c
V
c
c
c
Z
Z
Z
Z
Z
Z
c
c
a
a
a
a
a
a
a
a
a
a
a
a
a
a
a
a
a
a
a
a
a
a
"}
(37,1,1) = {"
a
a
a
a
a
a
a
a
a
c
c
c
c
c
c
c
c
c
c
c
L
S
c
Z
Z
c
P
c
c
Z
Z
Z
Z
Z
c
c
c
a
a
a
a
a
a
a
a
a
a
a
a
a
a
a
a
a
a
a
a
a
a
a
"}
(38,1,1) = {"
a
a
a
a
a
a
a
a
c
c
c
c
c
c
c
c
c
c
c
c
f
Z
Z
m
c
c
Z
t
Z
Z
Z
Z
Z
c
c
c
J
a
a
a
a
a
a
a
a
a
a
a
a
a
a
a
a
a
a
a
a
a
a
a
"}
(39,1,1) = {"
a
a
a
a
a
a
a
a
c
c
c
c
c
c
c
c
c
c
c
b
Z
Z
Z
Z
c
c
Z
Z
Z
Z
Z
c
c
c
c
c
c
a
a
a
a
a
a
a
a
a
a
a
a
a
a
a
a
a
a
a
a
a
a
a
"}
(40,1,1) = {"
a
a
a
a
a
a
a
a
c
c
c
c
c
c
c
c
c
c
c
c
c
c
c
c
c
c
c
c
c
c
c
c
c
c
c
c
c
c
a
a
a
a
a
a
a
a
a
a
a
a
a
a
a
a
a
a
a
a
a
a
"}
(41,1,1) = {"
a
a
a
a
a
a
a
a
c
c
c
c
c
c
c
c
c
c
c
c
c
c
c
c
c
c
c
c
c
c
c
c
c
c
c
c
c
c
a
a
a
a
a
a
a
a
a
a
a
a
a
a
a
a
a
a
a
a
a
a
"}
(42,1,1) = {"
a
a
a
a
a
a
a
a
c
c
c
c
c
c
c
c
c
c
c
c
c
c
c
c
c
c
c
c
c
c
c
c
c
c
c
c
c
c
a
a
a
a
a
a
a
a
a
a
a
a
a
a
a
a
a
a
a
a
a
a
"}
(43,1,1) = {"
a
a
a
a
a
a
a
a
a
c
c
c
c
c
c
c
c
c
c
c
c
c
c
c
c
c
c
c
c
c
c
c
c
c
c
c
c
a
a
a
a
a
a
a
a
a
a
a
a
a
a
a
a
a
a
a
a
a
a
a
"}
(44,1,1) = {"
a
a
a
a
a
a
a
a
a
a
c
c
c
c
c
c
c
c
c
c
c
c
c
c
c
c
c
c
c
c
c
c
c
c
c
c
c
a
a
a
a
a
a
a
a
a
a
a
a
a
a
a
a
a
a
a
a
a
a
a
"}
(45,1,1) = {"
a
a
a
a
a
a
a
a
a
a
c
c
c
c
c
c
c
c
c
c
c
c
c
c
c
c
c
c
c
c
c
c
c
c
c
a
a
a
a
a
a
a
a
a
a
a
a
a
a
a
a
a
a
a
a
a
a
a
a
a
"}
(46,1,1) = {"
a
a
a
a
a
a
a
a
a
a
a
c
c
c
c
c
c
c
c
c
c
c
c
c
c
c
c
c
c
c
c
c
c
a
a
a
a
a
a
a
a
a
a
a
a
a
a
a
a
a
a
a
a
a
a
a
a
a
a
a
"}
(47,1,1) = {"
a
a
a
a
a
a
a
a
a
a
a
c
c
c
c
c
c
c
c
c
c
c
c
c
c
c
c
c
c
c
c
c
a
a
a
a
a
a
a
a
a
a
a
a
a
a
a
a
a
a
a
a
a
a
a
a
a
a
a
a
"}
(48,1,1) = {"
a
a
a
a
a
a
a
a
a
a
a
a
c
c
c
c
c
c
c
c
c
c
c
c
c
c
c
c
c
c
c
c
a
a
a
a
a
a
a
a
a
a
a
a
a
a
a
a
a
a
a
a
a
a
a
a
a
a
a
a
"}
(49,1,1) = {"
a
a
a
a
a
a
a
a
a
a
a
a
a
a
c
c
c
c
c
c
c
c
c
c
c
c
c
c
c
c
c
a
a
a
a
a
a
a
a
a
a
a
a
a
a
a
a
a
a
a
a
a
a
a
a
a
a
a
a
a
"}
(50,1,1) = {"
a
a
a
a
a
a
a
a
a
a
a
a
a
a
a
c
c
c
c
c
c
c
c
c
c
c
c
c
c
c
a
a
a
a
a
a
a
a
a
a
a
a
a
a
a
a
a
a
a
a
a
a
a
a
a
a
a
a
a
a
"}
(51,1,1) = {"
a
a
a
a
a
a
a
a
a
a
a
a
a
a
a
a
a
c
c
c
c
c
c
c
c
c
c
a
a
a
a
a
a
a
a
a
a
a
a
a
a
a
a
a
a
a
a
a
a
a
a
a
a
a
a
a
a
a
a
a
"}
(52,1,1) = {"
a
a
a
a
a
a
a
a
a
a
a
a
a
a
a
a
a
a
c
c
a
a
c
c
c
c
a
a
a
a
a
a
a
a
a
a
a
a
a
a
a
a
a
a
a
a
a
a
a
a
a
a
a
a
a
a
a
a
a
a
"}
(53,1,1) = {"
a
a
a
a
a
a
a
a
a
a
a
a
a
a
a
a
a
a
a
a
a
a
a
c
c
a
a
a
a
a
a
a
a
a
a
a
a
a
a
a
a
a
a
a
a
a
a
a
a
a
a
a
a
a
a
a
a
a
a
a
"}
(54,1,1) = {"
a
a
a
a
a
a
a
a
a
a
a
a
a
a
a
a
a
a
a
a
a
a
a
a
a
a
a
a
a
a
a
a
a
a
a
a
a
a
a
a
a
a
a
a
a
a
a
a
a
a
a
a
a
a
a
a
a
a
a
a
"}
(55,1,1) = {"
a
a
a
a
a
a
a
a
a
a
a
a
a
a
a
a
a
a
a
a
a
a
a
a
a
a
a
a
a
a
a
a
a
a
a
a
a
a
a
a
a
a
a
a
a
a
a
a
a
a
a
a
a
a
a
a
a
a
a
a
"}
(56,1,1) = {"
a
a
a
a
a
a
a
a
a
a
a
a
a
a
a
a
a
a
a
a
a
a
a
a
a
a
a
a
a
a
a
a
a
a
a
a
a
a
a
a
a
a
a
a
a
a
a
a
a
a
a
a
a
a
a
a
a
a
a
a
"}
(57,1,1) = {"
a
a
a
a
a
a
a
a
a
a
a
a
a
a
a
a
a
a
a
a
a
a
a
a
a
a
a
a
a
a
a
a
a
a
a
a
a
a
a
a
a
a
a
a
a
a
a
a
a
a
a
a
a
a
a
a
a
a
a
a
"}
(58,1,1) = {"
a
a
a
a
a
a
a
a
a
a
a
a
a
a
a
a
a
a
a
a
a
a
a
a
a
a
a
a
a
a
a
a
a
a
a
a
a
a
a
a
a
a
a
a
a
a
a
a
a
a
a
a
a
a
a
a
a
a
a
a
"}
(59,1,1) = {"
a
a
a
a
a
a
a
a
a
a
a
a
a
a
a
a
a
a
a
a
a
a
a
a
a
a
a
a
a
a
a
a
a
a
a
a
a
a
a
a
a
a
a
a
a
a
a
a
a
a
a
a
a
a
a
a
a
a
a
a
"}
(60,1,1) = {"
a
a
a
a
a
a
a
a
a
a
a
a
a
a
a
a
a
a
a
a
a
a
a
a
a
a
a
a
a
a
a
a
a
a
a
a
a
a
a
a
a
a
a
a
a
a
a
a
a
a
a
a
a
a
a
a
a
a
a
a
"}
