//MAP CONVERTED BY dmm2tgm.py THIS HEADER COMMENT PREVENTS RECONVERSION, DO NOT REMOVE
"a" = (
/turf/template_noop,
/area/template_noop)
"b" = (
/turf/simulated/mineral,
/area/submap/asteroid4)
"d" = (
/obj/random/outcrop,
/turf/simulated/mineral/floor/vacuum,
/area/submap/asteroid4)
"e" = (
/obj/structure/shuttle/window,
/turf/simulated/shuttle/plating,
/area/submap/asteroid4)
"g" = (
/turf/simulated/shuttle/plating,
/area/submap/asteroid4)
"h" = (
/obj/effect/landmark/mobcorpse/clown,
/turf/simulated/shuttle/floor,
/area/submap/asteroid4)
"i" = (
/turf/simulated/shuttle/wall,
/area/submap/asteroid4)
"j" = (
/obj/machinery/power/supply_beacon/supermatter,
/turf/simulated/shuttle/floor,
/area/submap/asteroid4)
"l" = (
/obj/structure/shuttle/engine/propulsion/burst,
/turf/simulated/shuttle/wall{
	icon_state = "swall_s5"
	},
/area/submap/asteroid4)
"m" = (
/turf/simulated/shuttle/floor,
/area/submap/asteroid4)
"n" = (
/obj/structure/shuttle/engine/propulsion/burst,
/turf/simulated/shuttle/wall{
	icon_state = "swall_s9"
	},
/area/submap/asteroid4)
"o" = (
/obj/structure/outcrop/coal,
/turf/simulated/mineral/floor/vacuum,
/area/submap/asteroid4)
"v" = (
/obj/structure/outcrop/diamond,
/turf/simulated/mineral/floor/vacuum,
/area/submap/asteroid4)
"D" = (
/turf/simulated/mineral/floor/vacuum,
/area/submap/asteroid4)

(1,1,1) = {"
a
a
a
a
a
a
a
a
a
a
a
a
a
a
a
a
a
a
a
a
"}
(2,1,1) = {"
a
a
a
d
D
b
b
a
a
a
a
a
a
a
a
a
b
b
a
a
"}
(3,1,1) = {"
a
a
b
D
D
b
d
D
a
a
a
a
a
a
b
b
b
b
a
a
"}
(4,1,1) = {"
a
a
b
v
o
b
D
D
D
a
a
a
b
b
b
b
b
a
a
b
"}
(5,1,1) = {"
a
a
b
b
b
b
b
o
D
a
a
a
a
a
b
b
b
a
a
a
"}
(6,1,1) = {"
a
a
a
b
b
b
b
b
v
D
a
a
a
a
a
a
a
a
b
a
"}
(7,1,1) = {"
a
a
a
b
v
b
b
b
D
D
a
a
a
a
a
a
a
a
a
a
"}
(8,1,1) = {"
a
a
a
b
b
b
b
b
o
v
a
a
a
a
a
a
a
a
a
a
"}
(9,1,1) = {"
a
a
a
a
b
b
b
b
b
b
a
a
a
a
o
D
D
a
a
a
"}
(10,1,1) = {"
a
a
a
a
b
b
b
b
a
a
a
a
a
b
b
D
v
a
a
a
"}
(11,1,1) = {"
a
a
a
a
a
b
v
o
a
a
a
a
b
b
b
b
b
b
a
a
"}
(12,1,1) = {"
a
a
a
a
a
a
a
a
a
a
a
a
b
b
i
i
i
i
l
a
"}
(13,1,1) = {"
a
a
a
a
a
a
a
a
a
a
a
d
D
e
g
h
j
m
m
a
"}
(14,1,1) = {"
a
a
a
a
a
a
a
a
a
a
a
o
v
b
i
i
i
i
n
a
"}
(15,1,1) = {"
a
a
a
a
a
a
a
a
b
b
b
b
b
b
b
b
b
b
a
a
"}
(16,1,1) = {"
a
a
a
a
a
b
b
b
b
b
b
b
a
a
o
d
b
a
a
a
"}
(17,1,1) = {"
a
a
a
a
b
b
b
b
b
a
a
a
a
a
a
a
a
a
a
a
"}
(18,1,1) = {"
a
a
a
a
a
a
b
a
a
a
a
a
a
a
a
a
a
a
a
a
"}
(19,1,1) = {"
a
a
a
a
a
a
a
a
a
a
a
a
a
a
a
a
a
a
a
a
"}
(20,1,1) = {"
a
a
a
a
a
a
a
a
a
a
a
a
a
a
a
a
a
a
a
a
"}
