//MAP CONVERTED BY dmm2tgm.py THIS HEADER COMMENT PREVENTS RECONVERSION, DO NOT REMOVE
"a" = (
/turf/template_noop,
/area/template_noop)
"b" = (
/obj/structure/loot_pile/surface/bones,
/obj/random/trash,
/turf/simulated/shuttle/floor/white,
/area/submap/clownmime)
"c" = (
/obj/structure/shuttle/engine/heater{
	dir = 1
	},
/obj/structure/window/reinforced,
/turf/simulated/shuttle/plating,
/area/submap/clownmime)
"e" = (
/obj/machinery/door/unpowered/shuttle,
/turf/simulated/shuttle/floor/white,
/area/submap/clownmime)
"f" = (
/obj/item/broken_bottle,
/obj/structure/loot_pile/surface/bones,
/turf/simulated/shuttle/floor/white,
/area/submap/clownmime)
"g" = (
/obj/item/material/shard{
	icon_state = "medium"
	},
/obj/structure/loot_pile/surface/bones,
/turf/simulated/shuttle/floor/white,
/area/submap/clownmime)
"j" = (
/obj/structure/closet/crate,
/obj/item/stack/material/supermatter,
/turf/simulated/shuttle/floor/white,
/area/submap/clownmime)
"m" = (
/turf/simulated/mineral,
/area/submap/clownmime)
"n" = (
/obj/random/outcrop,
/turf/simulated/mineral/floor/vacuum,
/area/submap/clownmime)
"p" = (
/obj/item/material/shard{
	icon_state = "medium"
	},
/turf/simulated/mineral/floor/vacuum,
/area/submap/clownmime)
"q" = (
/obj/structure/closet/crate,
/obj/item/stack/material/supermatter{
	amount = 5
	},
/turf/simulated/shuttle/floor,
/area/submap/clownmime)
"s" = (
/turf/simulated/mineral/floor/vacuum,
/area/submap/clownmime)
"v" = (
/turf/simulated/shuttle/wall,
/area/submap/clownmime)
"w" = (
/obj/random/snack,
/turf/simulated/shuttle/floor,
/area/submap/clownmime)
"y" = (
/obj/structure/closet/crate,
/obj/item/tool/wrench/fuelrod,
/obj/item/fuel_assembly/tritium,
/obj/item/fuel_assembly/tritium,
/obj/item/fuel_assembly/tritium,
/obj/item/fuel_assembly/tritium,
/turf/simulated/shuttle/floor/white,
/area/submap/clownmime)
"z" = (
/obj/structure/closet/crate,
/obj/item/grenade/supermatter,
/turf/simulated/shuttle/floor/white,
/area/submap/clownmime)
"A" = (
/obj/structure/shuttle/engine/heater{
	dir = 4
	},
/obj/structure/window/reinforced{
	dir = 8
	},
/turf/simulated/shuttle/plating,
/area/submap/clownmime)
"B" = (
/obj/structure/shuttle/engine/propulsion{
	dir = 4;
	icon_state = "propulsion_l"
	},
/obj/structure/shuttle/engine/propulsion{
	dir = 4;
	icon_state = "burst_r"
	},
/turf/simulated/shuttle/plating,
/area/submap/clownmime)
"D" = (
/obj/random/trash,
/turf/simulated/shuttle/floor,
/area/submap/clownmime)
"E" = (
/obj/structure/shuttle/engine/propulsion{
	dir = 4;
	icon_state = "propulsion_l"
	},
/turf/simulated/shuttle/plating,
/area/submap/clownmime)
"F" = (
/obj/item/material/shard{
	pixel_x = 9
	},
/obj/machinery/computer/ship{
	dir = 4
	},
/turf/simulated/shuttle/floor,
/area/submap/clownmime)
"G" = (
/obj/effect/landmark/mobcorpse/clown,
/turf/simulated/shuttle/floor,
/area/submap/clownmime)
"H" = (
/obj/structure/loot_pile/surface/bones,
/turf/simulated/shuttle/floor,
/area/submap/clownmime)
"I" = (
/obj/item/material/shard{
	icon_state = "medium"
	},
/obj/random/trash,
/turf/simulated/mineral/floor/vacuum,
/area/submap/clownmime)
"J" = (
/obj/structure/grille,
/obj/structure/window/reinforced,
/obj/structure/window/reinforced{
	dir = 8
	},
/obj/structure/window/reinforced{
	dir = 4
	},
/turf/simulated/shuttle/floor/white,
/area/submap/clownmime)
"K" = (
/obj/structure/loot_pile/surface/bones,
/turf/simulated/shuttle/floor/white,
/area/submap/clownmime)
"L" = (
/turf/simulated/shuttle/floor,
/area/submap/clownmime)
"O" = (
/turf/simulated/shuttle/floor/white,
/area/submap/clownmime)
"P" = (
/obj/item/pickaxe,
/turf/simulated/shuttle/floor/white,
/area/submap/clownmime)
"Q" = (
/obj/structure/closet/crate,
/obj/item/fuel_assembly/phoron,
/obj/item/fuel_assembly/phoron,
/obj/item/fuel_assembly/phoron,
/obj/item/fuel_assembly/phoron,
/obj/item/fuel_assembly/phoron,
/turf/simulated/shuttle/floor/white,
/area/submap/clownmime)
"R" = (
/obj/structure/shuttle/engine/propulsion{
	dir = 4;
	icon_state = "propulsion_l"
	},
/obj/structure/shuttle/engine/propulsion{
	dir = 4;
	icon_state = "propulsion_l"
	},
/turf/simulated/shuttle/plating,
/area/submap/clownmime)
"S" = (
/obj/item/material/shard{
	pixel_x = 9
	},
/turf/simulated/mineral/floor/vacuum,
/area/submap/clownmime)
"T" = (
/obj/structure/closet/crate,
/obj/item/fuel_assembly/deuterium,
/obj/item/fuel_assembly/deuterium,
/obj/item/fuel_assembly/deuterium,
/obj/item/fuel_assembly/deuterium,
/obj/item/fuel_assembly/deuterium,
/turf/simulated/shuttle/floor/white,
/area/submap/clownmime)
"U" = (
/obj/item/material/shard{
	icon_state = "medium"
	},
/obj/random/trash,
/turf/simulated/shuttle/floor/white,
/area/submap/clownmime)
"V" = (
/obj/structure/closet/crate,
/obj/item/stack/material/supermatter{
	amount = 5
	},
/turf/simulated/shuttle/floor/white,
/area/submap/clownmime)
"W" = (
/obj/structure/closet/crate,
/obj/item/gun/magnetic/fuelrod,
/obj/item/fuel_assembly/blitz/shielded,
/obj/item/fuel_assembly/blitz/shielded,
/obj/item/fuel_assembly/blitz/shielded,
/obj/item/fuel_assembly/blitz/shielded,
/turf/simulated/shuttle/floor/white,
/area/submap/clownmime)
"Y" = (
/obj/structure/closet/crate,
/obj/item/fuel_assembly/supermatter,
/obj/item/fuel_assembly/supermatter,
/turf/simulated/shuttle/floor/white,
/area/submap/clownmime)

(1,1,1) = {"
a
a
a
a
m
m
a
a
a
a
a
a
a
a
a
a
a
a
a
a
"}
(2,1,1) = {"
a
a
a
m
m
m
m
m
a
a
a
a
a
a
m
m
a
a
a
a
"}
(3,1,1) = {"
a
a
a
m
m
m
m
m
m
a
m
m
m
m
m
m
a
a
a
a
"}
(4,1,1) = {"
a
a
a
a
m
m
n
m
m
m
m
m
m
m
m
a
a
a
a
a
"}
(5,1,1) = {"
a
a
a
a
a
m
m
s
s
m
m
m
m
m
m
m
m
m
m
a
"}
(6,1,1) = {"
a
a
a
a
a
m
m
n
s
s
n
s
m
m
m
m
m
m
a
a
"}
(7,1,1) = {"
a
a
a
a
m
m
m
m
s
s
s
s
m
m
m
m
m
a
a
a
"}
(8,1,1) = {"
a
a
a
n
m
m
m
m
s
s
n
s
m
m
m
m
m
a
a
a
"}
(9,1,1) = {"
a
a
v
v
m
m
m
m
n
s
s
s
s
m
m
m
s
a
a
a
"}
(10,1,1) = {"
v
e
v
v
m
m
m
m
m
m
s
s
n
m
m
s
s
a
a
a
"}
(11,1,1) = {"
c
f
j
I
m
m
m
m
m
m
m
s
s
m
m
n
s
s
a
a
"}
(12,1,1) = {"
c
g
G
q
s
S
m
m
m
m
m
m
n
s
m
m
m
n
s
a
"}
(13,1,1) = {"
c
K
V
j
b
s
m
m
m
m
m
m
s
m
m
m
m
m
m
a
"}
(14,1,1) = {"
v
e
v
v
v
m
m
s
m
m
m
m
m
m
m
m
m
n
m
a
"}
(15,1,1) = {"
a
a
v
v
m
m
m
n
s
m
m
m
m
m
m
m
m
m
m
m
"}
(16,1,1) = {"
a
a
a
a
m
a
a
a
v
m
m
J
v
m
m
m
m
m
m
m
"}
(17,1,1) = {"
a
a
a
a
a
a
a
a
v
m
F
O
v
m
m
m
m
s
m
m
"}
(18,1,1) = {"
a
a
a
a
a
a
a
v
v
p
G
K
v
v
m
m
m
n
m
m
"}
(19,1,1) = {"
a
a
a
a
a
a
a
v
S
s
H
U
O
v
m
m
m
s
s
n
"}
(20,1,1) = {"
a
a
a
a
a
a
a
v
K
H
L
L
P
v
m
m
m
a
a
a
"}
(21,1,1) = {"
a
a
a
a
a
a
a
e
O
w
D
H
O
e
m
m
a
a
a
a
"}
(22,1,1) = {"
a
a
a
a
a
a
a
e
O
L
L
D
O
e
m
m
a
a
a
a
"}
(23,1,1) = {"
a
a
a
a
a
a
a
v
y
D
H
L
Q
v
m
a
a
a
a
a
"}
(24,1,1) = {"
a
a
a
a
a
a
a
v
T
L
L
L
W
v
m
a
a
a
a
a
"}
(25,1,1) = {"
a
a
a
a
a
a
a
v
z
G
H
D
Y
v
m
a
a
a
a
a
"}
(26,1,1) = {"
a
a
a
a
a
a
a
v
O
O
O
O
O
v
a
a
a
a
a
a
"}
(27,1,1) = {"
a
a
a
a
a
a
a
v
A
A
A
A
A
v
a
a
a
a
a
a
"}
(28,1,1) = {"
a
a
a
a
a
a
a
a
B
E
E
E
R
a
a
a
a
a
a
a
"}
