//MAP CONVERTED BY dmm2tgm.py THIS HEADER COMMENT PREVENTS RECONVERSION, DO NOT REMOVE
"a" = (
/turf/template_noop,
/area/template_noop)
"c" = (
/turf/simulated/floor/plating,
/area/submap/derelict3)
"d" = (
/obj/structure/lattice,
/turf/template_noop,
/area/submap/derelict3)
"g" = (
/obj/structure/salvageable/console_broken_os,
/turf/simulated/floor/tiled/asteroid_steel/airless,
/area/submap/derelict3)
"h" = (
/obj/structure/girder,
/turf/simulated/floor/plating,
/area/submap/derelict3)
"i" = (
/obj/random/maintenance/clean,
/turf/simulated/floor/tiled/asteroid_steel/airless,
/area/submap/derelict3)
"k" = (
/obj/structure/salvageable/server,
/turf/simulated/floor/tiled/asteroid_steel/airless,
/area/submap/derelict3)
"m" = (
/obj/item/stack/rods{
	amount = 5
	},
/turf/template_noop,
/area/submap/derelict3)
"w" = (
/obj/machinery/autolathe,
/turf/simulated/floor/tiled/asteroid_steel/airless,
/area/submap/derelict3)
"C" = (
/obj/random/maintenance/security,
/turf/simulated/floor/tiled/asteroid_steel/airless,
/area/submap/derelict3)
"E" = (
/turf/simulated/wall,
/area/submap/derelict3)
"F" = (
/obj/structure/girder/displaced,
/turf/simulated/floor/plating,
/area/submap/derelict3)
"J" = (
/obj/random/maintenance,
/turf/simulated/floor/tiled/asteroid_steel/airless,
/area/submap/derelict3)
"K" = (
/obj/structure/table,
/turf/simulated/floor/plating,
/area/submap/derelict3)
"L" = (
/obj/structure/girder/displaced,
/turf/simulated/floor/tiled/asteroid_steel/airless,
/area/submap/derelict3)
"Q" = (
/turf/simulated/floor/tiled/asteroid_steel/airless,
/area/submap/derelict3)
"U" = (
/obj/structure/table,
/obj/random/maintenance/medical,
/turf/simulated/floor/tiled/asteroid_steel/airless,
/area/submap/derelict3)
"W" = (
/obj/structure/salvageable/computer,
/turf/simulated/floor/tiled/asteroid_steel/airless,
/area/submap/derelict3)
"Y" = (
/obj/structure/table,
/turf/simulated/floor/tiled/asteroid_steel/airless,
/area/submap/derelict3)
"Z" = (
/obj/structure/salvageable/machine,
/turf/simulated/floor/tiled/asteroid_steel/airless,
/area/submap/derelict3)

(1,1,1) = {"
a
a
a
a
a
a
a
a
a
a
a
a
a
a
a
a
a
a
a
a
a
a
a
a
a
a
a
a
a
a
a
a
a
a
a
a
a
a
a
a
"}
(2,1,1) = {"
a
a
a
a
a
a
a
a
a
a
a
a
a
a
a
a
a
a
a
a
a
a
a
a
a
a
a
a
a
a
a
a
a
a
a
a
a
a
a
a
"}
(3,1,1) = {"
a
a
a
a
a
a
a
a
a
a
a
a
a
a
a
a
a
a
a
a
a
a
a
a
a
a
a
a
a
E
E
F
h
E
a
a
a
a
a
a
"}
(4,1,1) = {"
a
a
a
a
a
a
a
a
a
a
a
a
a
a
a
a
a
a
a
a
a
a
a
a
a
a
a
a
c
c
K
Q
J
Q
E
a
a
a
a
a
"}
(5,1,1) = {"
a
a
a
a
a
a
a
a
a
a
a
a
a
a
a
a
a
a
a
a
a
a
a
a
a
a
a
a
Q
c
Q
i
Q
Q
Z
E
a
a
a
a
"}
(6,1,1) = {"
a
a
a
a
a
a
a
a
a
a
a
a
a
a
a
a
a
a
a
a
a
a
a
a
a
a
a
a
a
d
Q
Q
c
Q
k
E
a
a
a
a
"}
(7,1,1) = {"
a
a
a
a
a
a
a
a
a
a
a
a
a
a
a
a
a
a
a
a
a
a
a
a
a
a
a
a
m
d
d
d
Q
Q
k
E
a
a
a
a
"}
(8,1,1) = {"
a
a
a
a
a
a
a
a
a
a
a
a
a
a
a
a
a
a
a
a
a
a
a
a
a
a
a
a
a
d
d
d
c
Q
Q
E
a
a
a
a
"}
(9,1,1) = {"
a
a
a
a
a
a
a
a
a
a
a
a
a
a
a
a
a
a
a
a
a
a
a
a
a
a
a
a
a
a
d
d
d
c
Q
F
a
a
a
a
"}
(10,1,1) = {"
a
a
a
a
a
a
a
a
a
a
a
a
a
a
a
a
a
a
a
a
a
a
a
a
a
a
a
a
a
a
d
d
d
c
c
a
a
a
a
a
"}
(11,1,1) = {"
a
a
a
a
a
a
a
a
a
a
a
a
a
a
a
a
a
a
a
a
a
a
a
a
a
a
a
a
m
d
d
a
d
d
h
a
a
a
a
a
"}
(12,1,1) = {"
a
a
a
a
a
a
a
a
a
a
a
a
a
a
a
a
a
a
a
a
a
a
a
a
a
a
a
a
a
a
a
m
a
a
a
a
a
a
a
a
"}
(13,1,1) = {"
a
a
a
a
a
a
a
a
a
a
a
a
a
a
a
a
a
a
a
a
a
a
a
m
a
a
d
d
a
a
a
a
a
a
a
a
a
a
a
a
"}
(14,1,1) = {"
a
a
a
a
a
a
a
a
a
a
a
a
a
a
a
a
a
a
a
a
a
a
a
d
d
d
d
m
a
a
a
a
a
a
a
a
a
a
a
a
"}
(15,1,1) = {"
a
a
a
a
a
a
a
a
a
a
a
a
a
a
a
a
a
a
a
a
a
d
d
d
d
d
a
a
a
a
a
a
a
a
a
a
a
a
a
a
"}
(16,1,1) = {"
a
a
a
a
a
a
a
a
a
a
a
a
a
a
a
a
a
a
a
Q
Q
Q
Q
d
d
d
a
a
a
a
a
a
a
a
a
a
a
a
a
a
"}
(17,1,1) = {"
a
a
a
a
a
a
a
a
a
a
a
a
a
a
a
a
d
d
Q
c
E
Q
c
Q
d
a
a
a
a
a
a
a
a
a
a
a
a
a
a
a
"}
(18,1,1) = {"
a
a
a
a
a
a
a
a
a
a
a
a
a
a
m
d
d
Q
Q
Q
E
Q
c
J
d
a
a
a
a
a
a
a
a
a
a
a
a
a
a
a
"}
(19,1,1) = {"
a
a
a
a
a
a
a
a
a
a
a
m
a
a
d
d
Q
Q
Q
U
E
g
Q
Q
d
a
a
a
a
a
a
a
a
a
a
a
a
a
a
a
"}
(20,1,1) = {"
a
a
a
a
a
a
a
a
a
a
a
a
d
d
Q
d
Q
E
E
E
F
E
Q
Q
d
a
a
a
a
a
a
a
a
a
a
a
a
a
a
a
"}
(21,1,1) = {"
a
a
a
a
a
a
a
a
a
d
d
d
d
d
d
d
Q
c
Q
h
Q
Q
c
Q
d
a
a
a
a
a
a
a
a
a
a
a
a
a
a
a
"}
(22,1,1) = {"
a
a
a
a
a
a
a
a
a
Q
Q
Q
d
d
d
d
Q
h
i
Q
Q
Q
d
d
d
a
a
a
a
a
a
a
a
a
a
a
a
a
a
a
"}
(23,1,1) = {"
a
a
a
a
a
a
a
F
Q
i
Q
Q
Q
d
d
d
J
Q
Q
Q
d
d
d
d
d
m
a
a
a
a
a
a
a
a
a
a
a
a
a
a
"}
(24,1,1) = {"
a
a
a
a
a
m
c
Q
Q
Q
E
Y
Q
d
d
d
d
Q
Q
Q
d
d
Q
d
a
a
a
a
a
a
a
a
a
a
a
a
a
a
a
a
"}
(25,1,1) = {"
a
a
a
a
a
a
F
Q
Q
h
J
Q
Q
Q
d
d
d
d
d
d
d
d
d
d
m
a
a
a
a
a
a
a
a
a
a
a
a
a
a
a
"}
(26,1,1) = {"
a
a
a
a
a
a
c
Q
c
E
E
E
Q
Q
d
d
Q
d
d
d
d
d
d
d
d
a
a
a
a
a
a
a
a
a
a
a
a
a
a
a
"}
(27,1,1) = {"
a
a
a
a
a
a
c
Q
Q
E
w
Q
Q
Q
d
d
d
d
d
Q
Q
Q
Q
Q
d
d
a
a
a
a
a
a
a
a
a
a
a
a
a
a
"}
(28,1,1) = {"
a
a
a
a
a
a
a
Q
Q
Q
E
E
Q
d
d
d
d
Q
C
Q
c
c
Q
Q
Q
d
a
a
a
a
a
a
a
a
a
a
a
a
a
a
"}
(29,1,1) = {"
a
a
a
a
a
a
a
c
Q
Q
Q
Q
Q
d
d
d
d
Q
Q
c
c
Q
Q
Q
F
m
a
a
a
a
a
a
a
a
a
a
a
a
a
a
"}
(30,1,1) = {"
a
a
a
a
m
a
m
a
a
c
Q
Q
Q
d
d
d
Q
Q
Q
J
W
E
Q
Q
Q
Q
a
a
a
a
a
a
a
a
a
a
a
a
a
a
"}
(31,1,1) = {"
a
a
a
a
a
a
a
a
a
d
d
d
d
d
d
d
Q
L
Q
Q
E
E
E
E
h
h
a
a
a
a
a
a
a
a
a
a
a
a
a
a
"}
(32,1,1) = {"
a
a
a
a
a
a
a
a
a
a
a
d
d
Q
d
d
Q
Q
E
E
Q
h
Q
h
Q
a
a
a
a
a
a
a
a
a
a
a
a
a
a
a
"}
(33,1,1) = {"
a
a
a
a
a
a
a
a
a
a
m
a
d
d
d
d
Q
Q
Q
Q
Q
E
Q
Q
a
m
a
a
a
a
a
a
a
a
a
a
a
a
a
a
"}
(34,1,1) = {"
a
a
a
a
a
a
a
a
a
a
a
a
a
d
d
d
d
d
h
c
h
Q
a
a
a
a
a
a
a
a
a
a
a
a
a
a
a
a
a
a
"}
(35,1,1) = {"
a
a
a
a
a
a
a
a
a
a
a
a
a
a
a
m
a
a
a
a
a
m
a
a
a
a
a
a
a
a
a
a
a
a
a
a
a
a
a
a
"}
(36,1,1) = {"
a
a
a
a
a
a
a
a
a
a
a
a
a
a
a
a
a
a
a
a
a
a
a
a
a
a
a
a
a
a
a
a
a
a
a
a
a
a
a
a
"}
(37,1,1) = {"
a
a
a
a
a
a
a
a
a
a
a
a
a
a
a
a
a
a
a
a
a
a
a
a
a
a
a
a
a
a
a
a
a
a
a
a
a
a
a
a
"}
(38,1,1) = {"
a
a
a
a
a
a
a
a
a
a
a
a
a
a
a
a
a
a
a
a
a
a
a
a
a
a
a
a
a
a
a
a
a
a
a
a
a
a
a
a
"}
(39,1,1) = {"
a
a
a
a
a
a
a
a
a
a
a
a
a
a
a
a
a
a
a
a
a
a
a
a
a
a
a
a
a
a
a
a
a
a
a
a
a
a
a
a
"}
(40,1,1) = {"
a
a
a
a
a
a
a
a
a
a
a
a
a
a
a
a
a
a
a
a
a
a
a
a
a
a
a
a
a
a
a
a
a
a
a
a
a
a
a
a
"}
