//MAP CONVERTED BY dmm2tgm.py THIS HEADER COMMENT PREVENTS RECONVERSION, DO NOT REMOVE
"a" = (
/turf/template_noop,
/area/template_noop)
"c" = (
/turf/simulated/mineral,
/area/submap/derelict5)
"e" = (
/turf/simulated/wall,
/area/submap/derelict5)
"f" = (
/obj/effect/floor_decal/rust,
/turf/simulated/wall,
/area/submap/derelict5)
"h" = (
/obj/structure/closet/crate,
/turf/simulated/floor/plating,
/area/submap/derelict5)
"i" = (
/obj/effect/landmark/loot_spawn/low,
/turf/simulated/shuttle/plating,
/area/submap/derelict5)
"j" = (
/obj/structure/door_assembly,
/turf/simulated/floor/plating,
/area/submap/derelict5)
"k" = (
/obj/structure/table,
/obj/item/storage/toolbox/electrical,
/turf/simulated/floor/plating,
/area/submap/derelict5)
"l" = (
/obj/effect/decal/remains/human,
/turf/simulated/floor/plating,
/area/submap/derelict5)
"m" = (
/obj/structure/table,
/obj/item/storage/toolbox/syndicate,
/turf/simulated/floor/plating,
/area/submap/derelict5)
"n" = (
/obj/structure/table,
/turf/simulated/floor/plating,
/area/submap/derelict5)
"o" = (
/obj/random/obstruction,
/turf/simulated/floor/plating,
/area/submap/derelict5)
"p" = (
/obj/machinery/door/airlock/external,
/obj/random/obstruction,
/turf/simulated/floor/tiled/asteroid_steel/airless,
/area/submap/derelict5)
"q" = (
/obj/machinery/door/airlock/external,
/turf/simulated/floor/plating,
/area/submap/derelict5)
"r" = (
/turf/simulated/mineral/floor/vacuum,
/area/submap/derelict5)
"s" = (
/obj/random/trash,
/turf/simulated/floor/plating,
/area/submap/derelict5)
"t" = (
/obj/random/maintenance/engineering,
/turf/simulated/floor/plating,
/area/submap/derelict5)
"u" = (
/turf/simulated/floor/plating,
/area/submap/derelict5)
"w" = (
/obj/random/maintenance/research,
/turf/simulated/shuttle/plating,
/area/submap/derelict5)
"y" = (
/obj/random/junk,
/turf/simulated/shuttle/plating,
/area/submap/derelict5)
"z" = (
/obj/effect/landmark/loot_spawn/low,
/turf/simulated/floor/plating,
/area/submap/derelict5)
"A" = (
/obj/effect/landmark/loot_spawn/low,
/turf/simulated/floor/tiled/asteroid_steel/airless,
/area/submap/derelict5)
"C" = (
/obj/random/junk,
/turf/simulated/floor/plating,
/area/submap/derelict5)
"D" = (
/obj/item/stack/rods{
	amount = 5
	},
/turf/simulated/floor/plating,
/area/submap/derelict5)
"H" = (
/obj/effect/landmark/loot_spawn,
/turf/simulated/floor/plating,
/area/submap/derelict5)
"I" = (
/turf/simulated/shuttle/plating,
/area/submap/derelict5)
"L" = (
/obj/random/maintenance/engineering,
/turf/simulated/shuttle/plating,
/area/submap/derelict5)
"N" = (
/obj/random/trash,
/turf/simulated/shuttle/plating,
/area/submap/derelict5)
"O" = (
/obj/effect/landmark/loot_spawn,
/turf/simulated/shuttle/plating,
/area/submap/derelict5)
"R" = (
/turf/simulated/floor/tiled/asteroid_steel/airless,
/area/submap/derelict5)
"T" = (
/obj/random/maintenance/research,
/turf/simulated/floor/plating,
/area/submap/derelict5)
"V" = (
/obj/random/junk,
/turf/simulated/floor/tiled/asteroid_steel/airless,
/area/submap/derelict5)
"W" = (
/obj/random/trash,
/obj/random/junk,
/turf/simulated/floor/tiled/asteroid_steel/airless,
/area/submap/derelict5)
"X" = (
/obj/item/stack/rods{
	amount = 5
	},
/turf/simulated/mineral/floor/vacuum,
/area/submap/derelict5)
"Z" = (
/obj/random/outcrop,
/turf/simulated/mineral/floor/vacuum,
/area/submap/derelict5)

(1,1,1) = {"
a
a
a
a
a
a
a
a
a
a
a
a
a
a
a
a
a
a
a
a
a
a
a
a
a
a
a
a
a
a
a
a
a
a
a
a
a
a
a
a
"}
(2,1,1) = {"
a
a
a
a
a
a
a
a
a
a
a
a
a
a
a
a
a
a
a
a
a
a
a
a
a
a
a
a
a
a
a
a
a
c
c
c
a
a
a
a
"}
(3,1,1) = {"
a
a
a
a
a
a
a
a
a
a
a
a
a
a
a
a
a
a
a
a
a
a
a
a
a
a
a
a
a
a
a
a
a
c
c
c
a
a
a
a
"}
(4,1,1) = {"
a
a
a
a
a
a
a
a
a
a
a
a
a
a
a
a
a
a
a
a
c
a
a
a
a
a
a
a
a
a
a
a
a
a
a
c
a
a
a
c
"}
(5,1,1) = {"
a
a
a
a
a
a
a
a
a
a
a
a
a
a
a
a
a
a
a
a
a
a
a
a
a
a
a
a
a
a
a
a
a
a
a
a
a
a
a
a
"}
(6,1,1) = {"
a
a
a
a
a
a
a
a
a
a
a
r
r
r
r
a
a
a
a
a
a
a
a
a
c
a
a
a
a
a
a
a
a
a
a
a
a
a
c
a
"}
(7,1,1) = {"
a
a
a
a
a
a
a
a
a
r
Z
r
r
r
r
a
a
a
a
a
a
a
a
a
a
a
a
a
a
a
a
a
a
a
a
a
a
a
a
a
"}
(8,1,1) = {"
a
a
a
a
a
a
a
a
c
c
c
c
c
r
r
r
r
a
a
a
a
a
a
a
a
a
c
c
c
a
a
a
a
a
a
a
a
a
a
a
"}
(9,1,1) = {"
a
a
a
a
a
a
a
c
c
c
c
c
c
Z
r
r
r
r
r
r
a
a
a
a
a
a
c
c
c
a
a
a
a
a
a
a
a
a
a
a
"}
(10,1,1) = {"
a
a
a
a
a
a
a
c
c
c
c
c
c
c
c
c
r
r
r
r
r
a
a
a
a
a
a
c
c
c
c
a
a
a
a
a
a
a
a
a
"}
(11,1,1) = {"
a
a
a
a
a
a
a
c
c
c
c
c
c
c
c
c
c
c
c
r
r
a
a
a
a
a
a
c
c
c
c
a
a
a
a
a
a
a
a
a
"}
(12,1,1) = {"
a
a
a
a
a
a
c
c
c
r
Z
c
c
c
c
c
c
c
c
Z
r
r
r
a
a
a
a
a
a
a
a
a
a
a
a
a
a
a
a
a
"}
(13,1,1) = {"
a
a
a
a
a
a
c
c
c
Z
r
Z
c
c
c
c
c
c
c
c
r
r
r
a
a
a
a
a
a
a
a
a
a
a
a
a
a
a
a
a
"}
(14,1,1) = {"
a
a
a
a
a
a
c
c
c
c
c
c
c
c
c
c
c
c
c
c
Z
r
r
r
r
a
a
a
a
a
a
a
a
a
a
a
a
a
a
a
"}
(15,1,1) = {"
a
a
a
a
a
a
c
c
c
c
c
c
c
f
f
e
f
e
e
e
c
c
r
r
r
a
a
a
a
a
a
a
a
a
a
a
a
a
a
a
"}
(16,1,1) = {"
a
a
a
a
a
a
c
c
c
c
c
c
i
O
z
l
H
f
C
u
c
c
r
r
r
a
a
a
a
a
a
a
a
a
a
a
a
a
a
a
"}
(17,1,1) = {"
a
a
a
a
a
a
a
a
c
c
c
e
I
L
C
w
h
f
I
L
e
c
r
r
r
a
a
a
a
a
a
a
a
a
a
a
a
a
a
a
"}
(18,1,1) = {"
a
a
a
a
a
a
a
a
c
c
c
e
z
s
k
m
u
e
I
N
c
c
Z
r
r
r
a
a
a
a
a
a
c
c
c
a
a
a
a
a
"}
(19,1,1) = {"
a
a
a
a
a
a
a
a
c
c
c
f
e
j
f
f
e
e
R
I
e
c
c
c
r
r
r
r
r
a
a
a
c
c
c
c
c
a
a
a
"}
(20,1,1) = {"
a
a
a
a
a
a
a
a
a
c
c
c
i
I
O
h
l
e
u
I
f
c
c
c
r
r
r
r
r
r
r
r
r
Z
c
c
c
a
a
a
"}
(21,1,1) = {"
a
a
a
a
a
a
a
a
a
c
c
c
y
I
t
s
u
e
I
W
f
c
c
c
r
r
r
r
r
r
r
r
r
r
c
c
c
c
c
a
"}
(22,1,1) = {"
a
a
a
a
a
a
a
a
a
c
c
e
s
T
y
I
I
j
D
u
e
c
c
c
r
X
r
r
r
r
r
r
r
r
r
Z
c
c
c
a
"}
(23,1,1) = {"
a
a
a
a
a
a
a
a
a
a
c
e
h
h
z
n
s
e
T
V
e
e
e
c
r
r
r
r
r
r
r
r
r
r
r
r
c
c
c
c
"}
(24,1,1) = {"
a
a
a
a
a
a
a
a
a
a
c
c
f
f
j
f
I
e
A
o
p
o
q
X
r
r
r
r
r
Z
r
r
r
r
r
r
c
c
c
c
"}
(25,1,1) = {"
a
a
a
a
a
a
a
a
a
a
a
c
i
h
I
f
H
e
e
c
e
e
e
c
r
r
r
r
r
r
r
r
Z
r
r
r
c
c
c
c
"}
(26,1,1) = {"
a
a
a
c
a
a
a
a
a
a
a
c
c
e
f
e
c
c
c
c
c
c
c
c
Z
r
r
X
r
r
r
r
r
r
r
r
r
c
c
c
"}
(27,1,1) = {"
a
a
a
a
a
a
a
a
a
a
a
c
c
c
c
c
c
c
c
c
c
c
c
c
c
c
c
r
r
r
r
r
r
r
r
r
r
Z
c
c
"}
(28,1,1) = {"
a
a
a
a
a
a
a
a
a
a
a
c
c
c
c
c
c
c
c
c
c
c
c
c
c
c
c
c
r
r
r
r
r
r
r
r
r
r
c
c
"}
(29,1,1) = {"
a
a
a
a
a
a
a
a
a
a
a
c
c
c
c
c
c
c
c
c
c
c
c
c
c
c
c
c
r
r
r
r
r
r
r
r
r
r
c
c
"}
(30,1,1) = {"
a
a
a
a
a
a
a
a
a
a
a
c
c
c
c
c
c
Z
r
r
Z
c
c
c
c
c
c
r
r
r
r
Z
r
r
r
r
r
r
c
c
"}
(31,1,1) = {"
a
a
a
c
c
a
a
a
a
a
a
a
c
c
c
c
c
r
r
r
r
r
Z
c
c
c
c
Z
r
r
r
r
r
r
r
r
c
c
c
c
"}
(32,1,1) = {"
a
a
c
c
c
a
a
a
a
a
a
a
c
c
c
c
c
c
Z
r
r
c
c
c
c
c
c
c
r
r
r
r
r
r
r
Z
c
c
c
a
"}
(33,1,1) = {"
a
a
c
c
c
c
a
a
a
a
a
a
a
a
c
c
c
c
c
c
c
c
c
c
c
c
c
c
Z
r
r
r
r
r
c
c
c
c
c
a
"}
(34,1,1) = {"
a
a
a
c
c
c
a
a
a
a
a
a
a
a
c
c
c
c
c
c
c
c
c
c
c
c
c
c
c
c
c
c
r
Z
c
c
c
c
c
a
"}
(35,1,1) = {"
a
a
c
a
a
a
a
a
a
c
a
a
a
a
a
a
c
c
c
c
c
c
c
c
c
c
c
c
c
c
c
c
c
c
c
c
c
c
a
a
"}
(36,1,1) = {"
a
a
c
a
a
a
a
a
a
a
a
a
a
a
a
a
c
c
c
c
c
c
c
c
c
c
c
c
c
c
c
c
c
c
c
c
c
c
a
a
"}
(37,1,1) = {"
a
a
a
a
a
a
c
a
a
a
a
a
a
a
a
a
a
a
a
a
a
c
c
c
c
c
c
c
c
c
c
c
c
c
c
c
c
c
a
a
"}
(38,1,1) = {"
a
a
a
a
a
a
a
a
a
a
a
a
a
a
a
a
a
a
a
a
a
a
a
a
a
a
a
a
c
c
c
c
c
c
c
a
a
a
a
a
"}
(39,1,1) = {"
a
a
a
a
a
a
a
a
a
a
a
a
a
a
a
a
a
a
a
a
a
a
a
a
a
a
a
a
a
a
a
a
a
a
a
a
a
a
a
a
"}
(40,1,1) = {"
a
a
a
a
a
a
a
a
a
a
a
a
a
a
a
a
a
a
a
a
a
a
a
a
a
a
a
a
a
a
a
a
a
a
a
a
a
a
a
a
"}
