//MAP CONVERTED BY dmm2tgm.py THIS HEADER COMMENT PREVENTS RECONVERSION, DO NOT REMOVE
"a" = (
/turf/template_noop,
/area/template_noop)
"b" = (
/turf/simulated/mineral,
/area/submap/derelict4)
"d" = (
/turf/simulated/mineral/floor/vacuum,
/area/submap/derelict4)
"e" = (
/turf/simulated/shuttle/wall,
/area/submap/derelict4)
"f" = (
/obj/machinery/door/airlock/maintenance/rnd,
/turf/simulated/floor/airless,
/area/submap/derelict4)
"g" = (
/turf/simulated/floor/airless,
/area/submap/derelict4)
"h" = (
/obj/random/trash,
/turf/simulated/shuttle/floor,
/area/submap/derelict4)
"i" = (
/obj/structure/window/reinforced{
	dir = 8
	},
/obj/structure/bed/chair/bay/comfy/lime,
/turf/simulated/shuttle/floor,
/area/submap/derelict4)
"j" = (
/obj/structure/bed/chair/bay/comfy/lime,
/turf/simulated/shuttle/floor,
/area/submap/derelict4)
"k" = (
/obj/random/maintenance,
/turf/simulated/shuttle/floor,
/area/submap/derelict4)
"l" = (
/obj/structure/shuttle/engine/propulsion{
	dir = 4
	},
/turf/simulated/shuttle/plating,
/area/submap/derelict4)
"m" = (
/obj/item/material/shard,
/turf/simulated/floor/airless,
/area/submap/derelict4)
"n" = (
/obj/structure/bed/chair/bay/comfy/captain{
	dir = 8
	},
/turf/simulated/floor/airless,
/area/submap/derelict4)
"o" = (
/obj/structure/grille,
/turf/simulated/shuttle/floor,
/area/submap/derelict4)
"p" = (
/obj/structure/table,
/turf/simulated/shuttle/floor,
/area/submap/derelict4)
"q" = (
/obj/item/material/shard,
/obj/structure/bed/chair/bay/comfy/captain{
	dir = 8
	},
/turf/simulated/shuttle/floor,
/area/submap/derelict4)
"r" = (
/obj/structure/window/reinforced{
	dir = 8
	},
/obj/structure/bed/chair/bay/comfy/lime{
	dir = 1
	},
/turf/simulated/shuttle/floor,
/area/submap/derelict4)
"s" = (
/obj/structure/bed/chair/bay/comfy/lime{
	dir = 1
	},
/turf/simulated/floor/airless,
/area/submap/derelict4)
"t" = (
/obj/structure/girder,
/turf/simulated/floor/airless,
/area/submap/derelict4)
"w" = (
/obj/random/maintenance,
/turf/simulated/mineral/floor/vacuum,
/area/submap/derelict4)
"x" = (
/obj/item/stack/rods{
	amount = 5
	},
/turf/simulated/mineral/floor/vacuum,
/area/submap/derelict4)
"z" = (
/turf/simulated/shuttle/floor,
/area/submap/derelict4)
"G" = (
/obj/random/outcrop,
/turf/simulated/mineral/floor/vacuum,
/area/submap/derelict4)
"S" = (
/obj/random/junk,
/turf/simulated/shuttle/floor,
/area/submap/derelict4)
"U" = (
/obj/random/trash,
/turf/simulated/mineral/floor/vacuum,
/area/submap/derelict4)
"V" = (
/obj/random/maintenance,
/turf/simulated/floor/airless,
/area/submap/derelict4)
"W" = (
/obj/random/junk,
/turf/simulated/floor/airless,
/area/submap/derelict4)
"X" = (
/obj/item/storage/backpack/holding,
/turf/simulated/shuttle/floor,
/area/submap/derelict4)
"Z" = (
/obj/structure/prop/blackbox/quarantined_shuttle,
/turf/simulated/floor/airless,
/area/submap/derelict4)

(1,1,1) = {"
a
a
a
a
a
a
a
a
a
a
a
a
a
a
a
a
a
a
a
a
a
a
a
a
a
a
a
a
a
a
a
a
a
a
a
a
a
a
a
a
"}
(2,1,1) = {"
a
a
a
a
a
a
a
a
a
a
a
a
a
a
a
a
a
a
a
a
a
a
a
a
a
a
a
a
a
a
a
a
a
a
a
a
a
a
a
a
"}
(3,1,1) = {"
a
a
a
a
a
a
a
a
a
a
a
a
a
a
a
a
a
a
a
a
a
a
a
a
a
a
a
a
a
a
a
a
a
a
a
a
a
a
a
a
"}
(4,1,1) = {"
a
a
a
a
a
a
a
a
a
a
a
a
a
a
a
a
a
a
a
a
a
a
a
a
a
a
b
a
a
a
a
a
a
a
a
a
a
a
a
a
"}
(5,1,1) = {"
a
a
a
a
a
a
a
a
a
a
a
a
a
a
a
a
a
a
a
a
a
a
a
a
a
a
a
a
a
b
b
a
a
a
a
a
a
a
a
a
"}
(6,1,1) = {"
a
a
a
a
a
a
a
d
d
a
a
a
a
a
a
a
a
a
a
a
a
a
a
a
a
a
a
a
b
b
b
a
a
a
a
a
a
a
a
a
"}
(7,1,1) = {"
a
a
a
a
a
a
b
d
d
d
a
a
a
a
a
a
a
a
a
a
a
a
a
a
b
a
a
a
b
b
a
a
a
a
a
a
a
a
a
a
"}
(8,1,1) = {"
a
a
a
a
a
b
b
G
d
d
a
a
a
a
a
a
a
a
a
a
a
a
a
a
a
a
a
a
a
a
a
a
a
a
a
a
a
a
a
a
"}
(9,1,1) = {"
a
a
a
a
a
b
b
b
b
b
a
a
a
a
a
a
G
d
a
a
a
a
a
a
a
a
a
a
a
a
a
a
a
a
a
a
a
a
a
a
"}
(10,1,1) = {"
a
a
a
a
a
b
b
b
b
b
a
a
a
a
a
a
d
d
d
d
d
d
d
a
a
a
a
a
a
a
a
a
a
a
a
a
a
a
a
a
"}
(11,1,1) = {"
a
a
a
a
a
a
a
b
b
a
a
a
a
a
a
a
d
d
d
d
d
d
d
b
b
b
a
a
a
a
a
a
a
a
a
a
a
a
a
a
"}
(12,1,1) = {"
a
a
a
a
a
a
a
b
b
a
a
a
a
a
b
G
d
d
d
d
d
d
d
d
b
b
a
a
a
a
a
a
a
a
a
a
a
a
a
a
"}
(13,1,1) = {"
a
a
a
a
a
a
a
a
a
a
a
a
a
a
b
b
b
d
d
d
d
d
d
G
b
b
b
a
a
a
a
a
a
a
a
a
a
a
a
a
"}
(14,1,1) = {"
a
a
a
a
a
a
a
a
a
a
a
a
a
b
b
b
b
b
b
d
d
b
b
b
b
b
b
b
a
a
a
a
a
a
a
a
a
a
a
a
"}
(15,1,1) = {"
a
a
a
a
a
a
a
a
a
a
a
a
a
b
b
b
b
G
d
b
b
b
b
b
b
b
b
d
a
a
a
a
a
a
a
b
b
b
a
a
"}
(16,1,1) = {"
a
a
a
a
a
a
a
a
a
a
a
a
a
d
d
b
b
d
d
b
b
b
d
b
b
b
b
b
a
a
a
a
a
a
a
a
b
b
b
a
"}
(17,1,1) = {"
a
a
a
a
a
a
a
a
a
a
a
a
a
d
G
b
b
b
b
b
b
b
b
b
b
b
b
b
b
a
a
a
a
a
a
b
b
b
b
b
"}
(18,1,1) = {"
a
a
a
a
a
a
a
a
a
a
a
a
a
d
d
d
b
b
b
g
g
o
b
b
d
b
b
d
d
a
a
a
a
a
d
b
b
b
d
d
"}
(19,1,1) = {"
a
a
a
a
a
a
a
a
a
a
a
a
a
d
d
b
b
d
e
Z
m
p
g
e
d
b
b
d
G
a
a
a
a
d
d
b
b
G
d
d
"}
(20,1,1) = {"
a
a
a
a
a
a
a
a
a
a
a
a
a
d
b
b
b
d
e
V
n
q
z
e
d
b
b
d
d
a
a
a
G
b
b
b
d
d
d
a
"}
(21,1,1) = {"
a
a
a
a
a
a
a
a
a
a
a
a
a
b
b
b
b
d
e
W
z
S
k
e
d
w
b
b
b
a
a
a
b
b
b
b
d
d
d
a
"}
(22,1,1) = {"
a
a
a
a
a
a
a
a
a
a
a
a
a
b
b
b
d
x
e
h
z
X
z
e
d
d
d
G
b
a
a
d
b
b
G
d
d
d
d
a
"}
(23,1,1) = {"
a
a
a
a
a
a
a
a
a
a
a
a
a
a
b
b
d
d
f
z
z
S
z
f
x
d
d
d
b
a
b
b
b
b
d
d
d
a
a
a
"}
(24,1,1) = {"
a
a
a
a
a
a
a
a
a
a
a
a
a
a
b
b
b
d
e
i
z
z
r
e
U
d
d
d
a
a
b
b
b
d
d
d
a
a
a
a
"}
(25,1,1) = {"
a
a
a
a
a
a
a
a
a
a
a
b
a
a
b
b
b
d
e
j
z
h
s
t
d
x
d
d
a
a
b
b
d
a
a
a
a
a
a
a
"}
(26,1,1) = {"
a
a
a
a
a
a
a
a
a
a
a
a
a
b
b
b
d
w
e
k
S
g
g
g
x
d
a
a
a
a
a
b
d
a
a
a
a
a
a
a
"}
(27,1,1) = {"
a
a
a
a
a
a
a
a
b
b
a
a
a
b
b
b
d
x
e
e
e
e
e
e
d
d
a
a
a
a
a
a
a
a
a
a
a
a
a
a
"}
(28,1,1) = {"
a
a
a
a
a
a
a
b
b
b
a
a
a
b
b
b
d
d
e
l
l
l
l
e
d
d
a
a
a
a
a
a
a
a
a
a
a
a
a
a
"}
(29,1,1) = {"
a
a
a
a
a
a
a
a
b
b
a
a
a
b
b
b
b
b
d
d
d
d
d
d
x
d
a
a
a
a
a
a
a
a
a
a
a
a
a
a
"}
(30,1,1) = {"
a
a
a
a
a
a
a
a
a
a
a
a
a
a
b
b
b
G
d
d
d
d
a
a
a
a
a
a
a
a
a
a
a
a
a
a
a
a
a
a
"}
(31,1,1) = {"
a
a
a
a
a
a
a
a
a
a
a
a
a
a
a
b
b
d
d
d
d
d
a
a
a
a
a
a
a
a
a
a
a
a
a
a
a
a
a
a
"}
(32,1,1) = {"
a
a
a
a
a
a
a
a
a
a
a
a
a
a
a
a
a
a
a
a
a
a
a
a
a
a
a
a
a
a
a
a
a
a
a
a
a
a
a
a
"}
(33,1,1) = {"
a
a
a
a
a
a
a
a
a
a
a
a
a
a
a
a
a
a
a
a
a
a
a
a
a
a
a
a
a
a
a
a
a
a
a
a
a
a
a
a
"}
(34,1,1) = {"
a
a
a
a
a
a
a
a
a
a
a
a
a
a
a
a
a
a
a
a
a
a
a
a
a
a
a
a
a
a
a
d
d
G
a
a
a
a
a
a
"}
(35,1,1) = {"
a
a
a
a
a
a
a
a
a
a
a
a
a
a
a
a
a
a
a
a
a
a
a
a
a
a
a
a
a
a
d
d
b
b
a
a
a
a
a
a
"}
(36,1,1) = {"
a
a
a
a
a
a
a
a
a
a
a
a
a
a
a
a
a
a
a
a
a
a
a
a
a
a
a
a
a
a
d
d
G
b
a
a
a
a
a
a
"}
(37,1,1) = {"
a
a
a
a
a
a
a
a
a
a
a
a
a
a
a
a
a
a
a
a
a
a
a
a
a
a
a
a
b
a
b
d
b
b
a
a
a
a
a
a
"}
(38,1,1) = {"
a
a
a
a
a
a
a
a
a
a
a
a
a
a
a
a
a
a
a
a
a
a
a
a
a
a
a
a
a
a
b
b
a
a
a
a
a
a
a
a
"}
(39,1,1) = {"
a
a
a
a
a
a
a
a
a
a
a
a
a
a
a
a
a
a
a
a
a
a
a
a
a
a
a
a
a
a
a
a
a
a
a
a
a
a
a
a
"}
(40,1,1) = {"
a
a
a
a
a
a
a
a
a
a
a
a
a
a
a
a
a
a
a
a
a
a
a
a
a
a
a
a
a
a
a
a
a
a
a
a
a
a
a
a
"}
