//MAP CONVERTED BY dmm2tgm.py THIS HEADER COMMENT PREVENTS RECONVERSION, DO NOT REMOVE
"a" = (
/turf/template_noop,
/area/template_noop)
"b" = (
/obj/structure/lattice,
/turf/template_noop,
/area/template_noop)
"c" = (
/turf/simulated/wall,
/area/submap/gasthelizards)
"d" = (
/obj/machinery/light{
	dir = 1
	},
/obj/structure/bed,
/obj/effect/decal/remains/human,
/turf/simulated/floor/tiled/yellow,
/area/submap/gasthelizards)
"e" = (
/obj/structure/window/reinforced{
	dir = 4
	},
/mob/living/simple_mob/animal/passive/lizard/event,
/turf/simulated/floor/tiled/yellow,
/area/submap/gasthelizards)
"f" = (
/obj/structure/window/reinforced{
	dir = 8
	},
/obj/machinery/light{
	dir = 1
	},
/obj/structure/bed,
/obj/effect/decal/remains/human,
/turf/simulated/floor/tiled/yellow,
/area/submap/gasthelizards)
"g" = (
/obj/structure/window/reinforced{
	dir = 8
	},
/obj/machinery/light{
	dir = 1
	},
/obj/structure/bed,
/turf/simulated/floor/tiled/yellow,
/area/submap/gasthelizards)
"h" = (
/mob/living/simple_mob/animal/passive/lizard/event,
/turf/simulated/floor/tiled/yellow,
/area/submap/gasthelizards)
"i" = (
/turf/simulated/floor/tiled/yellow,
/area/submap/gasthelizards)
"j" = (
/obj/structure/window/reinforced{
	dir = 4
	},
/obj/machinery/atmospherics/unary/outlet_injector,
/turf/simulated/floor/tiled/yellow,
/area/submap/gasthelizards)
"k" = (
/obj/structure/window/reinforced{
	dir = 8
	},
/turf/simulated/floor/tiled/yellow,
/area/submap/gasthelizards)
"l" = (
/obj/machinery/atmospherics/unary/outlet_injector,
/turf/simulated/floor/tiled/yellow,
/area/submap/gasthelizards)
"m" = (
/obj/structure/closet/crate/freezer,
/obj/item/stack/animalhide/lizard{
	amount = 25
	},
/turf/simulated/floor/tiled/asteroid_steel{
	icon_state = "dark"
	},
/area/submap/gasthelizards)
"n" = (
/obj/structure/closet/crate/freezer,
/obj/machinery/light{
	dir = 1
	},
/obj/item/reagent_containers/food/snacks/meat,
/obj/item/reagent_containers/food/snacks/meat,
/obj/item/reagent_containers/food/snacks/meat,
/obj/item/reagent_containers/food/snacks/meat,
/obj/item/reagent_containers/food/snacks/meat,
/obj/item/reagent_containers/food/snacks/meat,
/obj/item/reagent_containers/food/snacks/meat,
/obj/item/reagent_containers/food/snacks/meat,
/obj/item/reagent_containers/food/snacks/meat,
/obj/item/reagent_containers/food/snacks/meat,
/obj/item/reagent_containers/food/snacks/meat,
/turf/simulated/floor/tiled/asteroid_steel{
	icon_state = "dark"
	},
/area/submap/gasthelizards)
"o" = (
/obj/structure/closet/crate/freezer,
/obj/item/reagent_containers/food/snacks/meat,
/obj/item/reagent_containers/food/snacks/meat,
/obj/item/reagent_containers/food/snacks/meat,
/obj/item/reagent_containers/food/snacks/meat,
/obj/item/reagent_containers/food/snacks/meat,
/obj/item/reagent_containers/food/snacks/meat,
/obj/item/reagent_containers/food/snacks/meat,
/obj/item/reagent_containers/food/snacks/meat,
/obj/item/reagent_containers/food/snacks/meat,
/obj/item/reagent_containers/food/snacks/meat,
/turf/simulated/floor/tiled/asteroid_steel{
	icon_state = "dark"
	},
/area/submap/gasthelizards)
"p" = (
/obj/structure/window/reinforced{
	dir = 1;
	layer = 2.9
	},
/obj/machinery/power/apc/high{
	dir = 8;
	pixel_x = -20
	},
/turf/simulated/floor/tiled/techmaint,
/area/submap/gasthelizards)
"q" = (
/obj/structure/window/reinforced{
	dir = 1;
	layer = 2.9
	},
/turf/simulated/floor/tiled/techmaint,
/area/submap/gasthelizards)
"r" = (
/obj/machinery/door/window/brigdoor/northleft,
/turf/simulated/floor/tiled/techmaint,
/area/submap/gasthelizards)
"s" = (
/turf/simulated/floor/tiled/asteroid_steel{
	icon_state = "dark"
	},
/area/submap/gasthelizards)
"t" = (
/turf/simulated/floor/tiled/asteroid_steel{
	temperature = 293.15
	},
/area/submap/gasthelizards)
"u" = (
/obj/machinery/light{
	dir = 1
	},
/obj/random/trash,
/turf/simulated/floor/tiled/asteroid_steel{
	temperature = 293.15
	},
/area/submap/gasthelizards)
"v" = (
/obj/machinery/light{
	dir = 4
	},
/turf/simulated/floor/tiled/asteroid_steel{
	temperature = 293.15
	},
/area/submap/gasthelizards)
"w" = (
/obj/structure/kitchenspike,
/turf/simulated/floor/tiled/asteroid_steel{
	icon_state = "dark"
	},
/area/submap/gasthelizards)
"x" = (
/obj/structure/table/reinforced,
/obj/item/reagent_containers/spray/pepper,
/obj/random/junk,
/obj/item/material/knife/butch,
/obj/item/handcuffs,
/obj/item/stolenpackage,
/turf/simulated/floor/tiled/asteroid_steel{
	icon_state = "dark"
	},
/area/submap/gasthelizards)
"y" = (
/obj/machinery/portable_atmospherics/canister/carbon_dioxide,
/turf/simulated/floor/tiled/asteroid_steel{
	temperature = 293.15
	},
/area/submap/gasthelizards)
"z" = (
/obj/machinery/gibber,
/turf/simulated/floor/tiled/asteroid_steel{
	icon_state = "dark"
	},
/area/submap/gasthelizards)
"A" = (
/obj/structure/table/reinforced,
/obj/item/clothing/suit/straight_jacket,
/turf/simulated/floor/tiled/asteroid_steel{
	icon_state = "dark"
	},
/area/submap/gasthelizards)
"B" = (
/obj/machinery/portable_atmospherics/canister/empty/nitrogen,
/turf/simulated/floor/tiled/asteroid_steel{
	temperature = 293.15
	},
/area/submap/gasthelizards)
"C" = (
/obj/machinery/door/airlock/security,
/turf/simulated/floor/tiled/asteroid_steel{
	icon_state = "dark"
	},
/area/submap/gasthelizards)
"D" = (
/obj/item/reagent_containers/glass/bottle/toxin{
	pixel_x = 6;
	pixel_y = 8
	},
/obj/structure/table/reinforced,
/obj/item/reagent_containers/glass/bottle/stoxin,
/obj/item/reagent_containers/glass/bottle/tramadol{
	pixel_x = -3;
	pixel_y = 6
	},
/obj/item/reagent_containers/glass/bottle/peridaxon{
	pixel_x = 7;
	pixel_y = -3
	},
/turf/simulated/floor/tiled/asteroid_steel{
	icon_state = "dark"
	},
/area/submap/gasthelizards)
"E" = (
/obj/item/melee/baton/cattleprod,
/obj/structure/table/rack/shelf/steel,
/turf/simulated/floor/tiled/asteroid_steel{
	temperature = 293.15
	},
/area/submap/gasthelizards)
"F" = (
/obj/item/pen/red,
/obj/structure/table/standard,
/turf/simulated/floor/tiled/asteroid_steel{
	temperature = 293.15
	},
/area/submap/gasthelizards)
"G" = (
/obj/item/paper_bin,
/obj/structure/table/standard,
/turf/simulated/floor/tiled/asteroid_steel{
	temperature = 293.15
	},
/area/submap/gasthelizards)
"H" = (
/obj/structure/table/standard,
/obj/random/junk,
/turf/simulated/floor/tiled/asteroid_steel{
	temperature = 293.15
	},
/area/submap/gasthelizards)
"I" = (
/obj/structure/window/reinforced{
	dir = 4
	},
/obj/machinery/light,
/obj/structure/table/standard,
/obj/item/toy/plushie/lizardplushie,
/turf/simulated/floor/tiled/asteroid_steel{
	temperature = 293.15
	},
/area/submap/gasthelizards)
"J" = (
/obj/machinery/portable_atmospherics/powered/scrubber,
/obj/effect/floor_decal/industrial/outline/yellow,
/turf/simulated/floor/tiled/asteroid_steel{
	temperature = 293.15
	},
/area/submap/gasthelizards)
"K" = (
/obj/structure/table/reinforced,
/obj/machinery/light,
/obj/item/surgical/circular_saw{
	pixel_y = 8
	},
/obj/item/surgical/scalpel,
/turf/simulated/floor/tiled/asteroid_steel{
	icon_state = "dark"
	},
/area/submap/gasthelizards)
"L" = (
/obj/effect/decal/cleanable/blood/gibs,
/turf/simulated/floor/tiled/asteroid_steel{
	icon_state = "dark"
	},
/area/submap/gasthelizards)
"M" = (
/obj/structure/table/reinforced,
/obj/item/reagent_containers/syringe,
/obj/item/reagent_containers/dropper,
/obj/item/reagent_containers/glass/bottle/mutagen,
/obj/item/reagent_containers/glass/bottle/mutagen,
/obj/item/surgical/cautery,
/obj/item/surgical/hemostat,
/turf/simulated/floor/tiled/asteroid_steel{
	icon_state = "dark"
	},
/area/submap/gasthelizards)
"N" = (
/obj/machinery/suit_cycler,
/turf/simulated/floor/tiled/asteroid_steel{
	temperature = 293.15
	},
/area/submap/gasthelizards)
"O" = (
/obj/machinery/light,
/turf/simulated/floor/tiled/asteroid_steel{
	temperature = 293.15
	},
/area/submap/gasthelizards)
"P" = (
/obj/structure/closet/emcloset,
/turf/simulated/floor/tiled/asteroid_steel{
	temperature = 293.15
	},
/area/submap/gasthelizards)
"Q" = (
/obj/machinery/door/airlock/external,
/turf/simulated/floor/plating,
/area/submap/gasthelizards)
"R" = (
/turf/simulated/floor/plating,
/area/submap/gasthelizards)
"S" = (
/obj/effect/floor_decal/rust,
/turf/simulated/floor/tiled/asteroid_steel{
	icon_state = "dark"
	},
/area/submap/gasthelizards)
"T" = (
/obj/item/stack/rods,
/turf/template_noop,
/area/template_noop)
"U" = (
/obj/effect/floor_decal/rust,
/turf/simulated/floor/tiled/asteroid_steel{
	temperature = 293.15
	},
/area/submap/gasthelizards)
"V" = (
/mob/living/simple_mob/humanoid/merc/ranged/technician,
/turf/simulated/floor/tiled/asteroid_steel{
	temperature = 293.15
	},
/area/submap/gasthelizards)
"W" = (
/mob/living/simple_mob/humanoid/merc/ranged/space/tommylas,
/turf/simulated/floor/tiled/asteroid_steel{
	temperature = 293.15
	},
/area/submap/gasthelizards)
"X" = (
/obj/random/junk,
/turf/simulated/floor/tiled/asteroid_steel{
	temperature = 293.15
	},
/area/submap/gasthelizards)
"Y" = (
/obj/random/trash,
/turf/simulated/floor/tiled/asteroid_steel{
	icon_state = "dark"
	},
/area/submap/gasthelizards)
"Z" = (
/obj/random/trash,
/turf/simulated/floor/tiled/asteroid_steel{
	temperature = 293.15
	},
/area/submap/gasthelizards)

(1,1,1) = {"
a
a
a
a
a
a
a
a
b
a
a
T
a
a
"}
(2,1,1) = {"
a
a
a
b
b
b
b
a
b
b
b
a
a
a
"}
(3,1,1) = {"
T
a
a
b
b
c
c
c
c
c
c
c
b
a
"}
(4,1,1) = {"
a
b
b
b
b
c
P
y
B
E
N
c
b
b
"}
(5,1,1) = {"
b
a
c
c
c
c
u
t
t
U
O
c
c
c
"}
(6,1,1) = {"
a
b
c
d
i
p
t
U
t
U
t
Q
R
Q
"}
(7,1,1) = {"
b
b
c
e
j
r
U
W
t
t
P
c
c
c
"}
(8,1,1) = {"
a
b
c
f
k
q
V
t
Z
F
c
c
b
b
"}
(9,1,1) = {"
b
b
c
e
j
r
t
U
t
G
c
b
b
a
"}
(10,1,1) = {"
a
a
c
g
k
q
t
U
t
H
c
b
T
a
"}
(11,1,1) = {"
b
b
c
e
j
r
V
X
t
I
c
b
a
a
"}
(12,1,1) = {"
b
a
c
f
k
q
t
U
t
J
c
b
a
a
"}
(13,1,1) = {"
a
b
c
h
l
r
v
t
t
J
c
b
a
a
"}
(14,1,1) = {"
a
b
c
c
c
c
c
c
C
c
c
b
a
a
"}
(15,1,1) = {"
a
b
b
c
m
S
w
z
s
K
c
a
T
a
"}
(16,1,1) = {"
a
b
b
c
n
Y
s
S
s
L
c
a
a
a
"}
(17,1,1) = {"
a
a
b
c
o
s
x
A
D
M
c
b
b
a
"}
(18,1,1) = {"
a
a
b
c
c
c
c
c
c
c
c
b
a
a
"}
(19,1,1) = {"
a
T
a
a
b
b
a
a
b
b
b
a
a
a
"}
