//MAP CONVERTED BY dmm2tgm.py THIS HEADER COMMENT PREVENTS RECONVERSION, DO NOT REMOVE
"a" = (
/turf/template_noop,
/area/template_noop)
"x" = (
/obj/structure/outcrop/phoron,
/turf/simulated/mineral/floor/vacuum,
/area/submap/golemtarget)
"H" = (
/turf/simulated/mineral,
/area/submap/golemtarget)
"Q" = (
/obj/singularity,
/turf/template_noop,
/area/submap/golemtarget)
"S" = (
/turf/simulated/mineral/floor/vacuum,
/area/submap/golemtarget)
"Y" = (
/obj/structure/outcrop/phoron,
/obj/structure/outcrop/phoron,
/turf/simulated/mineral/floor/vacuum,
/area/submap/golemtarget)

(1,1,1) = {"
a
a
a
a
a
a
a
a
a
a
a
a
a
a
a
a
a
a
a
a
a
a
a
a
a
a
a
a
a
a
"}
(2,1,1) = {"
x
H
x
a
a
a
a
a
a
a
a
a
a
a
a
a
a
a
H
H
a
a
a
a
a
a
a
a
a
a
"}
(3,1,1) = {"
H
S
S
x
a
a
a
a
a
a
a
a
a
a
a
a
a
a
H
x
x
a
a
a
a
a
a
a
a
a
"}
(4,1,1) = {"
a
x
S
S
a
a
a
a
a
a
a
a
a
a
a
a
a
a
a
x
S
S
x
a
a
H
H
a
a
a
"}
(5,1,1) = {"
a
a
x
S
a
a
a
a
a
a
a
a
a
a
a
a
a
a
a
a
S
x
S
H
a
H
S
S
a
a
"}
(6,1,1) = {"
a
a
a
x
a
a
a
a
a
a
a
a
H
H
a
a
a
a
a
a
a
a
H
H
a
a
x
S
a
a
"}
(7,1,1) = {"
a
a
a
a
a
a
a
a
a
a
S
x
S
a
a
a
a
a
a
a
a
a
a
a
a
a
S
x
a
a
"}
(8,1,1) = {"
a
a
a
a
a
a
a
a
H
H
H
x
x
a
a
a
x
H
a
a
a
a
a
a
a
a
a
Y
a
a
"}
(9,1,1) = {"
a
a
a
a
a
a
a
a
H
H
a
a
a
a
a
a
Y
S
x
a
a
a
a
a
a
a
a
S
a
a
"}
(10,1,1) = {"
a
a
a
a
a
a
a
x
x
S
a
a
a
a
a
a
a
H
S
a
a
a
a
a
H
a
a
H
a
a
"}
(11,1,1) = {"
a
a
a
a
a
a
H
H
a
a
a
a
a
a
a
a
a
x
S
x
a
a
a
a
S
a
a
S
a
a
"}
(12,1,1) = {"
a
a
a
a
a
a
a
a
a
a
a
a
a
a
a
a
a
a
H
H
a
a
a
a
H
a
a
H
a
a
"}
(13,1,1) = {"
a
H
H
a
a
a
a
a
a
a
a
a
a
a
a
a
a
a
a
a
a
a
a
H
H
a
a
S
a
a
"}
(14,1,1) = {"
a
H
S
x
a
a
a
a
a
a
a
a
a
a
a
a
a
a
a
a
a
a
x
x
H
a
a
x
a
a
"}
(15,1,1) = {"
a
a
x
S
a
a
a
a
H
a
a
a
a
a
Q
a
a
a
a
a
a
a
S
S
a
a
a
x
a
a
"}
(16,1,1) = {"
a
a
S
S
a
a
a
a
S
a
a
a
a
a
a
a
a
a
a
a
a
a
H
x
a
a
a
a
a
a
"}
(17,1,1) = {"
a
a
S
x
S
a
a
a
x
a
a
a
a
a
a
a
a
a
a
a
a
x
x
S
a
a
a
a
a
a
"}
(18,1,1) = {"
a
a
a
H
S
a
a
a
H
S
a
a
a
a
a
a
a
a
a
a
H
x
x
a
a
a
a
a
a
a
"}
(19,1,1) = {"
a
a
a
a
H
a
a
a
H
x
S
a
a
a
a
a
a
a
a
a
H
S
a
a
a
a
a
a
a
a
"}
(20,1,1) = {"
a
a
a
a
a
a
a
a
a
S
x
x
S
x
S
H
a
a
a
a
H
H
a
a
a
a
a
a
a
a
"}
(21,1,1) = {"
a
a
a
a
a
a
a
a
a
a
a
a
a
a
H
a
a
a
a
a
S
a
a
a
a
a
a
x
a
a
"}
(22,1,1) = {"
a
a
a
a
a
a
a
a
a
a
a
a
a
a
a
a
a
a
a
a
S
a
a
a
a
a
S
x
x
a
"}
(23,1,1) = {"
a
a
a
S
H
a
a
a
a
a
a
a
a
a
a
a
a
a
a
a
x
a
a
a
a
a
x
H
S
a
"}
(24,1,1) = {"
a
a
x
x
x
H
a
a
a
a
a
a
a
a
a
a
a
a
a
a
H
a
a
a
a
x
S
x
S
S
"}
(25,1,1) = {"
a
a
a
S
S
S
H
a
a
a
a
a
a
a
a
a
a
a
a
a
a
a
a
a
a
a
S
x
S
x
"}
(26,1,1) = {"
a
a
a
a
x
x
H
a
a
a
a
a
a
a
a
a
a
a
a
a
a
a
a
a
a
a
a
a
a
a
"}
(27,1,1) = {"
a
a
a
a
a
a
a
a
a
a
a
a
a
a
H
S
x
S
S
a
a
a
a
a
a
a
a
a
a
a
"}
(28,1,1) = {"
a
a
a
a
a
a
a
a
a
a
a
a
a
H
x
S
S
S
x
a
a
a
a
a
a
a
a
a
a
a
"}
(29,1,1) = {"
a
a
a
a
a
a
a
a
a
a
a
a
a
a
x
H
x
S
a
a
a
a
a
a
a
a
a
a
a
a
"}
(30,1,1) = {"
a
a
a
a
a
a
a
a
a
a
a
a
a
a
a
a
a
a
a
a
a
a
a
a
a
a
a
a
a
a
"}
