//MAP CONVERTED BY dmm2tgm.py THIS HEADER COMMENT PREVENTS RECONVERSION, DO NOT REMOVE
"a" = (
/turf/space,
/area/template_noop)
"b" = (
/turf/simulated/wall/r_wall,
/area/submap/starhuntertraders)
"c" = (
/mob/living/simple_mob/humanoid/starhunter/trader/farmer,
/turf/simulated/floor/grass,
/area/submap/starhuntertraders)
"g" = (
/mob/living/simple_mob/humanoid/starhunter/trader/miner,
/turf/simulated/floor/grass,
/area/submap/starhuntertraders)
"q" = (
/obj/structure/table/sifwoodentable,
/obj/item/reagent_containers/food/snacks/berrymuffin/poison,
/turf/simulated/floor/grass,
/area/submap/starhuntertraders)
"A" = (
/obj/structure/table/sifwoodentable,
/obj/item/reagent_containers/food/snacks/berrymuffin/berry,
/turf/simulated/floor/grass,
/area/submap/starhuntertraders)
"C" = (
/turf/simulated/mineral,
/area/submap/starhuntertraders)
"D" = (
/mob/living/simple_mob/humanoid/starhunter/trader/reliccollecter,
/turf/simulated/floor/grass,
/area/submap/starhuntertraders)
"F" = (
/mob/living/simple_mob/humanoid/starhunter/trader/weaponsmith,
/turf/simulated/floor/grass,
/area/submap/starhuntertraders)
"G" = (
/obj/structure/fans/hardlight/colorable/abductor,
/turf/simulated/floor/tiled/eris/steel/bar_light,
/area/submap/starhuntertraders)
"H" = (
/obj/structure/table/sifwoodentable,
/obj/item/reagent_containers/food/snacks/burrito_cheese_spicy,
/turf/simulated/floor/grass,
/area/submap/starhuntertraders)
"M" = (
/obj/structure/table/sifwoodentable,
/obj/item/reagent_containers/food/snacks/bacon_flatbread,
/turf/simulated/floor/grass,
/area/submap/starhuntertraders)
"N" = (
/turf/simulated/floor/grass,
/area/submap/starhuntertraders)
"R" = (
/obj/structure/table/sifwoodentable,
/obj/item/reagent_containers/food/snacks/burrito_mystery,
/turf/simulated/floor/grass,
/area/submap/starhuntertraders)
"S" = (
/obj/item/bedsheet,
/obj/structure/bed,
/turf/simulated/floor/grass,
/area/submap/starhuntertraders)
"T" = (
/obj/structure/table/sifwoodentable,
/obj/item/reagent_containers/food/snacks/amanitajelly,
/turf/simulated/floor/grass,
/area/submap/starhuntertraders)
"V" = (
/turf/simulated/floor/tiled/eris/steel/bar_light,
/area/submap/starhuntertraders)

(1,1,1) = {"
a
a
a
a
a
a
a
a
a
a
a
a
a
a
a
a
a
a
a
a
a
a
a
a
a
a
a
a
a
a
"}
(2,1,1) = {"
a
a
a
a
a
a
a
a
a
a
a
a
a
a
a
a
a
a
a
a
a
a
a
a
a
a
a
a
a
a
"}
(3,1,1) = {"
a
a
a
a
a
a
a
a
a
a
a
a
a
a
a
a
a
a
a
a
a
a
a
a
a
a
a
a
a
a
"}
(4,1,1) = {"
a
a
a
a
a
a
a
a
a
a
a
a
a
a
a
a
a
a
a
a
a
a
a
a
a
a
a
a
a
a
"}
(5,1,1) = {"
a
a
a
a
a
a
a
a
a
a
a
a
a
a
a
a
a
a
a
a
a
a
a
a
a
a
a
a
a
a
"}
(6,1,1) = {"
a
a
a
a
a
a
a
a
a
a
a
a
C
C
C
C
C
a
a
a
a
a
a
a
a
a
a
a
a
a
"}
(7,1,1) = {"
a
a
a
a
a
a
a
a
a
a
a
C
C
C
C
C
C
C
a
a
a
a
a
a
a
a
a
a
a
a
"}
(8,1,1) = {"
a
a
a
a
a
a
a
a
a
a
C
C
C
C
C
C
C
C
C
a
a
a
a
a
a
a
a
a
a
a
"}
(9,1,1) = {"
a
a
a
a
a
a
a
a
a
C
C
C
N
N
N
N
N
C
C
C
a
a
a
a
a
a
a
a
a
a
"}
(10,1,1) = {"
a
a
a
a
a
a
a
a
C
C
C
N
N
N
N
N
N
N
C
C
C
a
a
a
a
a
a
a
a
a
"}
(11,1,1) = {"
a
a
a
a
a
a
a
C
C
C
N
N
H
T
M
T
q
N
N
C
C
C
a
a
a
a
a
a
a
a
"}
(12,1,1) = {"
a
a
a
a
a
a
C
C
C
N
N
N
c
N
N
N
F
N
N
N
b
b
b
a
a
a
a
a
a
a
"}
(13,1,1) = {"
a
a
a
a
a
a
C
C
N
N
N
N
N
N
N
N
N
N
N
N
b
V
b
a
a
a
a
a
a
a
"}
(14,1,1) = {"
a
a
a
a
a
a
C
C
N
N
N
N
S
S
N
S
S
N
N
N
G
V
G
a
a
a
a
a
a
a
"}
(15,1,1) = {"
a
a
a
a
a
a
C
C
N
N
N
N
D
N
N
N
N
N
N
N
b
V
b
a
a
a
a
a
a
a
"}
(16,1,1) = {"
a
a
a
a
a
a
C
C
C
N
N
N
N
N
N
g
N
N
N
N
b
b
b
a
a
a
a
a
a
a
"}
(17,1,1) = {"
a
a
a
a
a
a
a
C
C
C
N
N
A
T
M
T
R
N
N
C
C
C
a
a
a
a
a
a
a
a
"}
(18,1,1) = {"
a
a
a
a
a
a
a
a
C
C
C
N
N
N
N
N
N
N
C
C
C
a
a
a
a
a
a
a
a
a
"}
(19,1,1) = {"
a
a
a
a
a
a
a
a
a
C
C
C
N
N
N
N
N
C
C
C
a
a
a
a
a
a
a
a
a
a
"}
(20,1,1) = {"
a
a
a
a
a
a
a
a
a
a
C
C
C
C
C
C
C
C
C
a
a
a
a
a
a
a
a
a
a
a
"}
(21,1,1) = {"
a
a
a
a
a
a
a
a
a
a
a
C
C
C
C
C
C
C
a
a
a
a
a
a
a
a
a
a
a
a
"}
(22,1,1) = {"
a
a
a
a
a
a
a
a
a
a
a
a
C
C
C
C
C
a
a
a
a
a
a
a
a
a
a
a
a
a
"}
(23,1,1) = {"
a
a
a
a
a
a
a
a
a
a
a
a
a
a
a
a
a
a
a
a
a
a
a
a
a
a
a
a
a
a
"}
(24,1,1) = {"
a
a
a
a
a
a
a
a
a
a
a
a
a
a
a
a
a
a
a
a
a
a
a
a
a
a
a
a
a
a
"}
(25,1,1) = {"
a
a
a
a
a
a
a
a
a
a
a
a
a
a
a
a
a
a
a
a
a
a
a
a
a
a
a
a
a
a
"}
(26,1,1) = {"
a
a
a
a
a
a
a
a
a
a
a
a
a
a
a
a
a
a
a
a
a
a
a
a
a
a
a
a
a
a
"}
(27,1,1) = {"
a
a
a
a
a
a
a
a
a
a
a
a
a
a
a
a
a
a
a
a
a
a
a
a
a
a
a
a
a
a
"}
(28,1,1) = {"
a
a
a
a
a
a
a
a
a
a
a
a
a
a
a
a
a
a
a
a
a
a
a
a
a
a
a
a
a
a
"}
(29,1,1) = {"
a
a
a
a
a
a
a
a
a
a
a
a
a
a
a
a
a
a
a
a
a
a
a
a
a
a
a
a
a
a
"}
(30,1,1) = {"
a
a
a
a
a
a
a
a
a
a
a
a
a
a
a
a
a
a
a
a
a
a
a
a
a
a
a
a
a
a
"}
