//MAP CONVERTED BY dmm2tgm.py THIS HEADER COMMENT PREVENTS RECONVERSION, DO NOT REMOVE
"a" = (
/turf/space,
/area/template_noop)
"b" = (
/turf/simulated/wall/r_wall,
/area/submap/starhunterarena)
"c" = (
/obj/structure/table/alien/blue,
/obj/item/paper{
	info = "Come face us. If we fall, you shall be rewarded.";
	name = "Challenge"
	},
/turf/simulated/floor/tiled/eris/steel/bar_light,
/area/submap/starhunterarena)
"g" = (
/mob/living/simple_mob/humanoid/starhunter/hunter/druid,
/turf/simulated/floor/grass,
/area/submap/starhunterarena)
"j" = (
/mob/living/simple_mob/humanoid/starhunter/hunter/champion,
/turf/simulated/floor/grass,
/area/submap/starhunterarena)
"k" = (
/obj/structure/flora/ausbushes,
/turf/simulated/floor/grass,
/area/submap/starhunterarena)
"n" = (
/obj/structure/flora/ausbushes/genericbush,
/turf/simulated/floor/grass,
/area/submap/starhunterarena)
"u" = (
/obj/structure/flora/ausbushes/brflowers,
/turf/simulated/floor/grass,
/area/submap/starhunterarena)
"B" = (
/obj/structure/flora/tree/bigtree,
/turf/simulated/floor/grass,
/area/submap/starhunterarena)
"E" = (
/obj/structure/flora/ausbushes/brflowers,
/mob/living/simple_mob/humanoid/starhunter/hunter/avatar,
/turf/simulated/floor/grass,
/area/submap/starhunterarena)
"G" = (
/turf/simulated/mineral,
/area/template_noop)
"K" = (
/obj/structure/fans/hardlight/colorable/abductor,
/turf/simulated/floor/tiled/eris/steel/bar_light,
/area/submap/starhunterarena)
"M" = (
/turf/simulated/floor/tiled/eris/steel/bar_light,
/area/submap/starhunterarena)
"P" = (
/turf/simulated/mineral,
/area/submap/starhunterarena)
"T" = (
/obj/structure/flora/ausbushes/brflowers,
/obj/structure/flora/ausbushes/brflowers,
/turf/simulated/floor/grass,
/area/submap/starhunterarena)
"U" = (
/turf/simulated/floor/grass,
/area/submap/starhunterarena)

(1,1,1) = {"
a
a
a
a
a
a
a
a
a
a
a
a
a
a
a
a
a
a
a
a
a
a
a
a
a
a
a
a
a
a
a
a
a
a
a
a
a
a
a
a
a
a
a
a
a
a
a
a
a
a
a
a
a
a
a
a
a
a
a
a
a
a
a
a
a
a
a
a
a
a
"}
(2,1,1) = {"
a
a
a
a
a
a
a
a
a
a
a
a
a
a
a
a
a
a
a
a
a
a
a
a
a
a
a
a
a
a
a
a
a
a
a
a
a
a
a
a
a
a
a
a
a
a
a
a
a
a
a
a
a
a
a
a
a
a
a
a
a
a
a
a
a
a
a
a
a
a
"}
(3,1,1) = {"
a
a
a
a
a
a
a
a
a
a
a
a
a
a
a
a
a
a
a
a
a
a
a
a
a
a
a
a
a
a
a
a
a
a
a
a
a
a
a
a
a
a
a
a
a
a
a
a
a
a
a
a
a
a
a
a
a
a
a
a
a
a
a
a
a
a
a
a
a
a
"}
(4,1,1) = {"
a
a
a
a
a
a
a
a
a
a
a
a
a
a
a
a
a
a
a
a
a
a
a
a
a
a
a
a
a
a
a
a
a
a
a
a
a
a
a
a
a
a
a
a
a
a
a
a
a
a
a
a
a
a
a
a
a
a
a
a
a
a
a
a
a
a
a
a
a
a
"}
(5,1,1) = {"
a
a
a
a
a
a
a
a
a
a
a
a
a
a
a
a
a
a
a
a
a
a
a
a
a
a
a
a
a
a
a
a
a
a
a
a
a
a
a
a
a
a
a
a
a
a
a
a
a
a
a
a
a
a
a
a
a
a
a
a
a
a
a
a
a
a
a
a
a
a
"}
(6,1,1) = {"
a
a
a
a
a
a
a
a
a
a
a
a
a
a
a
a
a
a
a
a
a
a
a
a
a
a
a
a
a
a
a
a
a
a
a
a
a
a
a
a
a
a
a
a
a
a
a
a
a
a
a
a
a
a
a
a
a
a
a
a
a
a
a
a
a
a
a
a
a
a
"}
(7,1,1) = {"
a
a
a
a
a
a
a
a
a
a
a
a
a
a
a
a
a
a
a
a
a
a
a
a
a
a
a
a
a
a
a
a
a
a
a
P
P
a
a
a
a
a
a
a
a
a
a
a
a
a
a
a
a
a
a
a
a
a
a
a
a
a
a
a
a
a
a
a
a
a
"}
(8,1,1) = {"
a
a
a
a
a
a
a
a
a
a
a
a
a
a
a
a
a
a
a
a
a
a
a
a
a
a
a
a
a
a
a
a
a
P
P
P
P
P
P
a
a
a
P
P
P
P
a
a
a
a
a
a
a
a
a
a
a
a
a
a
a
a
a
a
a
a
a
a
a
a
"}
(9,1,1) = {"
a
a
a
a
a
a
a
a
a
a
a
a
a
a
a
a
a
a
a
a
a
a
a
a
a
a
a
a
a
a
a
a
P
P
P
P
P
P
P
P
P
P
P
P
P
P
P
a
a
a
a
a
a
a
a
a
a
a
a
a
a
a
a
a
a
a
a
a
a
a
"}
(10,1,1) = {"
a
a
a
a
a
a
a
a
a
a
a
a
a
a
a
a
a
a
a
a
a
a
a
a
a
a
a
a
P
P
P
P
P
P
P
P
P
P
P
P
P
P
P
P
P
P
P
P
P
P
P
a
a
a
a
a
a
a
a
a
a
a
a
a
a
a
a
a
a
a
"}
(11,1,1) = {"
a
a
a
a
a
a
a
a
a
a
a
a
a
a
a
a
a
a
a
a
a
a
a
a
a
a
a
P
P
P
P
P
P
P
P
P
P
P
P
P
P
P
P
P
P
P
P
P
P
P
P
P
P
a
a
a
a
a
a
a
a
a
a
a
a
a
a
a
a
a
"}
(12,1,1) = {"
a
a
a
a
a
a
a
a
a
a
a
a
a
a
a
a
a
a
a
a
a
a
a
a
a
P
P
P
P
P
P
P
P
P
P
P
P
P
P
P
P
P
P
P
P
P
P
P
P
P
P
P
P
P
P
P
a
a
a
a
a
a
a
a
a
a
a
a
a
a
"}
(13,1,1) = {"
a
a
a
a
a
a
a
a
a
a
a
a
a
a
a
a
a
a
a
a
a
a
a
a
P
P
P
P
P
P
P
P
P
P
P
P
P
P
P
P
P
P
P
P
P
P
P
P
P
P
P
P
P
P
P
P
P
a
a
a
a
a
a
a
a
a
a
a
a
a
"}
(14,1,1) = {"
a
a
a
a
a
a
a
a
a
a
a
a
a
a
a
a
a
P
P
P
P
a
a
P
P
P
P
P
P
P
P
P
P
P
P
P
P
P
P
U
U
U
P
P
P
P
P
P
P
P
P
P
P
P
P
P
P
P
a
a
a
a
a
a
a
a
a
a
a
a
"}
(15,1,1) = {"
a
a
a
a
a
a
a
a
a
a
a
a
a
a
a
P
P
P
P
P
P
P
P
P
P
P
P
P
P
P
P
P
P
P
P
P
P
U
U
U
U
U
U
U
P
P
P
P
P
P
P
P
P
P
P
P
P
P
P
a
a
a
a
a
a
a
a
a
a
a
"}
(16,1,1) = {"
a
a
a
a
a
a
a
a
a
a
a
a
a
P
P
P
P
P
P
P
P
P
P
P
P
P
P
P
P
P
P
P
P
P
P
U
U
U
U
u
u
U
U
U
U
U
U
U
P
P
P
P
P
P
P
P
P
P
P
P
a
a
a
a
a
a
a
a
a
a
"}
(17,1,1) = {"
a
a
a
a
a
a
a
a
a
a
a
P
P
P
P
P
P
P
P
P
P
P
P
P
P
P
P
P
P
P
P
P
P
U
U
U
k
U
U
u
U
u
U
U
U
U
U
U
P
P
P
P
P
P
P
P
P
P
P
P
a
a
a
a
a
a
a
a
a
a
"}
(18,1,1) = {"
a
a
a
a
a
a
a
a
a
a
P
P
P
P
P
P
P
P
P
P
P
P
P
P
P
P
P
P
P
P
U
u
u
U
U
U
U
U
u
U
n
U
u
U
U
U
B
U
U
U
P
P
P
P
P
P
P
P
P
P
P
a
a
a
a
a
a
a
a
a
"}
(19,1,1) = {"
a
a
a
a
a
a
a
a
P
P
P
P
P
P
P
P
P
P
P
P
P
P
P
P
P
P
P
P
P
U
U
U
u
u
U
U
U
u
u
U
U
U
u
u
U
U
U
U
U
U
P
P
P
P
P
P
P
P
P
P
P
a
a
a
a
a
a
a
a
a
"}
(20,1,1) = {"
a
a
a
a
a
a
a
P
P
P
P
P
P
P
P
P
P
P
P
P
P
P
P
P
P
P
P
P
U
U
U
U
U
u
u
u
u
u
U
u
u
u
U
U
u
u
U
U
U
U
U
P
P
P
P
P
P
P
P
P
P
a
a
a
a
a
a
a
a
a
"}
(21,1,1) = {"
a
a
a
a
a
a
a
P
P
P
P
P
P
P
P
P
P
P
P
P
P
P
P
P
P
P
P
P
U
U
U
U
U
B
u
U
u
u
u
U
j
U
U
U
U
u
u
u
U
U
U
P
P
P
P
P
P
P
P
P
P
G
a
a
a
a
a
a
a
a
"}
(22,1,1) = {"
a
a
a
a
a
a
P
P
P
P
P
U
U
U
U
U
U
U
P
P
P
P
P
P
P
P
P
P
U
U
U
U
U
u
u
u
U
U
U
U
U
U
k
U
U
U
U
u
U
U
U
P
P
P
P
P
P
P
P
P
P
G
a
a
a
a
a
a
a
a
"}
(23,1,1) = {"
a
a
a
a
a
P
P
P
P
P
U
U
U
U
u
u
u
U
U
U
P
P
P
P
P
P
P
P
U
U
U
U
U
U
u
u
u
u
u
u
u
U
U
U
U
U
U
u
u
U
U
U
P
P
P
P
P
P
P
P
P
P
P
a
a
a
a
a
a
a
"}
(24,1,1) = {"
a
a
a
a
a
P
P
P
P
U
U
U
U
u
u
U
u
u
u
U
U
U
P
P
P
P
P
P
u
u
U
U
k
U
u
u
U
U
U
U
u
u
u
U
u
u
U
U
u
U
U
U
U
P
P
P
P
P
P
P
P
P
P
a
a
a
a
a
a
a
"}
(25,1,1) = {"
a
a
a
a
a
P
P
P
U
U
U
U
u
u
U
U
U
U
u
u
u
U
U
P
P
P
U
U
U
u
u
U
U
U
U
U
U
U
U
U
U
U
u
u
U
u
u
u
T
u
u
U
U
U
P
P
P
P
P
P
P
P
P
a
a
a
a
a
a
a
"}
(26,1,1) = {"
a
a
a
a
P
P
P
P
U
U
U
u
u
U
U
U
U
U
U
U
u
u
u
u
U
U
U
U
U
U
u
u
U
U
U
U
k
U
U
U
U
U
U
U
U
U
U
U
U
U
T
T
U
U
U
P
P
P
P
P
P
P
P
a
a
a
a
a
a
a
"}
(27,1,1) = {"
a
a
a
a
P
P
P
U
U
U
u
u
U
U
U
U
B
U
U
U
U
U
U
U
U
U
U
U
U
U
U
P
U
U
U
U
U
U
U
U
U
U
B
U
U
U
U
U
U
U
U
u
u
U
U
P
P
P
P
P
P
G
a
a
a
a
a
a
a
a
"}
(28,1,1) = {"
a
a
a
P
P
P
P
U
U
u
u
U
U
U
U
U
U
U
U
n
U
U
U
U
U
U
U
U
U
U
P
P
P
P
P
U
U
U
U
U
U
U
U
U
U
U
U
U
U
U
U
U
u
u
U
U
P
P
P
P
P
G
a
a
a
a
a
a
a
a
"}
(29,1,1) = {"
a
a
a
P
P
P
P
u
u
u
U
k
U
U
U
U
U
U
U
U
U
U
U
U
k
U
U
U
U
P
P
P
P
P
P
P
P
U
U
U
U
U
U
U
U
U
U
P
P
P
U
U
U
u
u
U
P
P
P
P
P
G
a
a
a
a
a
a
a
a
"}
(30,1,1) = {"
a
a
a
P
P
P
U
U
U
U
U
U
U
U
U
U
U
k
U
U
u
U
U
U
U
U
U
U
U
P
P
P
P
P
P
P
P
P
P
P
P
U
U
U
U
P
P
P
P
P
P
U
U
u
T
U
P
P
P
P
P
G
a
a
a
a
a
a
a
a
"}
(31,1,1) = {"
a
a
a
P
P
P
U
U
U
B
U
U
U
U
U
U
U
U
U
u
u
U
U
U
U
U
U
U
U
U
P
P
P
P
P
P
P
P
P
P
P
P
P
U
U
P
P
P
P
P
P
U
U
U
u
u
P
P
P
P
P
G
a
a
a
a
a
a
a
a
"}
(32,1,1) = {"
a
a
a
P
P
P
u
u
U
U
U
U
U
U
U
U
U
U
U
u
U
U
U
U
U
B
U
U
U
U
P
P
P
P
P
P
P
P
P
P
P
P
P
P
P
P
P
P
P
P
P
P
U
U
U
U
P
P
P
P
P
G
a
a
a
a
a
a
a
a
"}
(33,1,1) = {"
a
a
a
P
P
P
U
u
u
U
U
U
U
U
U
B
U
U
u
u
U
U
U
U
U
U
U
U
k
U
P
P
P
P
P
P
P
P
P
P
P
P
P
P
P
P
P
P
P
P
P
P
U
U
U
U
P
P
P
P
P
G
a
a
a
a
a
a
a
a
"}
(34,1,1) = {"
a
a
a
P
P
P
U
U
u
u
u
U
U
U
U
U
U
U
E
u
u
U
U
U
U
U
U
U
U
U
P
P
P
P
P
P
P
U
U
P
P
P
P
P
P
P
P
P
P
P
P
U
U
n
U
U
P
P
P
P
P
G
a
a
a
a
a
a
a
a
"}
(35,1,1) = {"
a
a
a
a
P
P
P
U
U
U
u
u
U
U
U
U
u
u
u
U
u
u
U
U
n
U
U
U
U
U
P
P
P
P
P
P
U
U
U
U
U
U
U
U
P
P
P
P
P
P
P
U
U
U
U
U
P
P
P
P
P
G
a
a
a
a
a
a
a
a
"}
(36,1,1) = {"
a
a
a
a
P
P
P
P
U
U
U
u
u
u
u
u
u
U
U
U
U
u
u
U
U
U
U
U
U
P
P
P
P
P
P
U
U
n
U
U
U
U
U
U
U
U
U
U
P
P
u
U
U
U
U
U
P
P
P
P
P
G
a
a
a
a
a
a
a
a
"}
(37,1,1) = {"
a
a
a
a
a
P
P
P
U
U
U
U
U
U
u
U
U
U
k
U
U
U
u
u
U
U
U
U
P
P
P
P
P
P
U
U
U
U
U
U
U
U
B
U
U
U
U
U
U
U
u
u
U
U
U
U
P
P
P
P
P
G
a
a
a
a
a
a
a
a
"}
(38,1,1) = {"
a
a
a
a
a
P
P
P
P
U
U
U
u
u
U
U
U
U
U
U
U
U
U
u
u
u
u
u
P
P
P
P
P
U
U
U
U
U
U
U
U
U
U
U
k
U
U
U
U
U
U
u
U
U
U
U
P
P
P
P
P
G
a
a
a
a
a
a
a
a
"}
(39,1,1) = {"
a
a
a
a
a
P
P
P
P
U
U
u
u
U
U
U
n
U
U
U
U
U
U
U
U
U
U
U
P
P
P
P
P
U
U
U
U
B
U
U
U
U
U
U
U
U
U
U
U
U
U
u
u
U
U
P
P
P
P
P
P
a
a
a
a
a
a
a
a
a
"}
(40,1,1) = {"
a
a
a
a
a
a
P
P
P
P
u
u
U
U
U
U
U
U
U
U
U
U
B
U
U
U
U
u
P
P
P
P
U
U
U
U
U
U
U
U
U
U
U
U
U
U
U
U
U
B
U
U
u
u
P
P
P
P
P
P
P
a
a
a
a
a
a
a
a
a
"}
(41,1,1) = {"
a
a
a
a
a
a
P
P
P
P
U
U
U
U
B
U
U
U
U
U
U
U
U
U
U
u
u
u
P
P
P
P
U
U
U
U
u
U
k
U
U
U
U
u
u
U
U
U
U
U
U
U
U
U
P
P
P
P
P
P
P
a
a
a
a
a
a
a
a
a
"}
(42,1,1) = {"
a
a
a
a
a
a
a
P
P
P
P
U
U
U
U
U
U
k
U
U
U
U
U
U
u
u
U
U
P
P
P
P
U
U
U
n
u
u
U
U
U
u
u
u
u
u
U
U
U
U
U
U
U
U
U
P
P
P
P
P
a
a
a
a
a
a
a
a
a
a
"}
(43,1,1) = {"
a
a
a
a
a
a
a
a
P
P
P
U
U
U
U
U
U
U
U
U
U
U
u
u
U
U
U
U
P
P
P
P
P
U
U
U
U
u
u
U
g
U
U
U
U
U
u
U
U
U
U
U
U
U
U
P
b
b
b
b
b
a
a
a
a
a
a
a
a
a
"}
(44,1,1) = {"
a
a
a
a
a
a
a
a
P
P
P
P
U
U
U
U
U
U
U
U
U
u
u
U
U
n
U
U
P
P
P
P
P
P
U
U
U
U
u
u
U
U
U
U
n
U
U
u
U
U
U
k
U
U
U
U
b
M
M
M
b
a
a
a
a
a
a
a
a
a
"}
(45,1,1) = {"
a
a
a
a
a
a
a
a
a
P
P
P
P
P
P
U
U
U
U
U
u
u
U
U
k
U
U
U
P
P
P
P
P
P
U
U
U
U
U
u
u
u
U
U
U
U
U
U
U
U
U
U
U
U
U
U
K
M
c
M
K
a
a
a
a
a
a
a
a
a
"}
(46,1,1) = {"
a
a
a
a
a
a
a
a
a
a
P
P
P
P
P
P
P
U
U
U
u
U
U
U
U
U
U
U
P
P
P
P
P
P
U
U
U
U
B
U
U
U
U
U
U
U
U
U
u
U
U
U
U
U
U
U
b
M
M
M
b
a
a
a
a
a
a
a
a
a
"}
(47,1,1) = {"
a
a
a
a
a
a
a
a
a
a
a
P
P
P
P
P
P
P
P
u
U
U
U
U
U
U
U
P
P
P
P
P
P
P
P
U
U
U
U
U
U
U
U
U
U
U
U
U
u
U
U
U
U
U
U
P
b
b
b
b
b
a
a
a
a
a
a
a
a
a
"}
(48,1,1) = {"
a
a
a
a
a
a
a
a
a
a
a
a
P
P
P
P
P
P
P
P
P
P
U
U
U
U
P
P
P
P
P
P
P
P
P
P
U
U
U
n
U
U
U
U
U
B
u
u
U
U
U
n
U
U
P
P
P
P
P
P
a
a
a
a
a
a
a
a
a
a
"}
(49,1,1) = {"
a
a
a
a
a
a
a
a
a
a
a
a
a
P
P
P
P
P
P
P
P
P
P
U
U
P
P
P
P
P
P
P
P
P
P
P
P
U
U
U
U
U
U
U
U
U
U
U
U
U
U
U
U
P
P
P
P
P
P
P
a
a
a
a
a
a
a
a
a
a
"}
(50,1,1) = {"
a
a
a
a
a
a
a
a
a
a
a
a
a
P
P
P
P
P
P
P
P
P
P
P
P
P
P
P
P
P
P
P
P
P
P
P
P
P
U
U
U
U
U
U
U
U
U
U
U
U
U
U
P
P
P
P
P
P
P
a
a
a
a
a
a
a
a
a
a
a
"}
(51,1,1) = {"
a
a
a
a
a
a
a
a
a
a
a
a
a
a
P
P
P
P
P
P
P
P
P
P
P
P
P
P
P
P
P
P
P
P
P
P
P
P
P
P
P
U
U
U
U
U
U
U
U
U
U
P
P
P
P
P
P
P
P
a
a
a
a
a
a
a
a
a
a
a
"}
(52,1,1) = {"
a
a
a
a
a
a
a
a
a
a
a
a
a
a
a
P
P
P
P
P
P
P
P
P
P
P
P
P
P
P
P
P
P
P
P
P
P
P
P
P
P
P
U
U
U
U
U
U
P
P
P
P
P
P
P
P
P
P
a
a
a
a
a
a
a
a
a
a
a
a
"}
(53,1,1) = {"
a
a
a
a
a
a
a
a
a
a
a
a
a
a
a
a
P
P
P
P
P
P
P
P
P
P
P
P
P
P
P
P
P
P
P
P
P
P
P
P
P
P
P
U
U
U
U
P
P
P
P
P
P
P
P
P
P
a
a
a
a
a
a
a
a
a
a
a
a
a
"}
(54,1,1) = {"
a
a
a
a
a
a
a
a
a
a
a
a
a
a
a
a
P
P
P
P
P
P
P
P
P
P
P
P
P
P
P
P
P
P
P
P
P
P
P
P
P
P
P
P
P
P
P
P
P
P
P
P
P
P
P
P
P
a
a
a
a
a
a
a
a
a
a
a
a
a
"}
(55,1,1) = {"
a
a
a
a
a
a
a
a
a
a
a
a
a
a
a
a
a
a
P
P
P
P
P
P
P
P
P
P
P
P
P
P
P
P
P
P
P
P
P
P
P
P
P
P
P
P
P
P
P
P
P
P
P
P
P
P
P
a
a
a
a
a
a
a
a
a
a
a
a
a
"}
(56,1,1) = {"
a
a
a
a
a
a
a
a
a
a
a
a
a
a
a
a
a
a
P
P
P
P
P
P
P
P
P
P
P
P
P
P
P
P
P
P
P
P
P
P
P
P
P
P
P
P
P
P
P
P
P
P
P
P
P
P
a
a
a
a
a
a
a
a
a
a
a
a
a
a
"}
(57,1,1) = {"
a
a
a
a
a
a
a
a
a
a
a
a
a
a
a
a
a
a
a
a
P
P
P
P
P
P
P
P
P
P
P
P
P
P
P
P
P
P
P
P
P
P
P
P
P
P
P
P
P
P
P
P
P
P
P
a
a
a
a
a
a
a
a
a
a
a
a
a
a
a
"}
(58,1,1) = {"
a
a
a
a
a
a
a
a
a
a
a
a
a
a
a
a
a
a
a
a
a
a
P
P
P
P
P
P
P
P
P
P
P
P
P
P
P
P
P
P
P
P
P
P
P
P
P
P
P
P
P
P
a
a
a
a
a
a
a
a
a
a
a
a
a
a
a
a
a
a
"}
(59,1,1) = {"
a
a
a
a
a
a
a
a
a
a
a
a
a
a
a
a
a
a
a
a
a
a
a
a
P
P
P
P
P
P
P
P
P
P
P
P
P
P
P
P
P
P
P
P
P
P
P
P
P
P
a
a
a
a
a
a
a
a
a
a
a
a
a
a
a
a
a
a
a
a
"}
(60,1,1) = {"
a
a
a
a
a
a
a
a
a
a
a
a
a
a
a
a
a
a
a
a
a
a
a
a
a
a
P
P
P
P
P
P
P
P
P
P
P
P
P
P
P
P
P
P
P
P
P
P
P
P
a
a
a
a
a
a
a
a
a
a
a
a
a
a
a
a
a
a
a
a
"}
(61,1,1) = {"
a
a
a
a
a
a
a
a
a
a
a
a
a
a
a
a
a
a
a
a
a
a
a
a
a
a
a
P
P
P
P
P
P
P
P
P
P
P
P
P
P
P
P
P
P
P
P
P
a
a
a
a
a
a
a
a
a
a
a
a
a
a
a
a
a
a
a
a
a
a
"}
(62,1,1) = {"
a
a
a
a
a
a
a
a
a
a
a
a
a
a
a
a
a
a
a
a
a
a
a
a
a
a
a
a
a
P
P
P
P
P
P
P
P
P
P
P
P
P
a
a
a
a
a
a
a
a
a
a
a
a
a
a
a
a
a
a
a
a
a
a
a
a
a
a
a
a
"}
(63,1,1) = {"
a
a
a
a
a
a
a
a
a
a
a
a
a
a
a
a
a
a
a
a
a
a
a
a
a
a
a
a
a
a
P
P
P
P
P
P
P
P
P
P
a
a
a
a
a
a
a
a
a
a
a
a
a
a
a
a
a
a
a
a
a
a
a
a
a
a
a
a
a
a
"}
(64,1,1) = {"
a
a
a
a
a
a
a
a
a
a
a
a
a
a
a
a
a
a
a
a
a
a
a
a
a
a
a
a
a
a
a
a
P
P
P
P
a
a
a
a
a
a
a
a
a
a
a
a
a
a
a
a
a
a
a
a
a
a
a
a
a
a
a
a
a
a
a
a
a
a
"}
(65,1,1) = {"
a
a
a
a
a
a
a
a
a
a
a
a
a
a
a
a
a
a
a
a
a
a
a
a
a
a
a
a
a
a
a
a
a
a
a
a
a
a
a
a
a
a
a
a
a
a
a
a
a
a
a
a
a
a
a
a
a
a
a
a
a
a
a
a
a
a
a
a
a
a
"}
(66,1,1) = {"
a
a
a
a
a
a
a
a
a
a
a
a
a
a
a
a
a
a
a
a
a
a
a
a
a
a
a
a
a
a
a
a
a
a
a
a
a
a
a
a
a
a
a
a
a
a
a
a
a
a
a
a
a
a
a
a
a
a
a
a
a
a
a
a
a
a
a
a
a
a
"}
(67,1,1) = {"
a
a
a
a
a
a
a
a
a
a
a
a
a
a
a
a
a
a
a
a
a
a
a
a
a
a
a
a
a
a
a
a
a
a
a
a
a
a
a
a
a
a
a
a
a
a
a
a
a
a
a
a
a
a
a
a
a
a
a
a
a
a
a
a
a
a
a
a
a
a
"}
(68,1,1) = {"
a
a
a
a
a
a
a
a
a
a
a
a
a
a
a
a
a
a
a
a
a
a
a
a
a
a
a
a
a
a
a
a
a
a
a
a
a
a
a
a
a
a
a
a
a
a
a
a
a
a
a
a
a
a
a
a
a
a
a
a
a
a
a
a
a
a
a
a
a
a
"}
(69,1,1) = {"
a
a
a
a
a
a
a
a
a
a
a
a
a
a
a
a
a
a
a
a
a
a
a
a
a
a
a
a
a
a
a
a
a
a
a
a
a
a
a
a
a
a
a
a
a
a
a
a
a
a
a
a
a
a
a
a
a
a
a
a
a
a
a
a
a
a
a
a
a
a
"}
(70,1,1) = {"
a
a
a
a
a
a
a
a
a
a
a
a
a
a
a
a
a
a
a
a
a
a
a
a
a
a
a
a
a
a
a
a
a
a
a
a
a
a
a
a
a
a
a
a
a
a
a
a
a
a
a
a
a
a
a
a
a
a
a
a
a
a
a
a
a
a
a
a
a
a
"}
