//MAP CONVERTED BY dmm2tgm.py THIS HEADER COMMENT PREVENTS RECONVERSION, DO NOT REMOVE
"a" = (
/turf/space,
/area/template_noop)
"b" = (
/obj/structure/fans/hardlight/colorable/abductor,
/turf/simulated/shuttle/floor/alien,
/area/submap/starhunterarena)
"c" = (
/turf/simulated/shuttle/floor/alien,
/area/submap/starhunterarena)
"g" = (
/mob/living/simple_mob/humanoid/eclipse/head/stargazer,
/turf/simulated/floor/grass,
/area/submap/starhunterarena)
"j" = (
/obj/structure/flora/tree/jungle,
/obj/structure/flora/ausbushes/brflowers,
/turf/simulated/floor/grass,
/area/submap/starhunterarena)
"u" = (
/obj/structure/flora/ausbushes/brflowers,
/turf/simulated/floor/grass,
/area/submap/starhunterarena)
"B" = (
/obj/structure/flora/tree/jungle,
/turf/simulated/floor/grass,
/area/submap/starhunterarena)
"E" = (
/turf/simulated/shuttle/wall/alien/blue,
/area/template_noop)
"G" = (
/turf/simulated/mineral,
/area/template_noop)
"P" = (
/turf/simulated/mineral,
/area/submap/starhunterarena)
"T" = (
/turf/simulated/shuttle/wall/alien/blue,
/area/submap/starhunterarena)
"U" = (
/turf/simulated/floor/grass,
/area/submap/starhunterarena)

(1,1,1) = {"
a
a
a
a
a
a
a
a
a
a
a
a
a
a
a
a
a
a
a
a
a
a
a
a
a
a
a
a
a
a
a
a
a
a
a
a
a
a
a
a
a
a
a
a
a
a
a
a
a
a
a
a
a
a
a
a
a
a
a
a
a
a
a
a
a
a
a
a
a
a
"}
(2,1,1) = {"
a
a
a
a
a
a
a
a
a
a
a
a
a
a
a
a
a
a
a
a
a
a
a
a
a
a
a
a
a
a
a
a
a
a
a
a
a
a
a
a
a
a
a
a
a
a
a
a
a
a
a
a
a
a
a
a
a
a
a
a
a
a
a
a
a
a
a
a
a
a
"}
(3,1,1) = {"
a
a
a
a
a
a
a
a
a
a
a
a
a
a
a
a
a
a
a
a
a
a
a
a
a
a
a
a
a
a
a
a
a
a
a
a
a
a
a
a
a
a
a
a
a
a
a
a
a
a
a
a
a
a
a
a
a
a
a
a
a
a
a
a
a
a
a
a
a
a
"}
(4,1,1) = {"
a
a
a
a
a
a
a
a
a
a
a
a
a
a
a
a
a
a
a
a
a
a
a
a
a
a
a
a
a
a
a
a
a
a
a
a
a
a
a
a
a
a
a
a
a
a
a
a
a
a
a
a
a
a
a
a
a
a
a
a
a
a
a
a
a
a
a
a
a
a
"}
(5,1,1) = {"
a
a
a
a
a
a
a
a
a
a
a
a
a
a
a
a
a
a
a
a
a
a
a
a
a
a
a
a
a
a
a
a
a
a
a
a
a
a
a
a
a
a
a
a
a
a
a
a
a
a
a
a
a
a
a
a
a
a
a
a
a
a
a
a
a
a
a
a
a
a
"}
(6,1,1) = {"
a
a
a
a
a
a
a
a
a
a
a
a
a
a
a
a
a
a
a
a
a
a
a
a
a
a
a
a
a
a
a
a
a
a
a
a
a
a
a
a
a
a
a
a
a
a
a
a
a
a
a
a
a
a
a
a
a
a
a
a
a
a
a
a
a
a
a
a
a
a
"}
(7,1,1) = {"
a
a
a
a
a
a
a
a
a
a
a
a
a
a
a
a
a
a
a
a
a
a
a
a
a
a
a
a
a
a
a
a
a
a
a
P
P
a
a
a
a
a
a
a
a
a
a
a
a
a
a
a
a
a
a
a
a
a
a
a
a
a
a
a
a
a
a
a
a
a
"}
(8,1,1) = {"
a
a
a
a
a
a
a
a
a
a
a
a
a
a
a
a
a
a
a
a
a
a
a
a
a
a
a
a
a
a
a
a
a
P
P
P
P
P
P
a
a
a
P
P
P
P
a
a
a
a
a
a
a
a
a
a
a
a
a
a
a
a
a
a
a
a
a
a
a
a
"}
(9,1,1) = {"
a
a
a
a
a
a
a
a
a
a
a
a
a
a
a
a
a
a
a
a
a
a
a
a
a
a
a
a
a
a
a
a
P
P
P
P
P
P
P
P
P
P
P
P
P
P
P
a
a
a
a
a
a
a
a
a
a
a
a
a
a
a
a
a
a
a
a
a
a
a
"}
(10,1,1) = {"
a
a
a
a
a
a
a
a
a
a
a
a
a
a
a
a
a
a
a
a
a
a
a
a
a
a
a
a
P
P
P
P
P
P
P
P
P
P
P
P
P
P
P
P
P
P
P
P
P
P
P
a
a
a
a
a
a
a
a
a
a
a
a
a
a
a
a
a
a
a
"}
(11,1,1) = {"
a
a
a
a
a
a
a
a
a
a
a
a
a
a
a
a
a
a
a
a
a
a
a
a
a
a
a
P
P
P
P
P
P
P
P
P
P
P
P
P
P
P
P
P
P
P
P
P
P
P
P
P
P
a
a
a
a
a
a
a
a
a
a
a
a
a
a
a
a
a
"}
(12,1,1) = {"
a
a
a
a
a
a
a
a
a
a
a
a
a
a
a
a
a
a
a
a
a
a
a
a
a
P
P
P
P
P
P
P
P
P
P
P
P
P
P
P
P
P
P
P
P
P
P
P
P
P
P
P
P
P
P
P
a
a
a
a
a
a
a
a
a
a
a
a
a
a
"}
(13,1,1) = {"
a
a
a
a
a
a
a
a
a
a
a
a
a
a
a
a
a
a
a
a
a
a
a
a
P
P
P
P
P
P
P
P
P
P
P
P
P
P
P
P
P
P
P
P
P
P
P
P
P
P
P
P
P
P
P
P
P
a
a
a
a
a
a
a
a
a
a
a
a
a
"}
(14,1,1) = {"
a
a
a
a
a
a
a
a
a
a
a
a
a
a
a
a
a
P
P
P
T
a
a
T
P
P
P
P
P
P
P
P
P
P
P
P
P
P
P
P
P
P
P
P
P
P
P
P
P
P
P
P
P
P
P
P
P
P
a
a
a
a
a
a
a
a
a
a
a
a
"}
(15,1,1) = {"
a
a
a
a
a
a
a
a
a
a
a
a
a
a
a
P
P
P
P
P
T
b
b
T
P
P
P
P
P
P
P
T
T
T
T
T
T
P
P
P
P
P
P
P
P
P
P
P
P
P
P
P
P
P
P
P
P
P
P
a
a
a
a
a
a
a
a
a
a
a
"}
(16,1,1) = {"
a
a
a
a
a
a
a
a
a
a
a
a
a
P
P
P
P
P
P
P
T
c
c
T
P
P
P
P
T
T
T
T
U
U
U
U
T
T
T
T
P
P
P
P
P
P
P
P
P
P
P
P
P
P
P
P
P
P
P
P
a
a
a
a
a
a
a
a
a
a
"}
(17,1,1) = {"
a
a
a
a
a
a
a
a
a
a
a
P
P
P
P
P
P
P
P
P
T
c
c
T
P
P
P
T
T
U
U
U
U
U
U
U
U
U
U
T
T
P
P
P
P
P
P
P
P
P
P
P
P
P
P
P
P
P
P
P
a
a
a
a
a
a
a
a
a
a
"}
(18,1,1) = {"
a
a
a
a
a
a
a
a
a
a
P
P
P
P
P
P
P
P
P
P
T
c
c
T
P
P
T
T
U
U
U
U
U
u
u
u
U
U
U
U
T
T
P
P
P
P
P
P
P
P
P
P
P
P
P
P
P
P
P
P
P
a
a
a
a
a
a
a
a
a
"}
(19,1,1) = {"
a
a
a
a
a
a
a
a
P
P
P
P
P
P
P
P
P
P
P
P
T
c
c
T
T
T
T
U
U
U
U
U
u
u
u
u
u
U
U
U
U
T
P
P
P
P
P
P
P
P
P
P
P
P
P
P
P
P
P
P
P
a
a
a
a
a
a
a
a
a
"}
(20,1,1) = {"
a
a
a
a
a
a
a
P
P
P
P
P
P
P
P
P
P
P
P
P
T
c
c
T
T
U
U
U
U
U
u
u
u
u
u
u
u
u
U
U
U
T
T
P
P
P
P
P
P
P
P
P
P
P
P
P
P
P
P
P
P
a
a
a
a
a
a
a
a
a
"}
(21,1,1) = {"
a
a
a
a
a
a
a
P
P
P
P
P
P
P
P
P
P
P
P
P
T
c
c
T
U
U
U
U
U
u
u
u
u
u
u
u
u
u
u
U
U
U
T
T
P
P
P
P
P
P
P
P
P
P
P
P
P
P
P
P
P
G
a
a
a
a
a
a
a
a
"}
(22,1,1) = {"
a
a
a
a
a
a
P
P
P
P
P
P
P
P
P
P
P
P
P
P
T
b
b
U
U
U
U
U
u
u
u
u
u
u
u
u
u
u
u
u
U
U
U
T
T
P
P
P
P
P
P
P
P
P
P
P
P
P
P
P
P
G
a
a
a
a
a
a
a
a
"}
(23,1,1) = {"
a
a
a
a
a
P
P
P
P
P
P
P
P
P
P
P
P
P
P
P
T
U
U
U
U
U
U
u
u
u
u
u
u
u
u
u
u
u
u
u
u
U
U
U
T
T
T
P
P
P
P
P
P
P
P
P
P
P
P
P
P
P
P
a
a
a
a
a
a
a
"}
(24,1,1) = {"
a
a
a
a
a
P
P
P
P
P
P
P
P
P
P
P
P
P
P
P
T
U
U
U
U
U
u
u
U
B
u
u
u
u
u
u
u
u
u
u
u
u
U
U
U
U
T
T
T
T
T
P
P
P
P
P
P
P
P
P
P
P
P
a
a
a
a
a
a
a
"}
(25,1,1) = {"
a
a
a
a
a
P
P
P
P
P
P
P
P
P
P
P
P
P
P
T
T
U
U
U
U
U
u
u
u
u
u
u
u
u
u
u
u
j
u
u
u
u
u
u
U
U
U
U
U
U
T
T
P
P
P
P
P
P
P
P
P
P
P
a
a
a
a
a
a
a
"}
(26,1,1) = {"
a
a
a
a
P
P
P
P
P
P
P
P
P
P
P
P
P
P
P
T
U
U
U
U
U
U
u
u
u
u
u
u
u
u
u
u
u
u
u
u
u
u
u
u
u
U
U
U
U
U
U
T
P
P
P
P
P
P
P
P
P
P
P
a
a
a
a
a
a
a
"}
(27,1,1) = {"
a
a
a
a
P
P
P
P
P
P
P
P
P
P
P
P
P
P
T
T
U
U
U
U
U
U
U
u
u
u
u
u
u
u
u
u
u
u
u
u
u
u
u
u
u
u
u
U
U
U
U
T
T
P
P
P
P
P
P
P
P
G
a
a
a
a
a
a
a
a
"}
(28,1,1) = {"
a
a
a
P
P
P
P
P
P
P
P
P
P
P
P
P
P
P
T
u
u
U
U
U
U
U
U
u
u
u
u
u
u
u
u
u
u
u
u
u
u
u
u
u
u
B
u
U
U
U
U
U
T
P
P
P
P
P
P
P
P
G
a
a
a
a
a
a
a
a
"}
(29,1,1) = {"
a
a
a
P
P
P
P
P
P
P
P
P
P
P
P
P
P
T
T
u
u
U
U
U
U
U
U
U
U
u
u
u
u
u
u
u
u
u
u
u
u
u
u
u
u
U
u
U
U
U
U
U
T
P
P
P
P
P
P
P
P
G
a
a
a
a
a
a
a
a
"}
(30,1,1) = {"
a
a
a
P
P
P
P
P
P
P
P
P
P
P
P
P
P
T
u
u
u
u
U
U
U
U
U
U
U
U
U
u
u
u
u
u
u
u
u
u
u
u
u
u
u
u
U
U
U
U
U
U
T
T
P
P
P
P
P
P
P
G
a
a
a
a
a
a
a
a
"}
(31,1,1) = {"
a
a
a
P
P
P
P
P
P
P
P
P
P
P
P
P
P
T
u
u
u
u
U
U
U
U
U
U
U
U
U
B
u
u
u
u
u
u
u
u
u
u
u
u
u
U
U
U
U
U
U
U
U
T
P
P
P
P
P
P
P
G
a
a
a
a
a
a
a
a
"}
(32,1,1) = {"
a
a
a
P
P
P
P
P
P
P
P
P
P
P
P
P
T
T
u
u
u
u
U
B
U
U
U
U
U
U
U
U
U
u
u
u
u
u
u
u
u
u
u
u
U
U
U
U
U
U
U
U
U
T
P
P
P
P
P
P
P
G
a
a
a
a
a
a
a
a
"}
(33,1,1) = {"
a
a
a
P
P
P
P
P
P
P
P
P
P
P
P
P
T
u
u
u
u
u
U
U
U
U
U
U
U
U
U
U
U
U
U
u
u
u
u
u
u
u
U
U
U
U
U
U
U
U
U
U
U
T
T
P
P
P
P
P
P
G
a
a
a
a
a
a
a
a
"}
(34,1,1) = {"
a
a
a
P
P
P
P
P
P
P
P
P
P
P
P
P
T
u
u
u
u
u
U
U
U
U
U
U
U
U
U
U
U
U
U
U
u
u
u
u
U
U
U
U
U
U
U
U
U
U
U
U
U
U
T
T
P
P
P
P
P
G
a
a
a
a
a
a
a
a
"}
(35,1,1) = {"
a
a
a
a
P
P
P
P
P
P
P
P
P
P
P
T
T
u
u
u
u
u
U
U
U
U
U
U
U
U
U
U
U
U
U
U
U
U
U
U
U
U
U
U
U
U
U
U
U
U
U
B
U
U
U
T
P
P
P
P
P
G
a
a
a
a
a
a
a
a
"}
(36,1,1) = {"
a
a
a
a
P
P
P
P
P
P
P
P
P
P
T
T
u
u
u
u
u
u
U
U
U
U
U
U
U
U
U
U
U
U
U
U
B
U
U
U
U
U
U
U
U
U
U
U
U
U
U
U
U
U
U
T
T
P
P
P
P
G
a
a
a
a
a
a
a
a
"}
(37,1,1) = {"
a
a
a
a
a
P
P
P
P
P
P
P
P
P
T
u
u
u
u
u
u
u
U
U
U
U
U
U
U
U
U
U
U
U
U
U
U
U
U
U
U
U
U
U
U
B
U
U
U
U
U
U
U
U
U
U
T
T
T
T
T
E
a
a
a
a
a
a
a
a
"}
(38,1,1) = {"
a
a
a
a
a
P
P
P
P
P
P
P
P
P
T
u
u
u
u
u
u
u
U
U
U
U
U
U
U
U
U
U
g
U
U
U
U
U
U
U
U
U
U
U
U
U
U
U
U
U
U
U
U
U
U
U
b
c
c
c
b
a
a
a
a
a
a
a
a
a
"}
(39,1,1) = {"
a
a
a
a
a
P
P
P
P
P
P
P
P
P
T
T
u
u
u
u
u
U
U
U
U
U
U
U
U
U
U
U
U
U
U
U
U
U
U
U
U
U
U
U
U
U
U
U
U
U
U
U
U
U
U
U
b
c
c
c
b
a
a
a
a
a
a
a
a
a
"}
(40,1,1) = {"
a
a
a
a
a
a
P
P
P
P
P
P
P
P
P
T
u
u
u
u
u
U
B
U
U
U
U
U
U
U
U
U
U
U
U
U
U
U
U
U
U
U
U
U
U
U
U
U
U
U
U
U
U
U
U
U
b
c
c
c
b
a
a
a
a
a
a
a
a
a
"}
(41,1,1) = {"
a
a
a
a
a
a
P
P
P
P
P
P
P
P
P
T
u
u
u
u
U
U
U
U
U
U
U
U
U
U
U
u
u
u
U
U
U
U
U
U
U
U
U
U
U
U
U
U
U
U
U
U
U
U
U
U
T
T
T
T
T
a
a
a
a
a
a
a
a
a
"}
(42,1,1) = {"
a
a
a
a
a
a
a
P
P
P
P
P
P
P
P
T
T
u
u
u
U
U
U
U
U
U
U
U
U
U
u
u
u
u
u
u
u
U
U
U
U
U
U
U
U
U
U
U
U
U
U
U
U
U
U
T
T
P
P
P
a
a
a
a
a
a
a
a
a
a
"}
(43,1,1) = {"
a
a
a
a
a
a
a
a
P
P
P
P
P
P
P
P
T
u
u
U
U
U
U
U
U
U
U
U
U
u
u
U
B
u
u
u
u
u
u
U
U
U
U
U
U
U
U
U
U
U
U
U
U
U
T
T
P
P
P
P
P
a
a
a
a
a
a
a
a
a
"}
(44,1,1) = {"
a
a
a
a
a
a
a
a
P
P
P
P
P
P
P
P
T
T
u
U
U
U
U
U
U
U
U
U
u
u
u
u
u
u
u
u
u
u
u
u
u
u
U
U
U
U
U
U
U
U
U
U
U
T
T
P
P
P
P
P
P
a
a
a
a
a
a
a
a
a
"}
(45,1,1) = {"
a
a
a
a
a
a
a
a
a
P
P
P
P
P
P
P
P
T
u
U
U
U
U
U
U
U
U
U
u
u
u
u
u
u
u
u
u
u
u
u
u
u
u
U
U
U
U
U
U
U
U
U
T
T
P
P
P
P
P
P
P
a
a
a
a
a
a
a
a
a
"}
(46,1,1) = {"
a
a
a
a
a
a
a
a
a
a
P
P
P
P
P
P
P
T
T
U
U
U
U
U
U
U
U
U
u
u
u
u
u
u
u
u
u
u
u
u
u
B
u
U
U
U
U
U
B
U
U
T
T
P
P
P
P
P
P
P
P
a
a
a
a
a
a
a
a
a
"}
(47,1,1) = {"
a
a
a
a
a
a
a
a
a
a
a
P
P
P
P
P
P
P
T
U
U
U
U
U
U
U
U
u
u
u
u
u
u
u
u
u
u
u
u
u
u
u
u
U
U
U
U
U
U
U
T
T
P
P
P
P
P
P
P
P
P
a
a
a
a
a
a
a
a
a
"}
(48,1,1) = {"
a
a
a
a
a
a
a
a
a
a
a
a
P
P
P
P
P
P
T
T
U
U
U
U
U
U
U
u
U
u
u
u
u
u
u
u
u
u
u
u
u
u
u
U
U
U
U
U
U
U
T
P
P
P
P
P
P
P
P
P
a
a
a
a
a
a
a
a
a
a
"}
(49,1,1) = {"
a
a
a
a
a
a
a
a
a
a
a
a
a
P
P
P
P
P
P
T
T
U
U
U
U
U
U
u
u
U
B
u
u
u
u
u
u
u
u
u
u
u
u
U
U
U
U
U
U
U
T
P
P
P
P
P
P
P
P
P
a
a
a
a
a
a
a
a
a
a
"}
(50,1,1) = {"
a
a
a
a
a
a
a
a
a
a
a
a
a
P
P
P
P
P
P
P
T
T
U
U
U
U
U
U
u
u
u
u
u
u
u
u
u
u
u
u
u
u
u
U
U
U
U
U
U
T
T
P
P
P
P
P
P
P
P
a
a
a
a
a
a
a
a
a
a
a
"}
(51,1,1) = {"
a
a
a
a
a
a
a
a
a
a
a
a
a
a
P
P
P
P
P
P
P
T
T
U
U
U
U
U
U
u
u
u
u
u
u
u
u
u
u
u
u
u
U
U
U
U
U
U
U
T
P
P
P
P
P
P
P
P
P
a
a
a
a
a
a
a
a
a
a
a
"}
(52,1,1) = {"
a
a
a
a
a
a
a
a
a
a
a
a
a
a
a
P
P
P
P
P
P
P
T
T
U
U
U
U
U
U
u
u
u
u
u
u
u
u
u
u
u
u
U
U
U
U
U
U
U
T
P
P
P
P
P
P
P
P
a
a
a
a
a
a
a
a
a
a
a
a
"}
(53,1,1) = {"
a
a
a
a
a
a
a
a
a
a
a
a
a
a
a
a
P
P
P
P
P
P
P
T
T
T
U
U
U
U
u
u
u
u
u
u
u
u
u
u
u
U
U
U
U
U
U
T
T
T
P
P
P
P
P
P
P
a
a
a
a
a
a
a
a
a
a
a
a
a
"}
(54,1,1) = {"
a
a
a
a
a
a
a
a
a
a
a
a
a
a
a
a
P
P
P
P
P
P
P
P
P
T
T
U
U
U
U
U
u
u
u
U
U
U
B
u
u
U
U
U
U
U
T
T
P
P
P
P
P
P
P
P
P
a
a
a
a
a
a
a
a
a
a
a
a
a
"}
(55,1,1) = {"
a
a
a
a
a
a
a
a
a
a
a
a
a
a
a
a
a
a
P
P
P
P
P
P
P
P
T
T
U
U
U
U
U
U
U
u
u
u
u
u
U
U
U
U
T
T
T
P
P
P
P
P
P
P
P
P
P
a
a
a
a
a
a
a
a
a
a
a
a
a
"}
(56,1,1) = {"
a
a
a
a
a
a
a
a
a
a
a
a
a
a
a
a
a
a
P
P
P
P
P
P
P
P
P
T
T
U
U
U
U
U
U
U
U
U
U
U
U
T
T
T
T
P
P
P
P
P
P
P
P
P
P
P
a
a
a
a
a
a
a
a
a
a
a
a
a
a
"}
(57,1,1) = {"
a
a
a
a
a
a
a
a
a
a
a
a
a
a
a
a
a
a
a
a
P
P
P
P
P
P
P
P
T
T
T
U
U
U
U
U
U
U
T
T
T
T
P
P
P
P
P
P
P
P
P
P
P
P
P
a
a
a
a
a
a
a
a
a
a
a
a
a
a
a
"}
(58,1,1) = {"
a
a
a
a
a
a
a
a
a
a
a
a
a
a
a
a
a
a
a
a
a
a
P
P
P
P
P
P
P
P
T
T
T
b
b
T
T
T
T
P
P
P
P
P
P
P
P
P
P
P
P
P
a
a
a
a
a
a
a
a
a
a
a
a
a
a
a
a
a
a
"}
(59,1,1) = {"
a
a
a
a
a
a
a
a
a
a
a
a
a
a
a
a
a
a
a
a
a
a
a
a
P
P
P
P
P
P
P
P
T
c
c
T
P
P
P
P
P
P
P
P
P
P
P
P
P
P
a
a
a
a
a
a
a
a
a
a
a
a
a
a
a
a
a
a
a
a
"}
(60,1,1) = {"
a
a
a
a
a
a
a
a
a
a
a
a
a
a
a
a
a
a
a
a
a
a
a
a
a
a
P
P
P
P
P
P
T
c
c
T
P
P
P
P
P
P
P
P
P
P
P
P
P
P
a
a
a
a
a
a
a
a
a
a
a
a
a
a
a
a
a
a
a
a
"}
(61,1,1) = {"
a
a
a
a
a
a
a
a
a
a
a
a
a
a
a
a
a
a
a
a
a
a
a
a
a
a
a
P
P
P
P
P
T
c
c
T
P
P
P
P
P
P
P
P
P
P
P
P
a
a
a
a
a
a
a
a
a
a
a
a
a
a
a
a
a
a
a
a
a
a
"}
(62,1,1) = {"
a
a
a
a
a
a
a
a
a
a
a
a
a
a
a
a
a
a
a
a
a
a
a
a
a
a
a
a
a
P
P
P
T
c
c
T
P
P
P
P
P
P
a
a
a
a
a
a
a
a
a
a
a
a
a
a
a
a
a
a
a
a
a
a
a
a
a
a
a
a
"}
(63,1,1) = {"
a
a
a
a
a
a
a
a
a
a
a
a
a
a
a
a
a
a
a
a
a
a
a
a
a
a
a
a
a
a
P
P
T
c
c
T
P
P
P
P
a
a
a
a
a
a
a
a
a
a
a
a
a
a
a
a
a
a
a
a
a
a
a
a
a
a
a
a
a
a
"}
(64,1,1) = {"
a
a
a
a
a
a
a
a
a
a
a
a
a
a
a
a
a
a
a
a
a
a
a
a
a
a
a
a
a
a
a
a
T
b
b
T
a
a
a
a
a
a
a
a
a
a
a
a
a
a
a
a
a
a
a
a
a
a
a
a
a
a
a
a
a
a
a
a
a
a
"}
(65,1,1) = {"
a
a
a
a
a
a
a
a
a
a
a
a
a
a
a
a
a
a
a
a
a
a
a
a
a
a
a
a
a
a
a
a
a
a
a
a
a
a
a
a
a
a
a
a
a
a
a
a
a
a
a
a
a
a
a
a
a
a
a
a
a
a
a
a
a
a
a
a
a
a
"}
(66,1,1) = {"
a
a
a
a
a
a
a
a
a
a
a
a
a
a
a
a
a
a
a
a
a
a
a
a
a
a
a
a
a
a
a
a
a
a
a
a
a
a
a
a
a
a
a
a
a
a
a
a
a
a
a
a
a
a
a
a
a
a
a
a
a
a
a
a
a
a
a
a
a
a
"}
(67,1,1) = {"
a
a
a
a
a
a
a
a
a
a
a
a
a
a
a
a
a
a
a
a
a
a
a
a
a
a
a
a
a
a
a
a
a
a
a
a
a
a
a
a
a
a
a
a
a
a
a
a
a
a
a
a
a
a
a
a
a
a
a
a
a
a
a
a
a
a
a
a
a
a
"}
(68,1,1) = {"
a
a
a
a
a
a
a
a
a
a
a
a
a
a
a
a
a
a
a
a
a
a
a
a
a
a
a
a
a
a
a
a
a
a
a
a
a
a
a
a
a
a
a
a
a
a
a
a
a
a
a
a
a
a
a
a
a
a
a
a
a
a
a
a
a
a
a
a
a
a
"}
(69,1,1) = {"
a
a
a
a
a
a
a
a
a
a
a
a
a
a
a
a
a
a
a
a
a
a
a
a
a
a
a
a
a
a
a
a
a
a
a
a
a
a
a
a
a
a
a
a
a
a
a
a
a
a
a
a
a
a
a
a
a
a
a
a
a
a
a
a
a
a
a
a
a
a
"}
(70,1,1) = {"
a
a
a
a
a
a
a
a
a
a
a
a
a
a
a
a
a
a
a
a
a
a
a
a
a
a
a
a
a
a
a
a
a
a
a
a
a
a
a
a
a
a
a
a
a
a
a
a
a
a
a
a
a
a
a
a
a
a
a
a
a
a
a
a
a
a
a
a
a
a
"}
