//MAP CONVERTED BY dmm2tgm.py THIS HEADER COMMENT PREVENTS RECONVERSION, DO NOT REMOVE
"ap" = (
/turf/simulated/floor/airless,
/area/submap/turretedoutpost)
"bT" = (
/obj/item/reagent_containers/food/drinks/bottle/vodka{
	pixel_x = -4;
	pixel_y = 4
	},
/obj/item/reagent_containers/food/drinks/bottle/vodka{
	pixel_x = 3
	},
/obj/structure/table/woodentable,
/turf/simulated/floor/tiled/asteroid_steel{
	temperature = 293.15
	},
/area/submap/turretedoutpost)
"ck" = (
/obj/machinery/door/blast/regular{
	closed_layer = 2
	},
/obj/machinery/door/airlock/vault/bolted,
/turf/simulated/floor/airless,
/area/submap/turretedoutpost)
"cN" = (
/obj/random/multiple/large_corp_crate,
/turf/simulated/floor/tiled/techfloor,
/area/submap/turretedoutpost)
"dH" = (
/obj/machinery/light{
	dir = 1
	},
/obj/machinery/atmospherics/unary/vent_pump/high_volume{
	dir = 1;
	frequency = 1380;
	id_tag = "turretpost_pump"
	},
/obj/machinery/embedded_controller/radio/airlock/airlock_controller{
	id_tag = "turretpost_airlock";
	pixel_y = 25;
	tag_airpump = "turretpost_pump";
	tag_chamber_sensor = "turretpost_sensor";
	tag_exterior_door = "turretpost_outer";
	tag_interior_door = "turretpost_inner"
	},
/turf/simulated/floor/plating,
/area/submap/turretedoutpost)
"dL" = (
/obj/structure/cable{
	icon_state = "1-2"
	},
/turf/simulated/floor/tiled/asteroid_steel{
	temperature = 293.15
	},
/area/submap/turretedoutpost)
"eb" = (
/obj/structure/grille,
/turf/simulated/floor/plating,
/area/submap/turretedoutpost)
"eK" = (
/obj/structure/largecrate/animal/chick,
/turf/simulated/floor/tiled/techfloor,
/area/submap/turretedoutpost)
"gb" = (
/obj/machinery/atmospherics/portables_connector,
/obj/machinery/portable_atmospherics/canister/air/airlock,
/obj/effect/floor_decal/industrial/outline/yellow,
/turf/simulated/floor/tiled/asteroid_steel{
	icon_state = "dark"
	},
/area/submap/turretedoutpost)
"gq" = (
/obj/machinery/access_button{
	command = "cycle_interior";
	frequency = 1379;
	master_tag = "turretpost_airlock";
	name = "interior access button";
	pixel_x = 25
	},
/obj/machinery/atmospherics/pipe/manifold/hidden{
	dir = 8
	},
/turf/simulated/floor/tiled/asteroid_steel{
	temperature = 293.15
	},
/area/submap/turretedoutpost)
"gL" = (
/obj/structure/cable{
	icon_state = "0-8"
	},
/obj/machinery/power/smes/buildable/point_of_interest,
/turf/simulated/floor/tiled/asteroid_steel{
	temperature = 293.15
	},
/area/submap/turretedoutpost)
"gQ" = (
/obj/structure/bed,
/obj/item/bedsheet/orange,
/turf/simulated/floor/tiled/asteroid_steel{
	temperature = 293.15
	},
/area/submap/turretedoutpost)
"hG" = (
/obj/structure/largecrate/animal/fennec,
/turf/simulated/floor/tiled/techfloor,
/area/submap/turretedoutpost)
"hJ" = (
/obj/structure/table/reinforced,
/obj/item/clipboard,
/obj/machinery/light{
	dir = 1
	},
/obj/item/radio,
/turf/simulated/floor/tiled/asteroid_steel{
	icon_state = "dark"
	},
/area/submap/turretedoutpost)
"id" = (
/turf/template_noop,
/area/template_noop)
"iv" = (
/obj/structure/table/reinforced,
/obj/structure/reagent_dispensers/peppertank{
	pixel_y = 32
	},
/turf/simulated/floor/tiled/asteroid_steel{
	icon_state = "dark"
	},
/area/submap/turretedoutpost)
"iG" = (
/obj/machinery/atmospherics/pipe/simple/hidden,
/turf/simulated/wall/r_wall,
/area/submap/turretedoutpost)
"jc" = (
/obj/machinery/atmospherics/unary/vent_pump/high_volume{
	frequency = 1380;
	id_tag = "turretpost_pump"
	},
/turf/simulated/floor/plating,
/area/submap/turretedoutpost)
"jX" = (
/obj/structure/salvageable/console_os,
/obj/machinery/atmospherics/pipe/simple/hidden{
	dir = 5
	},
/turf/simulated/floor/tiled/asteroid_steel{
	temperature = 293.15
	},
/area/submap/turretedoutpost)
"ll" = (
/obj/machinery/door/airlock/glass_external{
	frequency = 1379;
	icon_state = "door_locked";
	id_tag = "turretpost_inner";
	locked = 1;
	name = "Internal Airlock Access"
	},
/turf/simulated/floor/plating,
/area/submap/turretedoutpost)
"lo" = (
/obj/machinery/atmospherics/pipe/manifold/hidden,
/turf/simulated/wall/r_wall,
/area/submap/turretedoutpost)
"lL" = (
/obj/structure/table/rack/shelf/steel,
/obj/item/clothing/suit/armor/laserproof,
/obj/item/clothing/gloves/arm_guard/laserproof,
/obj/item/clothing/shoes/leg_guard/laserproof,
/obj/item/clothing/head/helmet/laserproof,
/obj/item/gun/energy/gun/etommy,
/turf/simulated/floor/tiled/techfloor,
/area/submap/turretedoutpost)
"lR" = (
/obj/machinery/light{
	dir = 1
	},
/obj/random/multiple/large_corp_crate,
/turf/simulated/floor/tiled/techfloor,
/area/submap/turretedoutpost)
"mf" = (
/obj/machinery/door/airlock,
/turf/simulated/floor/airless,
/area/submap/turretedoutpost)
"mo" = (
/obj/structure/salvageable/computer,
/turf/simulated/floor/tiled/asteroid_steel{
	temperature = 293.15
	},
/area/submap/turretedoutpost)
"mH" = (
/obj/structure/dispenser/oxygen,
/turf/simulated/floor/tiled/techfloor,
/area/submap/turretedoutpost)
"nC" = (
/obj/structure/table/reinforced,
/obj/item/pen/blue,
/turf/simulated/floor/tiled/asteroid_steel{
	icon_state = "dark"
	},
/area/submap/turretedoutpost)
"nV" = (
/obj/structure/largecrate/animal/cat/bones,
/turf/simulated/floor/tiled/techfloor,
/area/submap/turretedoutpost)
"pi" = (
/obj/machinery/light/small{
	dir = 8
	},
/turf/simulated/floor/airless,
/area/submap/turretedoutpost)
"pQ" = (
/obj/structure/filingcabinet,
/turf/simulated/floor/tiled/asteroid_steel{
	temperature = 293.15
	},
/area/submap/turretedoutpost)
"qq" = (
/obj/machinery/light,
/turf/simulated/floor/tiled/asteroid_steel{
	temperature = 293.15
	},
/area/submap/turretedoutpost)
"qE" = (
/obj/machinery/atmospherics/pipe/manifold/hidden,
/obj/effect/floor_decal/industrial/warning{
	dir = 1
	},
/turf/simulated/floor/tiled/asteroid_steel{
	temperature = 293.15
	},
/area/submap/turretedoutpost)
"rp" = (
/obj/structure/table/reinforced,
/obj/item/paper/crumpled,
/turf/simulated/floor/tiled/asteroid_steel{
	icon_state = "dark"
	},
/area/submap/turretedoutpost)
"sa" = (
/obj/machinery/door/airlock/external{
	frequency = 1379;
	icon_state = "door_locked";
	id_tag = "turretpost_outer";
	locked = 1;
	name = "External Airlock Access"
	},
/turf/simulated/floor/plating,
/area/submap/turretedoutpost)
"sb" = (
/turf/simulated/floor/tiled/asteroid_steel{
	temperature = 293.15
	},
/area/submap/turretedoutpost)
"sG" = (
/obj/machinery/light{
	dir = 1
	},
/obj/machinery/atmospherics/pipe/simple/hidden,
/turf/simulated/floor/tiled/asteroid_steel{
	temperature = 293.15
	},
/area/submap/turretedoutpost)
"tm" = (
/obj/machinery/atmospherics/pipe/simple/hidden{
	dir = 9
	},
/turf/simulated/wall/r_wall,
/area/submap/turretedoutpost)
"tS" = (
/obj/structure/bed/chair/comfy/black{
	dir = 4
	},
/mob/living/simple_mob/humanoid/merc/melee/sword/space,
/turf/simulated/floor/tiled/asteroid_steel{
	temperature = 293.15
	},
/area/submap/turretedoutpost)
"up" = (
/obj/machinery/power/apc{
	dir = 1;
	name = "north bump";
	pixel_y = 24
	},
/obj/structure/cable{
	icon_state = "0-2"
	},
/turf/simulated/floor/tiled/asteroid_steel{
	temperature = 293.15
	},
/area/submap/turretedoutpost)
"wu" = (
/obj/structure/cable{
	icon_state = "4-8"
	},
/turf/simulated/floor/tiled/asteroid_steel{
	temperature = 293.15
	},
/area/submap/turretedoutpost)
"wx" = (
/obj/item/grenade/chem_grenade/teargas,
/obj/structure/table/rack/shelf/steel,
/obj/item/grenade/confetti,
/obj/item/grenade/confetti,
/obj/item/grenade/confetti,
/obj/item/grenade/supermatter,
/obj/item/grenade/supermatter,
/obj/item/grenade/smokebomb,
/obj/item/grenade/smokebomb,
/turf/simulated/floor/tiled/techfloor,
/area/submap/turretedoutpost)
"wy" = (
/obj/machinery/atmospherics/pipe/manifold/hidden{
	dir = 1
	},
/turf/simulated/wall/r_wall,
/area/submap/turretedoutpost)
"xn" = (
/obj/structure/table/rack/shelf/steel,
/obj/item/clothing/shoes/leg_guard/bulletproof,
/obj/item/clothing/suit/armor/bulletproof/alt,
/obj/item/clothing/gloves/arm_guard/bulletproof,
/obj/item/clothing/head/helmet/bulletproof,
/obj/item/gun/projectile/automatic/bullpup,
/turf/simulated/floor/tiled/techfloor,
/area/submap/turretedoutpost)
"xx" = (
/obj/structure/table/reinforced,
/obj/machinery/light,
/obj/item/storage/box/syndie_kit/spy,
/turf/simulated/floor/tiled/asteroid_steel{
	icon_state = "dark"
	},
/area/submap/turretedoutpost)
"zz" = (
/obj/machinery/atmospherics/pipe/simple/hidden{
	dir = 4
	},
/obj/effect/floor_decal/industrial/warning/corner{
	dir = 4
	},
/turf/simulated/floor/tiled/asteroid_steel{
	temperature = 293.15
	},
/area/submap/turretedoutpost)
"Bl" = (
/turf/simulated/floor/airless,
/area/template_noop)
"Cu" = (
/obj/structure/grille,
/turf/simulated/floor/airless,
/area/submap/turretedoutpost)
"DU" = (
/obj/structure/bed/chair,
/mob/living/simple_mob/humanoid/merc/ranged/technician/poi,
/turf/simulated/floor/tiled/asteroid_steel{
	temperature = 293.15
	},
/area/submap/turretedoutpost)
"Ef" = (
/obj/structure/lattice,
/turf/template_noop,
/area/template_noop)
"Em" = (
/turf/simulated/wall/r_wall,
/area/submap/turretedoutpost)
"Et" = (
/obj/structure/bed/chair{
	dir = 8;
	icon_state = "chair"
	},
/mob/living/simple_mob/humanoid/merc/ranged/space/heavy,
/turf/simulated/floor/tiled/asteroid_steel{
	temperature = 293.15
	},
/area/submap/turretedoutpost)
"Ey" = (
/turf/simulated/floor/tiled/asteroid_steel{
	icon_state = "dark"
	},
/area/submap/turretedoutpost)
"EA" = (
/obj/random/multiple/random_size_crate,
/turf/simulated/floor/tiled/techfloor,
/area/submap/turretedoutpost)
"EN" = (
/obj/machinery/porta_turret/industrial,
/turf/simulated/floor/plating,
/area/submap/turretedoutpost)
"Ff" = (
/obj/structure/bed,
/obj/item/bedsheet/orange,
/obj/machinery/light{
	dir = 4
	},
/turf/simulated/floor/tiled/asteroid_steel{
	temperature = 293.15
	},
/area/submap/turretedoutpost)
"Gf" = (
/obj/structure/table/rack/shelf/steel,
/obj/item/clothing/suit/armor/laserproof,
/obj/item/clothing/gloves/arm_guard/laserproof,
/obj/item/clothing/shoes/leg_guard/laserproof,
/obj/item/clothing/head/helmet/laserproof,
/obj/item/gun/energy/lasershotgun,
/turf/simulated/floor/tiled/techfloor,
/area/submap/turretedoutpost)
"GJ" = (
/obj/machinery/door/airlock,
/obj/structure/cable{
	icon_state = "1-2"
	},
/turf/simulated/floor/airless,
/area/submap/turretedoutpost)
"IG" = (
/obj/machinery/atmospherics/pipe/simple/hidden,
/turf/simulated/floor/tiled/asteroid_steel{
	temperature = 293.15
	},
/area/submap/turretedoutpost)
"IR" = (
/obj/structure/table/reinforced,
/turf/simulated/floor/tiled/asteroid_steel{
	temperature = 293.15
	},
/area/submap/turretedoutpost)
"Kr" = (
/obj/machinery/atmospherics/pipe/simple/hidden{
	dir = 6
	},
/turf/simulated/wall/r_wall,
/area/submap/turretedoutpost)
"Lc" = (
/mob/living/simple_mob/humanoid/merc/melee/sword/space,
/turf/simulated/floor/tiled/asteroid_steel{
	temperature = 293.15
	},
/area/submap/turretedoutpost)
"Lf" = (
/obj/machinery/access_button{
	command = "cycle_exterior";
	frequency = 1379;
	master_tag = "turretpost_airlock";
	name = "exterior access button";
	pixel_x = -25
	},
/turf/simulated/floor/airless,
/area/submap/turretedoutpost)
"MH" = (
/obj/machinery/atmospherics/pipe/simple/hidden{
	dir = 10
	},
/turf/simulated/wall/r_wall,
/area/submap/turretedoutpost)
"MR" = (
/obj/structure/salvageable/machine,
/turf/simulated/floor/tiled/asteroid_steel{
	temperature = 293.15
	},
/area/submap/turretedoutpost)
"Ne" = (
/obj/item/reagent_containers/food/snacks/beetsoup,
/obj/machinery/light{
	dir = 8
	},
/obj/structure/table/woodentable,
/turf/simulated/floor/tiled/asteroid_steel{
	temperature = 293.15
	},
/area/submap/turretedoutpost)
"OZ" = (
/turf/simulated/floor/plating,
/area/submap/turretedoutpost)
"Pm" = (
/obj/machinery/porta_turret/industrial,
/turf/simulated/floor/airless,
/area/submap/turretedoutpost)
"Qg" = (
/mob/living/simple_mob/humanoid/merc/ranged/space/shotgun/auto,
/turf/simulated/floor/tiled/asteroid_steel{
	icon_state = "dark"
	},
/area/submap/turretedoutpost)
"Qt" = (
/obj/structure/salvageable/server,
/turf/simulated/floor/tiled/asteroid_steel{
	temperature = 293.15
	},
/area/submap/turretedoutpost)
"QG" = (
/obj/structure/cable{
	icon_state = "2-8"
	},
/turf/simulated/floor/tiled/asteroid_steel{
	temperature = 293.15
	},
/area/submap/turretedoutpost)
"Rj" = (
/obj/machinery/light,
/obj/random/multiple/random_size_crate,
/turf/simulated/floor/tiled/techfloor,
/area/submap/turretedoutpost)
"UE" = (
/obj/structure/table/reinforced,
/obj/item/paper_bin,
/turf/simulated/floor/tiled/asteroid_steel{
	icon_state = "dark"
	},
/area/submap/turretedoutpost)
"UN" = (
/obj/machinery/airlock_sensor{
	id_tag = "turretpost_sensor";
	pixel_y = 25
	},
/obj/machinery/atmospherics/unary/vent_pump/high_volume{
	dir = 1;
	frequency = 1380;
	id_tag = "turretpost_pump"
	},
/turf/simulated/floor/plating,
/area/submap/turretedoutpost)
"VS" = (
/obj/machinery/atmospherics/pipe/simple/hidden{
	dir = 9
	},
/obj/effect/floor_decal/industrial/warning{
	dir = 1
	},
/turf/simulated/floor/tiled/asteroid_steel{
	temperature = 293.15
	},
/area/submap/turretedoutpost)
"Wq" = (
/mob/living/simple_mob/humanoid/merc/ranged/technician/poi,
/turf/simulated/floor/tiled/asteroid_steel{
	temperature = 293.15
	},
/area/submap/turretedoutpost)
"WR" = (
/obj/structure/table/reinforced,
/obj/item/clothing/head/ushanka,
/turf/simulated/floor/tiled/asteroid_steel{
	icon_state = "dark"
	},
/area/submap/turretedoutpost)
"WY" = (
/obj/structure/largecrate/animal/corgi,
/turf/simulated/floor/tiled/techfloor,
/area/submap/turretedoutpost)
"Yg" = (
/obj/structure/cable{
	icon_state = "1-4"
	},
/turf/simulated/floor/tiled/asteroid_steel{
	temperature = 293.15
	},
/area/submap/turretedoutpost)
"Yo" = (
/obj/machinery/atmospherics/pipe/simple/hidden{
	dir = 4
	},
/turf/simulated/wall/r_wall,
/area/submap/turretedoutpost)
"YN" = (
/obj/structure/table/rack/shelf/steel,
/obj/item/clothing/shoes/leg_guard/bulletproof,
/obj/item/clothing/suit/armor/bulletproof/alt,
/obj/item/clothing/gloves/arm_guard/bulletproof,
/obj/item/clothing/head/helmet/bulletproof,
/obj/item/gun/projectile/shotgun/pump/USDF,
/turf/simulated/floor/tiled/techfloor,
/area/submap/turretedoutpost)
"ZE" = (
/obj/structure/table/reinforced,
/obj/item/folder,
/obj/item/radio,
/turf/simulated/floor/tiled/asteroid_steel{
	temperature = 293.15
	},
/area/submap/turretedoutpost)

(1,1,1) = {"
id
id
id
id
id
id
id
id
id
id
id
id
Ef
Ef
Ef
id
Ef
id
id
"}
(2,1,1) = {"
id
id
id
id
id
id
id
id
ap
ap
Cu
Cu
Cu
Cu
ap
ap
Ef
Ef
id
"}
(3,1,1) = {"
id
id
id
id
id
id
id
ap
Pm
Em
Em
Em
Em
Em
Em
Pm
ap
Ef
Ef
"}
(4,1,1) = {"
id
id
id
id
id
id
id
ap
Em
Em
lL
Gf
YN
xn
Em
Em
ap
Ef
id
"}
(5,1,1) = {"
id
id
id
Ef
Ef
Ef
Ef
ap
Em
cN
Ey
Ey
Ey
Ey
EA
Em
Cu
Ef
id
"}
(6,1,1) = {"
id
id
id
id
id
Ef
id
Cu
Em
cN
Qg
nV
eK
Qg
EA
Em
Cu
Ef
Ef
"}
(7,1,1) = {"
id
id
id
id
Ef
Ef
id
Cu
Em
lR
Ey
WY
hG
Ey
Rj
Em
Cu
id
id
"}
(8,1,1) = {"
id
id
id
Ef
Ef
Ef
id
Cu
Em
cN
Ey
Ey
Ey
Ey
EA
Em
ap
Ef
id
"}
(9,1,1) = {"
id
id
id
Ef
id
Ef
id
Cu
Em
Em
mH
Ey
Ey
wx
Em
Em
ap
Ef
id
"}
(10,1,1) = {"
id
id
id
id
Pm
ap
Cu
eb
eb
Em
Em
ck
ck
Em
Em
Pm
ap
Ef
id
"}
(11,1,1) = {"
id
id
id
id
ap
Em
Em
Em
Em
Em
WR
sb
sb
rp
Em
ap
Ef
Ef
Ef
"}
(12,1,1) = {"
id
id
id
id
eb
Em
IR
ZE
pQ
Em
iv
Wq
sb
xx
Em
ap
Ef
id
id
"}
(13,1,1) = {"
id
id
id
id
eb
Em
mo
Et
qq
Em
hJ
sb
DU
UE
Em
ap
id
id
id
"}
(14,1,1) = {"
id
id
id
id
eb
Em
MR
sb
sb
mf
sb
sb
sb
nC
Em
OZ
EN
Ef
Ef
"}
(15,1,1) = {"
id
id
id
Ef
eb
Em
Qt
sb
sb
Em
Em
Em
Em
Em
Em
Em
OZ
Ef
id
"}
(16,1,1) = {"
id
id
id
id
eb
Em
up
dL
dL
GJ
dL
Yg
tS
bT
Ne
Em
eb
Ef
Ef
"}
(17,1,1) = {"
id
id
id
Ef
eb
Kr
sG
IG
gq
iG
jX
QG
dL
dL
Yg
Em
eb
id
id
"}
(18,1,1) = {"
id
id
Ef
id
eb
Yo
ll
ll
Yo
Em
zz
sb
Lc
sb
wu
Em
eb
id
id
"}
(19,1,1) = {"
id
id
Ef
Ef
eb
wy
dH
jc
lo
gb
qE
Ff
gQ
gQ
gL
Em
eb
id
id
"}
(20,1,1) = {"
id
id
id
Ef
eb
MH
UN
jc
tm
gb
VS
Em
Em
Em
Em
Em
eb
Ef
Ef
"}
(21,1,1) = {"
id
id
Ef
Ef
OZ
Em
sa
sa
Em
Em
Em
Em
Cu
eb
eb
eb
Pm
id
Ef
"}
(22,1,1) = {"
id
id
id
Ef
Pm
Lf
ap
ap
pi
Pm
Bl
Bl
Bl
Ef
Ef
id
id
id
id
"}
(23,1,1) = {"
id
Ef
Ef
Ef
Ef
Ef
id
id
Ef
Ef
Ef
Ef
id
Ef
id
id
id
id
id
"}
