//MAP CONVERTED BY dmm2tgm.py THIS HEADER COMMENT PREVENTS RECONVERSION, DO NOT REMOVE
"a" = (
/turf/template_noop,
/area/template_noop)
"b" = (
/turf/simulated/mineral/vacuum,
/area/submap/way_home)
"c" = (
/obj/item/instrument/trombone/spectral,
/obj/item/clothing/suit/skeleton,
/turf/simulated/mineral/floor/vacuum,
/area/submap/way_home)
"e" = (
/obj/structure/loot_pile/surface/bones,
/turf/simulated/mineral/floor/vacuum,
/area/submap/way_home)
"s" = (
/turf/simulated/mineral/floor/vacuum,
/area/submap/way_home)
"E" = (
/obj/item/clothing/mask/smokable/pipe/bonepipe,
/turf/simulated/mineral/floor/vacuum,
/area/submap/way_home)
"J" = (
/obj/structure/signpost,
/turf/simulated/mineral/floor/vacuum,
/area/submap/way_home)

(1,1,1) = {"
a
a
a
a
a
a
a
a
a
a
a
a
a
a
a
a
a
a
a
a
a
a
a
a
a
a
a
a
a
a
"}
(2,1,1) = {"
a
a
a
a
a
a
a
a
a
a
a
a
a
a
a
a
a
a
a
a
a
a
a
a
a
a
a
a
a
a
"}
(3,1,1) = {"
a
a
a
a
a
a
a
a
a
a
a
a
a
a
a
a
a
a
a
a
a
a
a
a
b
b
a
a
a
a
"}
(4,1,1) = {"
a
a
a
a
a
a
a
a
a
a
a
a
a
a
a
a
a
a
a
a
a
a
a
a
b
b
b
a
a
a
"}
(5,1,1) = {"
a
a
a
a
a
a
a
a
a
a
a
a
a
a
a
a
a
a
a
a
a
a
a
a
a
b
a
a
a
a
"}
(6,1,1) = {"
a
a
a
a
a
a
a
a
a
a
a
a
a
a
a
a
a
a
a
a
a
a
a
a
a
a
a
a
a
a
"}
(7,1,1) = {"
a
a
a
a
a
a
a
a
a
a
a
a
b
b
a
a
a
a
a
a
a
a
a
a
a
a
a
a
a
a
"}
(8,1,1) = {"
a
a
a
a
a
a
a
a
a
a
b
b
b
b
b
b
a
a
a
a
a
a
a
a
a
a
a
a
a
a
"}
(9,1,1) = {"
a
a
a
a
a
a
a
a
a
b
b
b
b
b
b
b
a
a
a
a
a
a
a
a
a
a
a
a
a
a
"}
(10,1,1) = {"
a
a
a
a
a
a
a
b
b
b
b
b
b
b
b
a
a
a
a
a
a
a
a
a
a
a
a
a
a
a
"}
(11,1,1) = {"
a
a
a
a
b
a
b
b
b
b
b
b
b
b
s
a
a
a
a
a
a
a
a
a
a
a
a
a
a
a
"}
(12,1,1) = {"
a
a
a
a
b
b
b
b
b
b
b
b
b
b
s
s
a
a
a
a
a
a
a
a
a
a
a
a
a
a
"}
(13,1,1) = {"
a
a
a
a
b
b
b
b
b
b
b
b
b
s
s
s
a
a
a
a
a
a
a
a
a
a
a
a
a
a
"}
(14,1,1) = {"
a
a
a
b
b
b
b
b
b
b
b
b
b
s
s
s
s
s
s
a
a
a
a
a
a
a
a
a
a
a
"}
(15,1,1) = {"
a
a
b
b
b
b
b
b
b
b
b
s
s
s
s
s
s
s
E
s
s
a
a
a
a
a
b
a
a
a
"}
(16,1,1) = {"
a
a
a
b
b
b
b
b
b
b
c
s
s
a
a
s
s
J
e
s
s
s
s
s
a
b
b
a
a
a
"}
(17,1,1) = {"
a
a
a
a
b
b
b
b
b
b
b
s
a
a
a
a
s
s
s
s
s
s
b
b
b
b
a
a
a
a
"}
(18,1,1) = {"
a
a
a
a
b
b
b
b
b
b
b
a
a
a
a
a
a
s
s
s
b
b
b
b
b
b
a
a
a
a
"}
(19,1,1) = {"
a
a
a
a
b
b
a
a
b
b
b
a
a
a
a
a
a
a
s
s
s
b
b
b
b
b
a
a
a
a
"}
(20,1,1) = {"
a
a
a
a
a
a
a
a
a
b
a
a
a
a
a
a
a
a
a
s
s
s
b
b
b
b
b
a
a
a
"}
(21,1,1) = {"
a
a
a
a
a
a
a
a
a
a
a
a
a
a
a
a
a
a
a
a
a
s
b
b
b
b
b
a
a
a
"}
(22,1,1) = {"
a
a
a
a
a
a
a
a
a
a
a
a
a
a
a
a
a
a
a
a
a
a
a
b
b
b
b
a
a
a
"}
(23,1,1) = {"
a
a
a
a
a
a
a
a
a
a
a
a
a
a
a
a
a
a
a
a
a
a
a
a
b
b
a
a
a
a
"}
(24,1,1) = {"
a
a
a
a
a
a
a
a
a
a
a
a
a
a
a
a
a
a
a
a
a
a
a
a
a
b
b
a
a
a
"}
(25,1,1) = {"
a
a
a
a
a
a
a
a
a
a
a
a
a
a
a
a
a
a
a
a
a
a
a
a
a
a
a
a
a
a
"}
(26,1,1) = {"
a
a
a
a
a
a
a
a
a
a
a
a
a
a
a
a
a
a
a
a
a
a
a
a
a
a
a
a
a
a
"}
(27,1,1) = {"
a
a
a
a
a
a
a
a
a
a
a
a
a
a
a
a
a
a
a
a
a
a
a
a
a
a
a
a
a
a
"}
(28,1,1) = {"
a
a
a
a
a
a
a
a
a
a
a
a
a
a
a
a
a
a
a
a
a
a
a
a
a
a
a
a
a
a
"}
(29,1,1) = {"
a
a
a
a
a
a
a
a
a
a
a
a
a
a
a
a
a
a
a
a
a
a
a
a
a
a
a
a
a
a
"}
(30,1,1) = {"
a
a
a
a
a
a
a
a
a
a
a
a
a
a
a
a
a
a
a
a
a
a
a
a
a
a
a
a
a
a
"}
