//MAP CONVERTED BY dmm2tgm.py THIS HEADER COMMENT PREVENTS RECONVERSION, DO NOT REMOVE
"ab" = (
/obj/structure/table/rack,
/obj/item/clothing/suit/space/syndicate,
/obj/item/clothing/head/helmet/space/syndicate,
/obj/item/clothing/mask/breath,
/turf/simulated/floor/tiled/eris/white/techfloor,
/area/shuttle/whiteship)
"al" = (
/obj/item/device/multitool,
/turf/simulated/floor/tiled/eris/white/techfloor,
/area/shuttle/whiteship)
"aJ" = (
/obj/machinery/atmospherics/pipe/simple/hidden{
	dir = 6
	},
/turf/simulated/wall/rthull,
/area/shuttle/whiteship)
"bI" = (
/obj/machinery/light{
	dir = 8
	},
/turf/simulated/floor/tiled/eris/white/techfloor,
/area/shuttle/whiteship)
"bX" = (
/obj/random/junk,
/turf/simulated/floor/tiled/techmaint,
/area/shuttle/whiteship)
"co" = (
/obj/machinery/sleep_console,
/turf/simulated/floor/tiled/techmaint,
/area/shuttle/whiteship)
"cv" = (
/obj/effect/decal/cleanable/dirt,
/obj/random/trash,
/turf/simulated/floor/tiled/eris/steel/techfloor_grid,
/area/shuttle/whiteship)
"cA" = (
/obj/machinery/door/blast/regular{
	id = "oldship_gun";
	name = "Pod Bay Door"
	},
/turf/simulated/floor/plating,
/area/shuttle/whiteship)
"cR" = (
/obj/structure/bed/chair,
/turf/simulated/floor/tiled/eris/white/techfloor,
/area/shuttle/whiteship)
"cS" = (
/obj/structure/cable,
/obj/structure/frame/computer,
/obj/item/stack/cable_coil/cut,
/turf/simulated/floor/tiled/eris/white/techfloor,
/area/shuttle/whiteship)
"cT" = (
/obj/structure/table/standard,
/obj/effect/decal/cleanable/dirt,
/obj/item/device/analyzer,
/turf/simulated/floor/tiled/eris/steel/techfloor_grid,
/area/shuttle/whiteship)
"dw" = (
/obj/structure/salvageable/console_broken_os{
	dir = 4
	},
/turf/simulated/floor/tiled/eris/white/techfloor,
/area/shuttle/whiteship)
"dZ" = (
/obj/effect/decal/cleanable/dirt,
/obj/structure/salvageable/console_broken_os{
	dir = 1
	},
/turf/simulated/floor/tiled/eris/steel/techfloor_grid,
/area/shuttle/whiteship)
"en" = (
/obj/structure/bed/chair/bay/comfy/green{
	dir = 8
	},
/obj/effect/decal/cleanable/dirt,
/turf/simulated/floor/tiled/eris/steel/techfloor_grid,
/area/shuttle/whiteship)
"es" = (
/mob/living/simple_mob/metroid/juvenile/alpha,
/obj/effect/decal/cleanable/dirt,
/turf/simulated/floor/tiled/eris/steel/techfloor_grid,
/area/shuttle/whiteship)
"ew" = (
/turf/simulated/floor/tiled/eris/white/techfloor,
/area/shuttle/whiteship)
"eG" = (
/obj/machinery/atmospherics/pipe/manifold/visible{
	dir = 8
	},
/turf/simulated/wall/rthull,
/area/shuttle/whiteship)
"eN" = (
/obj/effect/decal/cleanable/dirt,
/obj/random/junk,
/turf/simulated/floor/tiled/techfloor/grid,
/area/shuttle/whiteship)
"eV" = (
/obj/random/trash,
/turf/simulated/floor/tiled/techfloor/grid,
/area/shuttle/whiteship)
"eY" = (
/obj/machinery/portable_atmospherics/powered/scrubber,
/turf/simulated/floor/tiled/eris/white/techfloor,
/area/shuttle/whiteship)
"fr" = (
/obj/structure/cable{
	d1 = 1;
	d2 = 8;
	icon_state = "1-8"
	},
/turf/simulated/floor/tiled/eris/white/techfloor,
/area/shuttle/whiteship)
"fu" = (
/obj/effect/decal/cleanable/dirt,
/turf/simulated/floor/tiled/eris/white/techfloor,
/area/submap/whiteship)
"fw" = (
/obj/machinery/atmospherics/unary/vent_pump/high_volume{
	frequency = 1380;
	id_tag = "white_ship_pump";
	dir = 8
	},
/obj/structure/cable{
	d1 = 1;
	d2 = 2;
	icon_state = "1-2"
	},
/turf/simulated/floor/tiled/eris/white/techfloor,
/area/shuttle/whiteship)
"fH" = (
/obj/random/junk,
/turf/simulated/floor/tiled/techfloor/grid,
/area/shuttle/whiteship)
"fR" = (
/turf/template_noop,
/area/template_noop)
"go" = (
/obj/machinery/atmospherics/portables_connector{
	dir = 4
	},
/obj/machinery/portable_atmospherics/canister/air/airlock,
/turf/simulated/floor/tiled/techmaint,
/area/shuttle/whiteship)
"gr" = (
/obj/item/weapon/surgical/scalpel,
/obj/effect/decal/cleanable/dirt,
/turf/simulated/floor/tiled/techmaint,
/area/shuttle/whiteship)
"gC" = (
/turf/simulated/floor/tiled/eris/steel/techfloor_grid,
/area/shuttle/whiteship)
"gJ" = (
/turf/simulated/wall/rthull,
/area/submap/whiteship)
"gK" = (
/obj/structure/table/standard,
/obj/random/maintenance/medical,
/turf/simulated/floor/tiled/eris/white/techfloor,
/area/shuttle/whiteship)
"gV" = (
/obj/machinery/door/window/northright,
/turf/simulated/floor/tiled/techmaint,
/area/shuttle/whiteship)
"hc" = (
/turf/template_noop,
/area/shuttle/whiteship)
"hM" = (
/obj/effect/decal/cleanable/dirt,
/obj/random/junk,
/turf/simulated/floor/tiled/eris/white/techfloor,
/area/shuttle/whiteship)
"ir" = (
/obj/effect/decal/cleanable/dirt,
/turf/simulated/floor/tiled/eris/white/techfloor,
/area/shuttle/whiteship)
"kz" = (
/obj/machinery/atmospherics/pipe/simple/hidden/yellow{
	dir = 10
	},
/turf/simulated/wall/rthull,
/area/shuttle/whiteship)
"lo" = (
/obj/effect/decal/cleanable/dirt,
/obj/random/trash,
/turf/simulated/floor/tiled/techfloor/grid,
/area/submap/whiteship)
"lx" = (
/obj/machinery/atmospherics/pipe/manifold/hidden/yellow{
	dir = 8
	},
/turf/simulated/wall/rthull,
/area/shuttle/whiteship)
"lR" = (
/obj/effect/landmark/loot_spawn/low,
/obj/effect/decal/cleanable/dirt,
/turf/simulated/floor/tiled/eris/white/techfloor,
/area/submap/whiteship)
"lW" = (
/obj/machinery/atmospherics/pipe/simple/hidden{
	dir = 10
	},
/turf/simulated/wall/rthull,
/area/shuttle/whiteship)
"mI" = (
/obj/effect/decal/cleanable/dirt,
/obj/random/junk,
/turf/simulated/floor/tiled/techfloor/grid,
/area/submap/whiteship)
"mL" = (
/obj/effect/decal/cleanable/dirt,
/turf/simulated/floor/tiled/techmaint,
/area/shuttle/whiteship)
"mO" = (
/mob/living/simple_mob/humanoid/merc/melee,
/obj/random/gun/random,
/obj/effect/decal/cleanable/dirt,
/turf/simulated/floor/tiled/techmaint,
/area/shuttle/whiteship)
"nm" = (
/obj/effect/decal/cleanable/dirt,
/obj/random/junk,
/turf/simulated/floor/tiled/eris/steel/techfloor_grid,
/area/shuttle/whiteship)
"nP" = (
/obj/machinery/power/apc{
	dir = 8;
	name = "west bump-derelict";
	operating = 0;
	pixel_x = -24
	},
/obj/structure/cable{
	d2 = 4;
	icon_state = "0-4"
	},
/turf/simulated/floor/tiled/eris/white/techfloor,
/area/shuttle/whiteship)
"od" = (
/mob/living/simple_mob/metroid/juvenile/baby,
/obj/effect/decal/cleanable/dirt,
/obj/random/trash,
/obj/random/trash,
/turf/simulated/floor/tiled/techfloor/grid,
/area/shuttle/whiteship)
"of" = (
/obj/structure/table,
/turf/simulated/floor/tiled/eris/white/techfloor,
/area/submap/whiteship)
"og" = (
/mob/living/simple_mob/metroid/juvenile/baby,
/obj/random/handgun/sec,
/turf/simulated/floor/tiled/techmaint,
/area/shuttle/whiteship)
"oh" = (
/obj/effect/decal/cleanable/dirt,
/obj/random/trash,
/turf/simulated/floor/tiled/techmaint,
/area/shuttle/whiteship)
"ok" = (
/obj/item/weapon/bedsheet,
/obj/structure/window/reinforced{
	dir = 1
	},
/obj/structure/window/reinforced{
	dir = 4
	},
/obj/structure/bed/padded,
/turf/simulated/floor/tiled/techmaint,
/area/shuttle/whiteship)
"pE" = (
/obj/machinery/door/airlock/glass{
	name = "Pod Bay"
	},
/turf/simulated/floor/tiled/techmaint,
/area/shuttle/whiteship)
"pU" = (
/obj/effect/decal/cleanable/dirt,
/obj/random/trash,
/mob/living/simple_mob/metroid/juvenile/zeta,
/turf/simulated/floor/tiled/techfloor/grid,
/area/shuttle/whiteship)
"qz" = (
/obj/effect/decal/cleanable/dirt,
/turf/simulated/floor/tiled/techfloor/grid,
/area/submap/whiteship)
"qP" = (
/mob/living/simple_mob/humanoid/merc/melee,
/obj/random/gun/random,
/turf/simulated/floor/tiled/techfloor/grid,
/area/shuttle/whiteship)
"rk" = (
/turf/simulated/floor/tiled/techfloor/grid,
/area/shuttle/whiteship)
"ry" = (
/mob/living/simple_mob/humanoid/merc/melee,
/obj/effect/decal/cleanable/dirt,
/turf/simulated/floor/tiled/eris/steel/techfloor_grid,
/area/shuttle/whiteship)
"sj" = (
/turf/simulated/floor/tiled/techfloor/grid,
/area/submap/whiteship)
"sn" = (
/obj/random/junk,
/turf/simulated/floor/tiled/eris/steel/techfloor_grid,
/area/shuttle/whiteship)
"tb" = (
/obj/item/weapon/cell{
	charge = 100;
	maxcharge = 15000
	},
/obj/structure/cable{
	d2 = 8;
	icon_state = "0-8"
	},
/obj/machinery/power/terminal,
/obj/structure/cable{
	d1 = 4;
	d2 = 8;
	icon_state = "4-8"
	},
/turf/simulated/floor/tiled/eris/white/techfloor,
/area/shuttle/whiteship)
"tc" = (
/obj/effect/decal/cleanable/dirt,
/obj/structure/bed/chair/bay/comfy/green{
	dir = 8
	},
/turf/simulated/floor/tiled/eris/steel/techfloor_grid,
/area/shuttle/whiteship)
"tf" = (
/turf/simulated/floor/plating,
/area/shuttle/whiteship)
"tg" = (
/obj/effect/decal/cleanable/dirt,
/mob/living/simple_mob/metroid/juvenile/omega,
/turf/simulated/floor/tiled/techfloor/grid,
/area/shuttle/whiteship)
"tK" = (
/obj/item/weapon/material/shard,
/obj/structure/bed/chair,
/turf/simulated/floor/tiled/eris/white/techfloor,
/area/shuttle/whiteship)
"us" = (
/obj/machinery/door/airlock/glass,
/turf/simulated/floor/tiled/techmaint,
/area/shuttle/whiteship)
"uz" = (
/obj/machinery/light_switch{
	pixel_x = 27
	},
/turf/simulated/floor/tiled/techmaint,
/area/shuttle/whiteship)
"uA" = (
/obj/machinery/atmospherics/pipe/simple/hidden/yellow{
	dir = 5
	},
/turf/simulated/wall/rthull,
/area/shuttle/whiteship)
"uD" = (
/obj/effect/decal/cleanable/dirt,
/turf/simulated/floor/tiled/eris/steel/techfloor_grid,
/area/shuttle/whiteship)
"va" = (
/obj/random/trash,
/obj/structure/cable{
	d1 = 1;
	d2 = 2;
	icon_state = "1-2"
	},
/turf/simulated/floor/tiled/eris/white/techfloor,
/area/shuttle/whiteship)
"vc" = (
/obj/effect/landmark/loot_spawn/low,
/turf/simulated/floor/tiled/eris/white/techfloor,
/area/submap/whiteship)
"vf" = (
/mob/living/simple_mob/metroid/juvenile/super,
/turf/simulated/floor/tiled/eris/white/techfloor,
/area/shuttle/whiteship)
"vQ" = (
/obj/machinery/atmospherics/unary/engine{
	dir = 8
	},
/turf/template_noop,
/area/shuttle/whiteship)
"wd" = (
/obj/machinery/computer/pod{
	dir = 1;
	id = "oldship_gun"
	},
/turf/simulated/floor/tiled/eris/white/techfloor,
/area/shuttle/whiteship)
"ww" = (
/obj/structure/cable,
/obj/structure/frame/computer,
/turf/simulated/floor/tiled/eris/white/techfloor,
/area/shuttle/whiteship)
"wx" = (
/obj/effect/decal/cleanable/dirt,
/obj/effect/decal/cleanable/dirt,
/turf/simulated/floor/tiled/techfloor/grid,
/area/shuttle/whiteship)
"wD" = (
/turf/simulated/wall/rthull,
/area/shuttle/whiteship)
"xq" = (
/obj/machinery/atmospherics/pipe/simple/hidden/yellow{
	dir = 6
	},
/turf/simulated/floor/plating,
/area/shuttle/whiteship)
"xw" = (
/obj/structure/table/rack,
/obj/item/weapon/tank/emergency/oxygen,
/obj/item/weapon/tank/emergency/oxygen,
/obj/item/weapon/tank/emergency/oxygen,
/obj/item/weapon/tank/emergency/oxygen,
/turf/simulated/floor/tiled/eris/white/techfloor,
/area/shuttle/whiteship)
"yw" = (
/obj/structure/frame/computer,
/turf/simulated/floor/tiled/eris/white/techfloor,
/area/shuttle/whiteship)
"yA" = (
/obj/machinery/door/airlock/voidcraft/survival_pod,
/obj/structure/cable{
	d1 = 1;
	d2 = 2;
	icon_state = "1-2"
	},
/turf/simulated/floor/tiled/eris/white/techfloor,
/area/shuttle/whiteship)
"ze" = (
/obj/machinery/atmospherics/pipe/simple/hidden/yellow{
	dir = 6
	},
/turf/simulated/wall/rthull,
/area/shuttle/whiteship)
"zt" = (
/obj/structure/shuttle/engine/heater{
	dir = 4
	},
/obj/structure/window/reinforced{
	dir = 8
	},
/turf/simulated/floor/airless,
/area/shuttle/whiteship)
"zR" = (
/obj/random/handgun/sec,
/obj/structure/table/standard,
/turf/simulated/floor/tiled/eris/steel/techfloor_grid,
/area/shuttle/whiteship)
"zT" = (
/mob/living/simple_mob/metroid/juvenile/baby,
/obj/effect/decal/cleanable/dirt,
/obj/random/trash,
/turf/simulated/floor/tiled/techmaint,
/area/shuttle/whiteship)
"zY" = (
/obj/item/weapon/cell{
	charge = 100;
	maxcharge = 15000
	},
/obj/random/trash,
/turf/simulated/floor/tiled/eris/white/techfloor,
/area/shuttle/whiteship)
"An" = (
/obj/structure/table/standard,
/obj/item/device/radio/off,
/obj/random/maintenance/engineering,
/obj/random/maintenance/engineering,
/turf/simulated/floor/tiled/eris/white/techfloor,
/area/shuttle/whiteship)
"Ap" = (
/obj/effect/decal/cleanable/dirt,
/obj/structure/salvageable/console_broken_os{
	dir = 2
	},
/turf/simulated/floor/tiled/eris/steel/techfloor_grid,
/area/shuttle/whiteship)
"At" = (
/obj/effect/landmark/loot_spawn/low,
/turf/simulated/floor/tiled/eris/white/techfloor,
/area/shuttle/whiteship)
"AQ" = (
/obj/machinery/door/airlock/glass,
/turf/simulated/floor/plating,
/area/shuttle/whiteship)
"Bq" = (
/obj/structure/lattice,
/obj/item/stack/rods,
/turf/template_noop,
/area/submap/whiteship)
"Br" = (
/obj/structure/shuttle/window,
/obj/structure/grille,
/turf/simulated/floor/plating,
/area/shuttle/whiteship)
"Cd" = (
/mob/living/simple_mob/humanoid/merc/melee,
/turf/simulated/floor/tiled/techmaint,
/area/shuttle/whiteship)
"Cr" = (
/obj/machinery/atmospherics/pipe/manifold/visible{
	dir = 2
	},
/turf/simulated/wall/rthull,
/area/shuttle/whiteship)
"Dc" = (
/obj/machinery/door/window,
/turf/simulated/floor/tiled/techmaint,
/area/shuttle/whiteship)
"Em" = (
/obj/machinery/door/airlock/glass,
/turf/simulated/floor/tiled/eris/white/techfloor,
/area/shuttle/whiteship)
"Es" = (
/obj/machinery/door/airlock/glass{
	welded = 1
	},
/turf/simulated/floor/tiled/eris/white/techfloor,
/area/shuttle/whiteship)
"Ex" = (
/obj/structure/cable{
	d1 = 1;
	d2 = 2;
	icon_state = "1-2"
	},
/turf/simulated/floor/tiled/eris/white/techfloor,
/area/shuttle/whiteship)
"EE" = (
/obj/structure/lattice,
/turf/template_noop,
/area/submap/whiteship)
"EF" = (
/obj/structure/table/standard,
/turf/simulated/floor/tiled/eris/white/techfloor,
/area/shuttle/whiteship)
"EM" = (
/obj/machinery/light{
	dir = 1
	},
/turf/simulated/floor/tiled/eris/white/techfloor,
/area/shuttle/whiteship)
"Fn" = (
/obj/effect/decal/cleanable/dirt,
/mob/living/simple_mob/metroid/juvenile/super,
/turf/simulated/floor/tiled/eris/white/techfloor,
/area/shuttle/whiteship)
"FB" = (
/obj/structure/lattice,
/obj/structure/lattice,
/turf/template_noop,
/area/submap/whiteship)
"FT" = (
/obj/machinery/portable_atmospherics/canister/oxygen,
/turf/simulated/floor/tiled/eris/white/techfloor,
/area/shuttle/whiteship)
"Gy" = (
/obj/machinery/mass_driver{
	dir = 8;
	id = "oldship_gun"
	},
/turf/simulated/floor/plating,
/area/shuttle/whiteship)
"GA" = (
/obj/effect/decal/cleanable/dirt,
/mob/living/simple_mob/metroid/juvenile/super,
/turf/simulated/floor/tiled/techfloor/grid,
/area/submap/whiteship)
"GV" = (
/obj/random/gun/random,
/obj/effect/decal/cleanable/dirt,
/turf/simulated/floor/tiled/techfloor/grid,
/area/shuttle/whiteship)
"Hi" = (
/obj/effect/landmark/loot_spawn/low,
/obj/effect/decal/cleanable/dirt,
/turf/simulated/floor/tiled/eris/white/techfloor,
/area/shuttle/whiteship)
"Hl" = (
/obj/machinery/atmospherics/pipe/simple/hidden/yellow{
	dir = 5
	},
/turf/simulated/floor/plating,
/area/shuttle/whiteship)
"HM" = (
/obj/machinery/light_switch{
	pixel_x = 27
	},
/obj/machinery/light{
	dir = 4
	},
/turf/simulated/floor/tiled/eris/white/techfloor,
/area/shuttle/whiteship)
"HY" = (
/obj/machinery/door/airlock/glass{
	name = "Hibernation Pods"
	},
/obj/effect/decal/cleanable/dirt,
/obj/effect/decal/cleanable/dirt,
/turf/simulated/floor/tiled/techmaint,
/area/shuttle/whiteship)
"IB" = (
/obj/structure/table/standard,
/obj/machinery/light{
	dir = 4
	},
/obj/random/maintenance/medical,
/turf/simulated/floor/tiled/eris/white/techfloor,
/area/shuttle/whiteship)
"IK" = (
/obj/effect/decal/cleanable/dirt,
/turf/simulated/floor/tiled/techfloor/grid,
/area/shuttle/whiteship)
"Jb" = (
/turf/simulated/floor/tiled/techmaint,
/area/shuttle/whiteship)
"Jy" = (
/obj/effect/decal/cleanable/dirt,
/obj/effect/decal/cleanable/dirt,
/obj/random/trash,
/obj/random/junk,
/turf/simulated/floor/tiled/techfloor/grid,
/area/shuttle/whiteship)
"Jz" = (
/obj/machinery/atmospherics/pipe/simple/hidden/yellow{
	dir = 9
	},
/turf/simulated/wall/rthull,
/area/shuttle/whiteship)
"JU" = (
/obj/machinery/atmospherics/portables_connector{
	dir = 1
	},
/obj/machinery/portable_atmospherics/canister/phoron/cold,
/turf/simulated/floor/tiled/eris/white/techfloor,
/area/shuttle/whiteship)
"KK" = (
/obj/machinery/atmospherics/pipe/manifold/hidden/yellow,
/turf/simulated/floor/plating,
/area/shuttle/whiteship)
"Lg" = (
/obj/random/junk,
/turf/simulated/floor/tiled/eris/white/techfloor,
/area/submap/whiteship)
"LD" = (
/obj/random/trash,
/turf/simulated/floor/tiled/techmaint,
/area/shuttle/whiteship)
"LH" = (
/turf/simulated/floor/tiled/eris/white/techfloor,
/area/submap/whiteship)
"LW" = (
/obj/item/weapon/material/shard{
	icon_state = "medium"
	},
/turf/simulated/floor/tiled/eris/white/techfloor,
/area/shuttle/whiteship)
"Ma" = (
/obj/item/weapon/banner/solgov,
/obj/effect/decal/cleanable/dirt,
/turf/simulated/floor/tiled/techfloor/grid,
/area/submap/whiteship)
"Md" = (
/obj/structure/table/standard,
/obj/item/weapon/storage/firstaid/regular{
	pixel_x = 6;
	pixel_y = -5
	},
/obj/random/maintenance/medical,
/obj/random/maintenance/medical,
/obj/random/maintenance/medical,
/obj/random/trash,
/turf/simulated/floor/tiled/techmaint,
/area/shuttle/whiteship)
"Mi" = (
/obj/random/junk,
/turf/simulated/floor/tiled/eris/white/techfloor,
/area/shuttle/whiteship)
"MK" = (
/obj/machinery/light_switch{
	pixel_x = 27
	},
/obj/structure/cable{
	d1 = 1;
	d2 = 2;
	icon_state = "1-2"
	},
/turf/simulated/floor/tiled/eris/white/techfloor,
/area/shuttle/whiteship)
"Nc" = (
/obj/item/stack/rods,
/turf/template_noop,
/area/submap/whiteship)
"Nk" = (
/obj/machinery/light{
	dir = 1
	},
/obj/machinery/sleeper{
	dir = 8
	},
/turf/simulated/floor/tiled/techmaint,
/area/shuttle/whiteship)
"Nq" = (
/obj/structure/table/standard,
/obj/item/weapon/tank/oxygen,
/turf/simulated/floor/tiled/techmaint,
/area/shuttle/whiteship)
"NE" = (
/obj/structure/table/rack,
/obj/item/weapon/storage/toolbox/syndicate,
/turf/simulated/floor/tiled/eris/white/techfloor,
/area/shuttle/whiteship)
"QH" = (
/obj/machinery/power/smes/buildable/point_of_interest,
/turf/simulated/floor/tiled/eris/white/techfloor,
/area/shuttle/whiteship)
"RB" = (
/obj/machinery/atmospherics/pipe/manifold/hidden/yellow{
	dir = 8
	},
/turf/simulated/floor/plating,
/area/shuttle/whiteship)
"So" = (
/obj/structure/table/standard,
/obj/item/weapon/tool/screwdriver,
/obj/machinery/light,
/obj/random/maintenance/engineering,
/obj/random/maintenance/engineering,
/obj/random/maintenance/engineering,
/turf/simulated/floor/tiled/eris/white/techfloor,
/area/shuttle/whiteship)
"Su" = (
/obj/structure/table/standard,
/obj/random/maintenance/medical,
/obj/random/maintenance/medical,
/obj/random/maintenance/medical,
/turf/simulated/floor/tiled/eris/white/techfloor,
/area/shuttle/whiteship)
"Sw" = (
/obj/effect/decal/cleanable/dirt,
/obj/random/trash,
/turf/simulated/floor/tiled/eris/white/techfloor,
/area/shuttle/whiteship)
"TC" = (
/mob/living/simple_mob/metroid/juvenile/baby,
/obj/effect/decal/cleanable/dirt,
/turf/simulated/floor/tiled/techfloor/grid,
/area/shuttle/whiteship)
"TS" = (
/obj/structure/bed/chair{
	dir = 1
	},
/turf/simulated/floor/tiled/eris/white/techfloor,
/area/shuttle/whiteship)
"Uq" = (
/obj/item/weapon/bedsheet,
/obj/structure/window/reinforced{
	dir = 8
	},
/obj/structure/window/reinforced,
/obj/structure/bed/padded,
/turf/simulated/floor/tiled/techmaint,
/area/shuttle/whiteship)
"UA" = (
/obj/effect/decal/cleanable/dirt,
/obj/random/junk,
/turf/simulated/floor/tiled/techmaint,
/area/shuttle/whiteship)
"Vu" = (
/obj/structure/salvageable/console_broken_os{
	dir = 4
	},
/obj/item/weapon/paper{
	info = "Soontm"
	},
/turf/simulated/floor/tiled/eris/white/techfloor,
/area/shuttle/whiteship)
"Vz" = (
/obj/machinery/computer/med_data{
	dir = 4
	},
/turf/simulated/floor/tiled/techmaint,
/area/shuttle/whiteship)
"VC" = (
/mob/living/simple_mob/metroid/juvenile/alpha,
/turf/simulated/floor/tiled/eris/steel/techfloor_grid,
/area/shuttle/whiteship)
"Wt" = (
/obj/machinery/light/small{
	dir = 8
	},
/turf/simulated/floor/tiled/techmaint,
/area/shuttle/whiteship)
"Wx" = (
/obj/structure/cable{
	d1 = 4;
	d2 = 8;
	icon_state = "4-8"
	},
/turf/simulated/floor/tiled/techfloor/grid,
/area/shuttle/whiteship)
"WO" = (
/obj/machinery/atmospherics/pipe/manifold/hidden/yellow{
	dir = 1
	},
/turf/simulated/floor/plating,
/area/shuttle/whiteship)
"Xs" = (
/obj/effect/decal/cleanable/dirt,
/obj/structure/cable{
	d1 = 1;
	d2 = 2;
	icon_state = "1-2"
	},
/turf/simulated/floor/tiled/eris/white/techfloor,
/area/shuttle/whiteship)
"Xy" = (
/mob/living/simple_mob/metroid/juvenile/baby,
/obj/effect/decal/cleanable/dirt,
/obj/effect/decal/cleanable/dirt,
/turf/simulated/floor/tiled/techfloor/grid,
/area/shuttle/whiteship)
"XK" = (
/obj/machinery/atmospherics/portables_connector,
/obj/machinery/portable_atmospherics/canister/phoron/cold,
/turf/simulated/floor/tiled/eris/white/techfloor,
/area/shuttle/whiteship)
"YV" = (
/obj/machinery/door/airlock/glass,
/turf/simulated/floor/tiled/eris/white/techfloor,
/area/submap/whiteship)

(1,1,1) = {"
fR
fR
fR
fR
fR
fR
fR
fR
fR
fR
fR
fR
fR
fR
fR
fR
fR
fR
fR
fR
fR
fR
fR
fR
fR
fR
fR
fR
fR
fR
"}
(2,1,1) = {"
fR
fR
fR
fR
fR
fR
fR
fR
fR
fR
fR
fR
fR
fR
fR
fR
fR
fR
fR
fR
fR
fR
fR
fR
fR
fR
fR
fR
fR
fR
"}
(3,1,1) = {"
fR
fR
fR
fR
fR
fR
fR
fR
fR
fR
fR
fR
fR
fR
fR
fR
fR
fR
fR
fR
fR
fR
fR
fR
fR
fR
fR
fR
fR
fR
"}
(4,1,1) = {"
fR
fR
fR
fR
fR
fR
fR
fR
fR
wD
wD
wD
Br
Br
Br
Br
Br
Br
Br
wD
wD
fR
fR
fR
fR
fR
fR
fR
fR
fR
"}
(5,1,1) = {"
fR
fR
fR
fR
fR
fR
fR
fR
wD
wD
ew
ew
EF
dw
Vu
dw
EF
ew
ew
LW
wD
wD
fR
fR
fR
fR
fR
fR
fR
fR
"}
(6,1,1) = {"
fR
fR
fR
fR
fR
fR
fR
wD
wD
ew
ew
VC
Ap
tc
cT
en
dZ
sn
ew
tK
ww
wD
cA
wD
fR
fR
fR
fR
fR
fR
"}
(7,1,1) = {"
fR
fR
fR
fR
fR
fR
wD
wD
wD
yw
TS
uD
nm
ry
zR
uD
uD
uD
ir
cR
cS
wD
Gy
wD
fR
fR
fR
fR
fR
fR
"}
(8,1,1) = {"
fR
fR
fR
fR
fR
fR
wD
Vz
wD
wD
ew
gC
uD
cv
gC
es
uD
uD
Sw
ew
wD
wD
Em
wD
wD
fR
fR
fR
fR
fR
"}
(9,1,1) = {"
fR
fR
fR
fR
fR
wD
wD
LD
Jb
wD
gK
Su
IB
ew
ew
ew
ew
ew
HM
wD
wD
wD
ew
wd
wD
wD
fR
fR
fR
fR
"}
(10,1,1) = {"
fR
fR
fR
fR
fR
wD
Jb
UA
mL
wD
wD
wD
wD
wD
Br
Em
Br
wD
wD
wD
wD
ew
ew
ew
wD
wD
fR
fR
fR
fR
"}
(11,1,1) = {"
fR
fR
fR
fR
fR
wD
Jb
Xy
oh
Br
al
ir
ir
ir
hM
ir
ew
ew
wD
wD
xw
ir
mL
ir
ew
wD
fR
fR
fR
fR
"}
(12,1,1) = {"
fR
fR
fR
fR
fR
wD
Nk
GV
mL
Br
ew
IK
IK
IK
IK
rk
rk
rk
rk
wD
ab
mL
UA
mO
So
wD
fR
fR
fR
fR
"}
(13,1,1) = {"
fR
fR
fR
fR
fR
wD
co
IK
gr
Br
zY
rk
wD
wD
wD
wD
wD
wD
rk
wD
NE
Fn
zT
ir
An
wD
fR
fR
fR
fR
"}
(14,1,1) = {"
fR
fR
fR
fR
fR
wD
Jb
Jb
mL
HY
ir
TC
us
Jb
Wt
Cd
gV
wD
rk
wD
wD
ew
ew
ew
wD
wD
fR
fR
fR
fR
"}
(15,1,1) = {"
fR
fR
fR
fR
fR
wD
wD
Md
mL
wD
hM
IK
wD
Uq
Nq
og
ok
wD
rk
wD
wD
wD
pE
wD
wD
wD
fR
fR
fR
fR
"}
(16,1,1) = {"
fR
fR
fR
fR
fR
fR
wD
go
go
wD
ew
rk
wD
Dc
uz
Jb
bX
us
rk
ew
nP
Mi
ew
wD
wD
fR
fR
fR
fR
fR
"}
(17,1,1) = {"
fR
fR
fR
fR
fR
fR
wD
lW
Cr
wD
ew
IK
wD
wD
wD
wD
wD
wD
rk
rk
Wx
ir
ew
wD
wD
fR
fR
fR
fR
fR
"}
(18,1,1) = {"
fR
fR
fR
fR
fR
wD
aJ
eG
Cr
wD
ew
IK
fH
IK
tg
eV
IK
Xy
wx
rk
tb
QH
wD
wD
fR
fR
fR
fR
fR
fR
"}
(19,1,1) = {"
fR
fR
fR
fR
fR
yA
fw
fw
fw
yA
Ex
Ex
MK
va
Ex
Ex
Ex
Xs
Xs
Ex
fr
wD
wD
fR
fR
fR
fR
fR
fR
fR
"}
(20,1,1) = {"
fR
fR
fR
fR
fR
wD
wD
wD
wD
wD
AQ
wD
wD
wD
Br
Em
Br
wD
wD
wD
AQ
wD
wD
fR
fR
fR
fR
fR
fR
fR
"}
(21,1,1) = {"
fR
fR
fR
fR
fR
fR
fR
wD
wD
tf
xq
lx
JU
bI
ew
ew
ew
bI
XK
lx
Hl
tf
wD
wD
fR
fR
fR
fR
fR
fR
"}
(22,1,1) = {"
fR
fR
fR
fR
fR
fR
ze
lx
RB
RB
KK
kz
JU
vf
ir
IK
Mi
ew
XK
Jz
WO
RB
RB
lx
uA
fR
fR
fR
fR
fR
"}
(23,1,1) = {"
fR
fR
fR
fR
fR
wD
zt
zt
zt
zt
zt
wD
wD
ew
IK
od
qP
ew
wD
wD
zt
zt
zt
zt
zt
wD
fR
fR
fR
fR
"}
(24,1,1) = {"
fR
fR
fR
fR
fR
wD
vQ
vQ
vQ
vQ
vQ
hc
wD
eY
Mi
rk
ir
ew
wD
hc
vQ
vQ
vQ
vQ
vQ
wD
fR
fR
fR
fR
"}
(25,1,1) = {"
fR
fR
fR
fR
fR
fR
fR
fR
fR
fR
fR
fR
wD
wD
ew
ew
ir
wD
wD
fR
fR
fR
fR
fR
fR
fR
fR
fR
fR
fR
"}
(26,1,1) = {"
fR
fR
fR
fR
fR
fR
fR
fR
fR
fR
fR
fR
fR
wD
wD
Em
wD
wD
fR
fR
fR
fR
fR
fR
fR
fR
fR
fR
fR
fR
"}
(27,1,1) = {"
fR
fR
fR
fR
fR
fR
fR
fR
fR
fR
fR
fR
fR
fR
wD
ew
wD
fR
fR
fR
fR
fR
fR
fR
fR
fR
fR
fR
fR
fR
"}
(28,1,1) = {"
fR
fR
fR
fR
fR
fR
fR
fR
fR
fR
fR
fR
fR
wD
wD
Em
wD
wD
fR
fR
fR
fR
fR
fR
fR
fR
fR
fR
fR
fR
"}
(29,1,1) = {"
fR
fR
fR
fR
fR
fR
fR
fR
fR
fR
fR
fR
EE
wD
ew
ir
ir
wD
fR
fR
fR
fR
fR
fR
fR
fR
fR
fR
fR
fR
"}
(30,1,1) = {"
fR
fR
fR
fR
fR
fR
fR
fR
fR
fR
fR
fR
EE
wD
ew
Jy
ir
wD
fR
fR
fR
fR
fR
fR
fR
fR
fR
fR
fR
fR
"}
(31,1,1) = {"
fR
fR
fR
fR
fR
fR
fR
fR
fR
fR
Nc
fR
Nc
wD
At
TC
At
wD
fR
fR
fR
fR
fR
fR
fR
fR
fR
fR
fR
fR
"}
(32,1,1) = {"
fR
fR
fR
fR
fR
fR
fR
fR
fR
fR
fR
fR
fR
wD
ew
IK
At
wD
fR
fR
fR
fR
fR
fR
fR
fR
fR
fR
fR
fR
"}
(33,1,1) = {"
fR
fR
fR
fR
fR
fR
fR
fR
fR
fR
fR
fR
EE
wD
EM
pU
ir
wD
fR
fR
fR
fR
fR
fR
fR
fR
fR
fR
fR
fR
"}
(34,1,1) = {"
fR
fR
fR
fR
fR
fR
fR
fR
fR
fR
fR
Nc
EE
wD
ew
eN
Hi
wD
fR
fR
fR
fR
fR
fR
fR
fR
fR
fR
fR
fR
"}
(35,1,1) = {"
fR
fR
fR
fR
fR
fR
fR
fR
fR
fR
fR
fR
fR
wD
At
IK
ir
wD
fR
fR
Nc
fR
fR
fR
fR
fR
fR
fR
fR
fR
"}
(36,1,1) = {"
fR
fR
fR
fR
fR
fR
fR
fR
fR
fR
fR
fR
fR
wD
ew
rk
FT
wD
fR
fR
fR
fR
fR
fR
fR
fR
fR
fR
fR
fR
"}
(37,1,1) = {"
fR
fR
fR
fR
fR
fR
fR
fR
fR
fR
fR
fR
fR
wD
ew
ew
ew
wD
fR
fR
fR
fR
fR
fR
fR
fR
fR
fR
fR
fR
"}
(38,1,1) = {"
fR
fR
fR
fR
fR
fR
fR
fR
fR
fR
fR
fR
fR
wD
wD
Es
wD
wD
EE
EE
fR
fR
fR
fR
fR
fR
fR
fR
fR
fR
"}
(39,1,1) = {"
fR
fR
fR
fR
fR
fR
fR
fR
fR
fR
fR
fR
fR
fR
EE
EE
EE
fR
fR
Nc
fR
fR
fR
fR
fR
fR
fR
fR
fR
fR
"}
(40,1,1) = {"
fR
fR
fR
fR
fR
fR
fR
fR
fR
fR
fR
fR
fR
fR
fR
fR
EE
Nc
FB
Nc
fR
fR
fR
fR
fR
fR
fR
fR
fR
fR
"}
(41,1,1) = {"
fR
fR
fR
fR
fR
fR
fR
fR
fR
fR
fR
fR
fR
EE
Nc
EE
EE
EE
fR
fR
EE
EE
fR
fR
fR
fR
fR
fR
fR
fR
"}
(42,1,1) = {"
fR
fR
fR
fR
fR
fR
fR
fR
fR
fR
fR
EE
FB
EE
gJ
gJ
YV
gJ
gJ
fR
fR
fR
fR
fR
fR
fR
fR
fR
fR
fR
"}
(43,1,1) = {"
fR
fR
fR
fR
fR
fR
fR
Nc
fR
fR
EE
EE
fR
fR
gJ
LH
LH
LH
gJ
fR
fR
fR
fR
fR
fR
fR
fR
fR
fR
fR
"}
(44,1,1) = {"
fR
fR
fR
fR
fR
fR
fR
fR
fR
fR
EE
fR
fR
fR
gJ
fu
qz
vc
gJ
fR
fR
fR
fR
fR
fR
fR
fR
fR
fR
fR
"}
(45,1,1) = {"
fR
fR
fR
fR
fR
fR
fR
fR
fR
Nc
fR
fR
fR
fR
gJ
fu
lo
fu
gJ
fR
fR
fR
fR
fR
fR
fR
fR
fR
fR
fR
"}
(46,1,1) = {"
fR
fR
fR
fR
fR
fR
fR
fR
Nc
fR
fR
fR
fR
fR
gJ
lR
Ma
vc
gJ
fR
fR
fR
fR
fR
fR
fR
fR
fR
fR
fR
"}
(47,1,1) = {"
fR
fR
fR
fR
fR
fR
fR
fR
fR
fR
fR
fR
fR
fR
gJ
fu
mI
LH
gJ
fR
fR
fR
fR
fR
fR
fR
fR
fR
fR
fR
"}
(48,1,1) = {"
fR
fR
fR
fR
fR
fR
fR
fR
fR
fR
fR
fR
fR
fR
gJ
LH
qz
of
gJ
fR
fR
fR
fR
fR
fR
fR
fR
fR
fR
fR
"}
(49,1,1) = {"
fR
fR
fR
fR
fR
fR
fR
fR
fR
fR
fR
fR
fR
fR
gJ
vc
GA
Lg
gJ
fR
fR
fR
fR
fR
fR
fR
fR
fR
fR
fR
"}
(50,1,1) = {"
fR
fR
fR
fR
fR
fR
fR
fR
fR
fR
fR
fR
fR
fR
gJ
LH
sj
vc
gJ
fR
fR
fR
fR
fR
fR
fR
fR
fR
fR
fR
"}
(51,1,1) = {"
fR
fR
fR
fR
fR
fR
fR
fR
fR
fR
fR
fR
fR
fR
gJ
LH
LH
LH
gJ
fR
fR
fR
fR
fR
fR
fR
fR
fR
fR
fR
"}
(52,1,1) = {"
fR
fR
fR
fR
fR
fR
fR
fR
fR
fR
fR
fR
fR
fR
gJ
gJ
YV
gJ
gJ
fR
fR
fR
fR
fR
fR
fR
fR
fR
fR
fR
"}
(53,1,1) = {"
fR
fR
fR
fR
fR
fR
fR
fR
fR
fR
fR
fR
fR
fR
fR
fR
EE
fR
fR
fR
fR
fR
fR
fR
fR
fR
fR
fR
fR
fR
"}
(54,1,1) = {"
fR
fR
fR
fR
fR
fR
fR
fR
fR
fR
fR
fR
fR
EE
EE
EE
EE
EE
fR
fR
fR
fR
Nc
fR
fR
fR
fR
fR
fR
fR
"}
(55,1,1) = {"
fR
fR
fR
fR
fR
fR
fR
fR
fR
fR
fR
fR
fR
Nc
fR
fR
fR
fR
Bq
EE
fR
fR
fR
fR
fR
fR
fR
fR
fR
fR
"}
