//MAP CONVERTED BY dmm2tgm.py THIS HEADER COMMENT PREVENTS RECONVERSION, DO NOT REMOVE
"a" = (
/turf/simulated/floor/outdoors/crystal_planet/purplesand,
/area/submap/crystalcore/deeppurple/eight)
"d" = (
/obj/structure/cliff/automatic{
	dir = 4
	},
/turf/simulated/floor/outdoors/crystal_planet/purplesand,
/area/submap/crystalcore/deeppurple/eight)
"f" = (
/turf/template_noop,
/area/submap/crystalcore/deeppurple/eight)
"g" = (
/obj/structure/cliff/automatic{
	dir = 6
	},
/turf/simulated/floor/outdoors/crystal_planet/purplesand,
/area/submap/crystalcore/deeppurple/eight)
"l" = (
/obj/structure/cliff/automatic{
	dir = 5
	},
/turf/simulated/floor/outdoors/crystal_planet/purplesand,
/area/submap/crystalcore/deeppurple/eight)
"m" = (
/obj/item/mecha_parts/mecha_equipment/tool/drill/bore,
/obj/structure/table/steel,
/turf/simulated/floor/outdoors/crystal_planet/purplesand,
/area/submap/crystalcore/deeppurple/eight)
"q" = (
/obj/structure/cliff/automatic/corner{
	dir = 6
	},
/turf/simulated/floor/outdoors/crystal_planet/purplesand,
/area/submap/crystalcore/deeppurple/eight)
"s" = (
/obj/structure/cliff/automatic{
	dir = 9
	},
/turf/simulated/floor/outdoors/crystal_planet/purplesand,
/area/submap/crystalcore/deeppurple/eight)
"t" = (
/obj/structure/cliff/automatic/corner{
	dir = 10
	},
/turf/simulated/floor/outdoors/crystal_planet/purplesand,
/area/submap/crystalcore/deeppurple/eight)
"v" = (
/obj/structure/cliff/automatic/corner{
	dir = 9
	},
/turf/simulated/floor/outdoors/crystal_planet/purplesand,
/area/submap/crystalcore/deeppurple/eight)
"A" = (
/obj/structure/cliff/automatic{
	dir = 8
	},
/turf/simulated/floor/outdoors/crystal_planet/purplesand,
/area/submap/crystalcore/deeppurple/eight)
"E" = (
/mob/living/simple_mob/mechanical/mining_drone,
/turf/simulated/floor/outdoors/crystal_planet/purplesand,
/area/submap/crystalcore/deeppurple/eight)
"K" = (
/obj/structure/cliff/automatic{
	dir = 2
	},
/turf/simulated/floor/outdoors/crystal_planet/purplesand,
/area/submap/crystalcore/deeppurple/eight)
"O" = (
/turf/template_noop,
/area/template_noop)
"P" = (
/obj/mecha/working/ripley/antique,
/turf/simulated/floor/outdoors/crystal_planet/purplesand,
/area/submap/crystalcore/deeppurple/eight)
"S" = (
/obj/item/mecha_parts/mecha_equipment/weapon/phoron_bore,
/obj/structure/table/steel,
/turf/simulated/floor/outdoors/crystal_planet/purplesand,
/area/submap/crystalcore/deeppurple/eight)
"W" = (
/obj/structure/cliff/automatic/corner,
/turf/simulated/floor/outdoors/crystal_planet/purplesand,
/area/submap/crystalcore/deeppurple/eight)
"Z" = (
/obj/structure/cliff/automatic{
	dir = 10
	},
/turf/simulated/floor/outdoors/crystal_planet/purplesand,
/area/submap/crystalcore/deeppurple/eight)

(1,1,1) = {"
O
O
O
O
O
O
O
O
O
O
O
O
O
O
O
"}
(2,1,1) = {"
O
f
f
f
f
f
a
a
a
f
f
f
f
f
O
"}
(3,1,1) = {"
O
f
f
f
f
q
d
d
d
W
f
f
f
f
O
"}
(4,1,1) = {"
O
f
f
f
q
g
a
a
a
l
W
f
f
f
O
"}
(5,1,1) = {"
O
f
f
q
g
a
a
S
a
a
l
W
f
f
O
"}
(6,1,1) = {"
O
f
q
g
a
E
a
a
a
a
a
l
a
f
O
"}
(7,1,1) = {"
O
a
K
a
a
a
a
a
a
a
a
a
a
a
O
"}
(8,1,1) = {"
O
a
K
a
a
P
a
a
a
E
a
a
a
a
O
"}
(9,1,1) = {"
O
a
K
a
a
a
a
a
a
a
a
a
a
a
O
"}
(10,1,1) = {"
O
f
t
Z
a
E
a
a
a
a
a
s
a
f
O
"}
(11,1,1) = {"
O
f
f
t
Z
a
a
m
a
a
s
v
f
f
O
"}
(12,1,1) = {"
O
f
f
f
t
Z
a
a
a
s
v
f
f
f
O
"}
(13,1,1) = {"
O
f
f
f
f
t
A
A
A
v
f
f
f
f
O
"}
(14,1,1) = {"
O
f
f
f
f
f
a
a
a
f
f
f
f
f
O
"}
(15,1,1) = {"
O
O
O
O
O
O
O
O
O
O
O
O
O
O
O
"}
