//MAP CONVERTED BY dmm2tgm.py THIS HEADER COMMENT PREVENTS RECONVERSION, DO NOT REMOVE
"a" = (
/turf/template_noop,
/area/submap/crystalcore/deeppurple/fourteen)
"i" = (
/turf/template_noop,
/area/template_noop)
"j" = (
/turf/simulated/open,
/area/submap/crystalcore/deeppurple/fourteen)

(1,1,1) = {"
i
i
i
i
i
i
i
i
i
i
i
i
i
i
i
"}
(2,1,1) = {"
i
a
a
a
a
a
a
a
a
a
a
a
a
a
i
"}
(3,1,1) = {"
i
a
j
j
a
a
a
a
a
a
a
j
j
a
i
"}
(4,1,1) = {"
i
a
j
j
j
a
a
a
a
a
j
j
j
a
i
"}
(5,1,1) = {"
i
a
a
j
j
j
a
a
a
j
j
j
a
a
i
"}
(6,1,1) = {"
i
a
a
a
j
j
j
j
j
j
j
a
a
a
i
"}
(7,1,1) = {"
i
a
a
a
a
j
j
j
j
j
a
a
a
a
i
"}
(8,1,1) = {"
i
a
a
a
a
j
j
j
j
j
a
a
a
a
i
"}
(9,1,1) = {"
i
a
a
a
a
j
j
j
j
j
a
a
a
a
i
"}
(10,1,1) = {"
i
a
a
a
j
j
j
j
j
j
j
a
a
a
i
"}
(11,1,1) = {"
i
a
a
j
j
j
a
a
a
j
j
j
a
a
i
"}
(12,1,1) = {"
i
a
j
j
j
a
a
a
a
a
j
j
j
a
i
"}
(13,1,1) = {"
i
a
j
j
a
a
a
a
a
a
a
j
j
a
i
"}
(14,1,1) = {"
i
a
a
a
a
a
a
a
a
a
a
a
a
a
i
"}
(15,1,1) = {"
i
i
i
i
i
i
i
i
i
i
i
i
i
i
i
"}
