//MAP CONVERTED BY dmm2tgm.py THIS HEADER COMMENT PREVENTS RECONVERSION, DO NOT REMOVE
"a" = (
/turf/template_noop,
/area/submap/crystalcore/deeppurple/five)
"x" = (
/turf/simulated/wall/sandstone,
/area/submap/crystalcore/deeppurple/five)
"y" = (
/turf/template_noop,
/area/template_noop)
"J" = (
/turf/simulated/wall/sandstonediamond,
/area/submap/crystalcore/deeppurple/five)
"Z" = (
/turf/simulated/wall/silvergold,
/area/submap/crystalcore/deeppurple/five)

(1,1,1) = {"
y
y
y
y
y
y
y
y
y
y
y
y
y
y
y
"}
(2,1,1) = {"
y
x
x
x
x
x
x
x
x
x
x
x
x
x
y
"}
(3,1,1) = {"
y
a
a
a
a
a
a
a
a
a
a
a
a
x
y
"}
(4,1,1) = {"
y
a
a
a
a
a
a
a
a
a
a
a
a
x
y
"}
(5,1,1) = {"
y
x
x
x
x
x
x
x
x
x
J
a
a
x
y
"}
(6,1,1) = {"
y
a
a
a
a
x
a
a
a
a
x
a
a
x
y
"}
(7,1,1) = {"
y
a
a
a
a
x
a
Z
Z
a
x
a
a
x
y
"}
(8,1,1) = {"
y
a
a
a
a
x
a
Z
Z
a
x
a
a
x
y
"}
(9,1,1) = {"
y
a
a
a
a
x
a
a
a
a
x
a
a
x
y
"}
(10,1,1) = {"
y
a
a
a
a
x
x
x
x
x
x
a
a
x
y
"}
(11,1,1) = {"
y
a
a
a
a
a
a
a
a
a
x
a
a
x
y
"}
(12,1,1) = {"
y
a
a
a
a
a
a
a
a
a
x
a
a
x
y
"}
(13,1,1) = {"
y
a
a
a
a
a
a
a
a
a
x
a
a
x
y
"}
(14,1,1) = {"
y
a
a
a
a
a
a
a
a
a
x
a
a
x
y
"}
(15,1,1) = {"
y
y
y
y
y
y
y
y
y
y
y
y
y
y
y
"}
