//MAP CONVERTED BY dmm2tgm.py THIS HEADER COMMENT PREVENTS RECONVERSION, DO NOT REMOVE
"a" = (
/turf/template_noop,
/area/submap/crystalcore/deeppurple/four)
"k" = (
/turf/simulated/wall/sandstone,
/area/submap/crystalcore/deeppurple/four)
"A" = (
/obj/structure/bed,
/turf/template_noop,
/area/submap/crystalcore/deeppurple/four)
"E" = (
/obj/structure/closet/crate/secure/loot,
/turf/template_noop,
/area/submap/crystalcore/deeppurple/four)
"F" = (
/obj/structure/table/marble,
/turf/template_noop,
/area/submap/crystalcore/deeppurple/four)
"H" = (
/turf/simulated/wall/sandstonediamond,
/area/submap/crystalcore/deeppurple/four)
"K" = (
/turf/template_noop,
/area/template_noop)

(1,1,1) = {"
K
K
K
K
K
K
K
K
K
K
K
K
K
K
K
"}
(2,1,1) = {"
K
a
a
a
a
a
a
a
a
a
a
a
a
a
K
"}
(3,1,1) = {"
K
a
a
a
a
a
a
a
a
a
a
a
a
a
K
"}
(4,1,1) = {"
K
a
a
a
k
k
k
H
k
k
k
k
k
k
K
"}
(5,1,1) = {"
K
a
a
a
k
a
a
a
a
a
a
a
a
k
K
"}
(6,1,1) = {"
K
a
a
a
k
a
a
a
a
a
a
a
a
k
K
"}
(7,1,1) = {"
K
a
a
a
k
a
a
a
a
a
k
a
a
k
K
"}
(8,1,1) = {"
K
a
a
a
k
a
a
a
a
a
k
a
a
k
K
"}
(9,1,1) = {"
K
a
a
a
k
a
a
a
a
a
k
a
a
k
K
"}
(10,1,1) = {"
K
a
a
a
k
a
a
a
a
a
k
a
a
k
K
"}
(11,1,1) = {"
K
a
a
a
k
E
A
F
A
E
k
a
a
k
K
"}
(12,1,1) = {"
K
a
a
a
k
k
k
H
k
k
k
a
a
k
K
"}
(13,1,1) = {"
K
a
a
a
a
a
a
a
a
a
k
a
a
k
K
"}
(14,1,1) = {"
K
a
a
a
a
a
a
a
a
a
k
a
a
k
K
"}
(15,1,1) = {"
K
K
K
K
K
K
K
K
K
K
K
K
K
K
K
"}
