//MAP CONVERTED BY dmm2tgm.py THIS HEADER COMMENT PREVENTS RECONVERSION, DO NOT REMOVE
"a" = (
/turf/simulated/mineral/redcrystal,
/area/submap/crystalcore/deeppurple/nine)
"l" = (
/obj/fire,
/obj/item/weapon/rcd,
/turf/simulated/floor/outdoors/crystal_planet/redsand,
/area/submap/crystalcore/deeppurple/nine)
"r" = (
/turf/template_noop,
/area/submap/crystalcore/deeppurple/nine)
"v" = (
/obj/fire,
/obj/structure/loot_pile/surface/bones,
/turf/simulated/floor/outdoors/crystal_planet/redsand,
/area/submap/crystalcore/deeppurple/nine)
"w" = (
/obj/fire,
/turf/simulated/floor/outdoors/crystal_planet/redsand,
/area/submap/crystalcore/deeppurple/nine)
"I" = (
/turf/template_noop,
/area/template_noop)

(1,1,1) = {"
I
I
I
I
I
I
I
I
I
I
I
I
I
I
I
"}
(2,1,1) = {"
I
r
r
r
r
r
a
a
a
a
a
a
a
r
I
"}
(3,1,1) = {"
I
r
r
r
r
a
a
w
w
w
w
w
a
r
I
"}
(4,1,1) = {"
I
r
r
r
a
a
w
w
w
v
w
w
a
a
I
"}
(5,1,1) = {"
I
r
r
a
a
w
w
w
w
w
w
w
w
a
I
"}
(6,1,1) = {"
I
r
r
a
w
w
w
w
w
w
w
w
w
a
I
"}
(7,1,1) = {"
I
r
a
a
w
w
w
w
l
w
w
v
w
a
I
"}
(8,1,1) = {"
I
a
a
w
w
w
v
w
w
w
w
w
w
a
I
"}
(9,1,1) = {"
I
a
w
w
w
w
w
w
w
w
w
w
w
a
I
"}
(10,1,1) = {"
I
a
w
w
w
l
w
w
w
w
w
a
a
a
I
"}
(11,1,1) = {"
I
a
a
w
w
w
w
w
w
w
a
a
r
r
I
"}
(12,1,1) = {"
I
r
a
w
w
v
w
w
w
a
a
r
r
r
I
"}
(13,1,1) = {"
I
r
a
a
a
w
w
a
a
a
r
r
r
r
I
"}
(14,1,1) = {"
I
r
r
r
a
a
a
a
r
r
r
r
r
r
I
"}
(15,1,1) = {"
I
I
I
I
I
I
I
I
I
I
I
I
I
I
I
"}
