//MAP CONVERTED BY dmm2tgm.py THIS HEADER COMMENT PREVENTS RECONVERSION, DO NOT REMOVE
"a" = (
/turf/template_noop,
/area/submap/crystalcore/deeppurple/nine)
"j" = (
/mob/living/simple_mob/animal/crystalcore/magmaslime,
/turf/simulated/floor/outdoors/crystal_planet/purplesand,
/area/submap/crystalcore/deeppurple/nine)
"B" = (
/turf/template_noop,
/area/template_noop)
"L" = (
/turf/simulated/floor/outdoors/crystal_planet/purplesand,
/area/submap/crystalcore/deeppurple/nine)

(1,1,1) = {"
B
B
B
B
B
B
B
B
B
B
B
B
B
B
B
"}
(2,1,1) = {"
B
a
a
a
a
a
L
L
L
a
a
a
a
a
B
"}
(3,1,1) = {"
B
a
a
a
a
L
L
L
L
L
a
a
a
a
B
"}
(4,1,1) = {"
B
a
a
a
L
L
L
L
L
L
L
a
a
a
B
"}
(5,1,1) = {"
B
a
a
L
L
L
L
L
L
L
L
L
a
a
B
"}
(6,1,1) = {"
B
a
L
L
L
L
L
L
L
L
L
L
L
a
B
"}
(7,1,1) = {"
B
L
L
L
L
L
L
L
L
L
L
L
L
L
B
"}
(8,1,1) = {"
B
L
L
L
L
L
L
j
L
L
L
L
L
L
B
"}
(9,1,1) = {"
B
L
L
L
L
L
L
L
L
L
L
L
L
L
B
"}
(10,1,1) = {"
B
a
L
L
L
L
L
L
L
L
L
L
L
a
B
"}
(11,1,1) = {"
B
a
a
L
L
L
L
L
L
L
L
L
a
a
B
"}
(12,1,1) = {"
B
a
a
a
L
L
L
L
L
L
L
a
a
a
B
"}
(13,1,1) = {"
B
a
a
a
a
L
L
L
L
L
a
a
a
a
B
"}
(14,1,1) = {"
B
a
a
a
a
a
L
L
L
a
a
a
a
a
B
"}
(15,1,1) = {"
B
B
B
B
B
B
B
B
B
B
B
B
B
B
B
"}
