//MAP CONVERTED BY dmm2tgm.py THIS HEADER COMMENT PREVENTS RECONVERSION, DO NOT REMOVE
"a" = (
/turf/template_noop,
/area/template_noop)
"i" = (
/turf/template_noop,
/area/submap/crystalcore/deeppurple/thirteen)
"s" = (
/turf/simulated/open,
/area/submap/crystalcore/deeppurple/thirteen)

(1,1,1) = {"
a
a
a
a
a
a
a
a
a
a
a
a
a
a
a
"}
(2,1,1) = {"
a
i
i
i
i
i
i
i
i
i
s
i
i
i
a
"}
(3,1,1) = {"
a
i
i
i
i
i
i
i
i
s
s
s
i
i
a
"}
(4,1,1) = {"
a
i
i
i
i
i
i
i
s
s
s
s
s
i
a
"}
(5,1,1) = {"
a
i
i
i
i
i
i
i
s
s
s
s
s
s
a
"}
(6,1,1) = {"
a
i
i
i
i
i
i
s
s
s
s
s
s
i
a
"}
(7,1,1) = {"
a
i
i
i
i
i
i
i
s
s
s
s
i
i
a
"}
(8,1,1) = {"
a
i
i
i
i
s
i
i
i
s
i
i
i
i
a
"}
(9,1,1) = {"
a
i
i
s
s
s
s
i
i
i
i
i
i
i
a
"}
(10,1,1) = {"
a
i
s
s
s
s
s
s
i
i
i
i
i
i
a
"}
(11,1,1) = {"
a
s
s
s
s
s
s
i
i
i
i
i
i
i
a
"}
(12,1,1) = {"
a
i
s
s
s
s
s
i
i
i
i
i
i
i
a
"}
(13,1,1) = {"
a
i
i
s
s
s
i
i
i
i
i
i
i
i
a
"}
(14,1,1) = {"
a
i
i
i
s
i
i
i
i
i
i
i
i
i
a
"}
(15,1,1) = {"
a
a
a
a
a
a
a
a
a
a
a
a
a
a
a
"}
