//MAP CONVERTED BY dmm2tgm.py THIS HEADER COMMENT PREVENTS RECONVERSION, DO NOT REMOVE
"a" = (
/turf/template_noop,
/area/submap/crystalcore/deeppurple/three)
"b" = (
/obj/structure/table/bench/glass,
/turf/template_noop,
/area/submap/crystalcore/deeppurple/three)
"t" = (
/obj/structure/table/gold,
/obj/item/weapon/reagent_containers/food/snacks/aesirsalad,
/turf/template_noop,
/area/submap/crystalcore/deeppurple/three)
"B" = (
/turf/simulated/wall/sandstone,
/area/submap/crystalcore/deeppurple/three)
"D" = (
/obj/structure/table/gold,
/obj/item/weapon/reagent_containers/food/snacks/amanitajelly,
/turf/template_noop,
/area/submap/crystalcore/deeppurple/three)
"K" = (
/obj/structure/table/gold,
/obj/item/weapon/reagent_containers/food/snacks/bucheslice,
/turf/template_noop,
/area/submap/crystalcore/deeppurple/three)
"U" = (
/obj/structure/table/gold,
/obj/item/weapon/reagent_containers/food/snacks/antball,
/turf/template_noop,
/area/submap/crystalcore/deeppurple/three)
"Y" = (
/turf/template_noop,
/area/template_noop)

(1,1,1) = {"
Y
Y
Y
Y
Y
Y
Y
Y
Y
Y
Y
Y
Y
Y
Y
"}
(2,1,1) = {"
Y
a
a
a
a
a
a
a
a
a
a
a
a
a
Y
"}
(3,1,1) = {"
Y
a
a
B
B
B
B
B
B
B
B
B
a
a
Y
"}
(4,1,1) = {"
Y
a
a
B
a
a
a
a
a
a
a
B
a
a
Y
"}
(5,1,1) = {"
Y
a
a
B
a
a
a
a
a
a
a
B
a
a
Y
"}
(6,1,1) = {"
Y
a
a
B
a
a
b
U
b
a
a
B
B
B
Y
"}
(7,1,1) = {"
Y
a
a
B
a
a
b
D
b
a
a
a
a
a
Y
"}
(8,1,1) = {"
Y
a
a
B
a
a
b
K
b
a
a
a
a
a
Y
"}
(9,1,1) = {"
Y
a
a
B
a
a
b
t
b
a
a
B
B
B
Y
"}
(10,1,1) = {"
Y
a
a
B
a
a
a
a
a
a
a
B
a
a
Y
"}
(11,1,1) = {"
Y
a
a
B
a
a
a
a
a
a
a
B
a
a
Y
"}
(12,1,1) = {"
Y
a
a
B
B
B
B
B
B
B
B
B
a
a
Y
"}
(13,1,1) = {"
Y
a
a
a
a
a
a
a
a
a
a
a
a
a
Y
"}
(14,1,1) = {"
Y
Y
Y
Y
Y
Y
Y
Y
Y
Y
Y
Y
Y
Y
Y
"}
