//MAP CONVERTED BY dmm2tgm.py THIS HEADER COMMENT PREVENTS RECONVERSION, DO NOT REMOVE
"a" = (
/turf/template_noop,
/area/template_noop)
"x" = (
/turf/simulated/open,
/area/submap/crystalcore/deeppurple/twelve)
"W" = (
/turf/template_noop,
/area/submap/crystalcore/deeppurple/twelve)

(1,1,1) = {"
a
a
a
a
a
a
a
a
a
a
a
a
a
a
a
"}
(2,1,1) = {"
a
W
W
x
x
x
W
W
W
W
W
W
W
W
a
"}
(3,1,1) = {"
a
W
x
x
x
W
W
W
W
W
W
W
W
W
a
"}
(4,1,1) = {"
a
x
x
x
W
W
W
W
W
W
W
W
W
W
a
"}
(5,1,1) = {"
a
W
x
x
x
x
W
W
W
W
W
W
W
W
a
"}
(6,1,1) = {"
a
W
W
x
x
x
x
x
W
W
W
W
W
W
a
"}
(7,1,1) = {"
a
W
W
W
W
x
x
x
x
x
W
W
W
W
a
"}
(8,1,1) = {"
a
W
W
W
W
W
W
x
x
x
x
x
W
W
a
"}
(9,1,1) = {"
a
W
W
W
W
x
x
x
x
x
W
W
W
W
a
"}
(10,1,1) = {"
a
W
W
x
x
x
x
x
W
W
W
W
W
W
a
"}
(11,1,1) = {"
a
W
x
x
x
x
W
W
W
W
W
W
W
W
a
"}
(12,1,1) = {"
a
x
x
x
W
W
W
W
W
W
W
W
W
W
a
"}
(13,1,1) = {"
a
W
x
x
x
W
W
W
W
W
W
W
W
W
a
"}
(14,1,1) = {"
a
W
W
x
x
x
W
W
W
W
W
W
W
W
a
"}
(15,1,1) = {"
a
a
a
a
a
a
a
a
a
a
a
a
a
a
a
"}
