//MAP CONVERTED BY dmm2tgm.py THIS HEADER COMMENT PREVENTS RECONVERSION, DO NOT REMOVE
"a" = (
/turf/template_noop,
/area/submap/crystalcore/deeppurple/two)
"v" = (
/obj/structure/closet/crate/secure/loot,
/turf/template_noop,
/area/submap/crystalcore/deeppurple/two)
"z" = (
/turf/simulated/wall/sandstonediamond,
/area/submap/crystalcore/deeppurple/two)
"C" = (
/turf/simulated/wall/sandstone,
/area/submap/crystalcore/deeppurple/two)
"M" = (
/turf/template_noop,
/area/template_noop)

(1,1,1) = {"
M
M
M
M
M
M
M
M
M
M
M
M
M
M
M
"}
(2,1,1) = {"
M
a
a
a
a
a
a
a
C
a
a
C
a
a
M
"}
(3,1,1) = {"
M
a
a
a
a
a
a
a
C
a
a
C
a
a
M
"}
(4,1,1) = {"
M
a
a
a
a
a
a
a
C
a
a
C
a
a
M
"}
(5,1,1) = {"
M
a
a
a
C
C
C
C
C
a
a
C
a
a
M
"}
(6,1,1) = {"
M
a
a
a
C
a
a
a
C
a
a
C
a
a
M
"}
(7,1,1) = {"
M
a
a
a
C
a
a
a
C
a
a
C
a
a
M
"}
(8,1,1) = {"
M
a
a
a
z
v
a
a
C
a
a
C
a
a
M
"}
(9,1,1) = {"
M
a
a
a
C
a
a
a
C
a
a
C
a
a
M
"}
(10,1,1) = {"
M
a
a
a
C
a
a
a
C
a
a
C
a
a
M
"}
(11,1,1) = {"
M
a
a
a
C
C
C
C
C
a
a
C
a
a
M
"}
(12,1,1) = {"
M
a
a
a
a
a
a
a
C
a
a
C
a
a
M
"}
(13,1,1) = {"
M
a
a
a
a
a
a
a
C
a
a
C
a
a
M
"}
(14,1,1) = {"
M
a
a
a
a
a
a
a
C
a
a
C
a
a
M
"}
(15,1,1) = {"
M
M
M
M
M
M
M
M
M
M
M
M
M
M
M
"}
