//MAP CONVERTED BY dmm2tgm.py THIS HEADER COMMENT PREVENTS RECONVERSION, DO NOT REMOVE
"aa" = (
/turf/template_noop,
/area/template_noop)
"ab" = (
/turf/template_noop,
/area/submap/virgo2/BoomBase)
"ac" = (
/obj/effect/decal/remains/human,
/turf/template_noop,
/area/submap/virgo2/BoomBase)
"ad" = (
/turf/space,
/area/submap/virgo2/BoomBase)
"ae" = (
/turf/simulated/floor/plating/bor4,
/area/submap/virgo2/BoomBase)
"af" = (
/obj/structure/girder,
/turf/simulated/floor/plating/bor4,
/area/submap/virgo2/BoomBase)
"ag" = (
/obj/structure/girder,
/obj/item/stack/rods,
/turf/simulated/floor/plating/bor4,
/area/submap/virgo2/BoomBase)
"ah" = (
/turf/simulated/wall/bor4,
/area/submap/virgo2/BoomBase)
"ai" = (
/obj/structure/closet/crate/secure/phoron,
/obj/fiftyspawner/phoron,
/turf/simulated/floor/plating,
/area/submap/virgo2/BoomBase)
"aj" = (
/obj/structure/closet/crate/secure/phoron,
/obj/fiftyspawner/phoron,
/turf/simulated/floor/tiled/techfloor/bor4,
/area/submap/virgo2/BoomBase)
"ak" = (
/obj/effect/decal/cleanable/dirt,
/obj/effect/decal/cleanable/ash,
/turf/simulated/floor/tiled/techfloor/bor4,
/area/submap/virgo2/BoomBase)
"al" = (
/obj/effect/decal/cleanable/dirt,
/turf/simulated/floor/tiled/techfloor/bor4,
/area/submap/virgo2/BoomBase)
"am" = (
/obj/effect/decal/cleanable/dirt,
/obj/effect/spider,
/obj/item/material/shard,
/turf/simulated/floor/tiled/techfloor/bor4,
/area/submap/virgo2/BoomBase)
"an" = (
/turf/simulated/floor/tiled/techfloor/bor4,
/area/submap/virgo2/BoomBase)
"ao" = (
/mob/living/simple_mob/animal/space/jelly,
/turf/simulated/floor/tiled/techfloor/bor4,
/area/submap/virgo2/BoomBase)
"ap" = (
/obj/machinery/portable_atmospherics/canister/empty/phoron,
/turf/simulated/floor/tiled/techfloor/bor4,
/area/submap/virgo2/BoomBase)
"aq" = (
/obj/machinery/portable_atmospherics/canister/empty/phoron,
/obj/item/material/shard,
/turf/simulated/floor/tiled/techfloor/bor4,
/area/submap/virgo2/BoomBase)
"ar" = (
/obj/effect/decal/remains/human,
/turf/simulated/floor/tiled/techfloor/bor4,
/area/submap/virgo2/BoomBase)
"as" = (
/obj/item/material/shard,
/turf/simulated/floor/plating/bor4,
/area/submap/virgo2/BoomBase)
"at" = (
/obj/effect/spider/stickyweb,
/turf/simulated/floor/plating/bor4,
/area/submap/virgo2/BoomBase)
"au" = (
/obj/effect/decal/cleanable/dirt,
/turf/simulated/floor/plating/bor4,
/area/submap/virgo2/BoomBase)
"av" = (
/obj/effect/decal/cleanable/ash,
/turf/simulated/floor/plating/bor4,
/area/submap/virgo2/BoomBase)
"aw" = (
/obj/effect/decal/cleanable/dirt,
/obj/effect/spider/stickyweb,
/turf/simulated/floor/tiled/techfloor/bor4,
/area/submap/virgo2/BoomBase)
"ax" = (
/obj/effect/decal/cleanable/dirt,
/mob/living/simple_mob/animal/space/jelly,
/turf/simulated/floor/tiled/techfloor/bor4,
/area/submap/virgo2/BoomBase)
"ay" = (
/obj/structure/table,
/turf/simulated/floor/tiled/techfloor/bor4,
/area/submap/virgo2/BoomBase)
"az" = (
/obj/effect/decal/cleanable/dirt,
/obj/structure/table/standard,
/obj/item/tank/phoron,
/obj/item/fuel_assembly/phoron,
/turf/simulated/floor/tiled/techfloor/bor4,
/area/submap/virgo2/BoomBase)
"aA" = (
/obj/effect/decal/remains/human,
/obj/effect/decal/cleanable/ash,
/turf/simulated/floor/tiled/techfloor/bor4,
/area/submap/virgo2/BoomBase)
"aB" = (
/obj/effect/decal/remains/human,
/turf/space,
/area/submap/virgo2/BoomBase)
"aC" = (
/obj/item/material/shard,
/turf/simulated/floor/tiled/techfloor/bor4,
/area/submap/virgo2/BoomBase)
"aD" = (
/obj/effect/decal/cleanable/ash,
/turf/simulated/floor/tiled/techfloor/bor4,
/area/submap/virgo2/BoomBase)
"aE" = (
/obj/effect/decal/cleanable/dirt,
/turf/space,
/area/submap/virgo2/BoomBase)
"aF" = (
/obj/effect/decal/cleanable/dirt,
/obj/effect/decal/cleanable/ash,
/turf/simulated/floor/plating/bor4,
/area/submap/virgo2/BoomBase)
"aG" = (
/obj/cryogaia_away_spawner/aerostat_surface,
/turf/space,
/area/submap/virgo2/BoomBase)
"aH" = (
/obj/effect/decal/cleanable/dirt,
/obj/cryogaia_away_spawner/aerostat_surface,
/turf/simulated/floor/plating/bor4,
/area/submap/virgo2/BoomBase)
"aI" = (
/obj/effect/decal/cleanable/ash,
/turf/space,
/area/submap/virgo2/BoomBase)
"aJ" = (
/obj/structure/ghost_pod/manual/lost_drone/dogborg,
/turf/simulated/floor/plating/bor4,
/area/submap/virgo2/BoomBase)
"aK" = (
/obj/item/transfer_valve,
/turf/space,
/area/submap/virgo2/BoomBase)
"aL" = (
/obj/item/material/shard,
/turf/space,
/area/submap/virgo2/BoomBase)
"aM" = (
/obj/effect/spider/stickyweb,
/obj/item/material/shard,
/turf/space,
/area/submap/virgo2/BoomBase)
"aY" = (
/obj/effect/spider/stickyweb,
/obj/effect/decal/cleanable/ash,
/turf/simulated/floor/plating/bor4,
/area/submap/virgo2/BoomBase)
"aZ" = (
/obj/effect/decal/remains/human,
/obj/effect/decal/cleanable/ash,
/turf/simulated/floor/plating/bor4,
/area/submap/virgo2/BoomBase)
"ba" = (
/obj/item/stack/rods,
/turf/simulated/wall/bor4,
/area/submap/virgo2/BoomBase)

(1,1,1) = {"
aa
aa
aa
aa
aa
aa
aa
aa
aa
aa
aa
aa
aa
aa
aa
aa
aa
aa
aa
aa
"}
(2,1,1) = {"
aa
ab
ab
ab
ab
ab
ab
ad
ad
ad
ad
ab
ab
ab
ab
ad
ad
ad
ab
aa
"}
(3,1,1) = {"
aa
ac
ab
ab
ab
ad
ad
ad
ad
ad
ad
ad
ad
ad
ad
ad
ad
ad
ab
aa
"}
(4,1,1) = {"
aa
ab
ad
ad
ad
ad
ad
ad
ad
ad
ad
ad
ad
ad
ad
ad
ad
ad
ab
aa
"}
(5,1,1) = {"
aa
ad
ad
ad
ad
ad
ad
ad
ad
ad
ad
ad
av
ad
ad
ad
ad
ad
ad
aa
"}
(6,1,1) = {"
aa
ad
ad
ba
ah
ah
ah
ah
ah
ah
ah
ah
ah
ah
af
ad
ad
ad
ad
aa
"}
(7,1,1) = {"
aa
ad
ah
ah
aF
au
aw
al
ax
ay
az
an
aJ
aD
ae
ad
ad
ad
ad
aa
"}
(8,1,1) = {"
aa
ad
ah
ai
au
au
au
al
al
al
aA
aC
an
an
ag
ae
af
ae
ad
aa
"}
(9,1,1) = {"
aa
ad
ah
aj
au
aH
au
au
aE
aE
ad
ad
ad
ad
ad
ad
ae
af
ad
aa
"}
(10,1,1) = {"
aa
ad
ah
au
al
al
au
af
aE
an
ad
ad
ad
ad
ad
ad
ad
ad
ad
aa
"}
(11,1,1) = {"
aa
ad
ah
ak
al
au
aE
au
aE
ad
ad
ad
ad
ad
ad
ad
ah
ad
ad
aa
"}
(12,1,1) = {"
aa
ad
ah
al
au
af
aE
aE
ad
ad
ad
ad
ad
ad
aG
ad
ae
ah
ad
aa
"}
(13,1,1) = {"
aa
ad
ah
am
au
aE
aE
ad
ad
ad
ad
ad
ad
ad
ad
ad
ae
ah
ad
aa
"}
(14,1,1) = {"
aa
ad
ah
an
an
ad
ad
ad
ad
ad
ad
ad
ad
ad
ad
ad
ae
ae
ad
aa
"}
(15,1,1) = {"
aa
ad
ah
ao
ar
ad
ad
ad
aI
ad
ad
ad
ad
ad
ad
ad
ad
ad
ad
aa
"}
(16,1,1) = {"
aa
ad
ah
ap
an
ad
ad
ad
ad
ad
ad
aK
ad
ad
ad
ad
ad
ad
ad
aa
"}
(17,1,1) = {"
aa
ad
ah
aq
an
ad
ad
ad
ad
ad
ad
aL
ad
ad
ad
ad
ad
ad
ad
aa
"}
(18,1,1) = {"
aa
ad
ah
as
ae
ad
ad
ad
ad
ad
ad
ad
ad
ad
ad
ad
ad
ad
ad
aa
"}
(19,1,1) = {"
aa
ad
ah
at
ad
ad
ad
ad
ad
ad
ad
ad
ad
ad
ad
ad
ae
ae
ad
aa
"}
(20,1,1) = {"
aa
ad
ah
ag
ad
ad
ad
aG
ad
ad
ad
ad
ad
ad
ad
ae
ae
ah
ad
aa
"}
(21,1,1) = {"
aa
ad
ah
ad
ad
ad
ad
ad
ad
ad
ad
ad
ad
ad
ad
ae
aY
ah
ad
aa
"}
(22,1,1) = {"
aa
ad
af
ad
ad
ad
ad
ah
ah
ah
ah
ah
ad
ad
ae
at
aZ
ba
ad
aa
"}
(23,1,1) = {"
aa
ad
ag
ad
ad
ad
ad
ae
af
af
af
af
ad
ae
aM
ae
ah
ah
ad
aa
"}
(24,1,1) = {"
aa
aB
ad
ad
ad
ad
ad
ad
ad
ad
af
ae
ad
ad
ad
ad
ad
ad
aB
aa
"}
(25,1,1) = {"
aa
aa
aa
aa
aa
aa
aa
aa
aa
aa
aa
aa
aa
aa
aa
aa
aa
aa
aa
aa
"}
