"a" = (/turf/template_noop,/area/template_noop)
"b" = (/turf/simulated/wall/bor4,/area/submap/virgo2/ButcherShack)
"d" = (/obj/structure/closet,/obj/effect/decal/cleanable/cobweb,/obj/item/weapon/beartrap,/obj/item/weapon/beartrap,/obj/item/weapon/packageWrap,/obj/item/weapon/material/knife/hook,/turf/simulated/floor/tiled,/area/submap/virgo2/ButcherShack)
"e" = (/obj/structure/closet/secure_closet/freezer/meat,/turf/simulated/floor/tiled,/area/submap/virgo2/ButcherShack)
"f" = (/obj/structure/closet/crate/freezer,/obj/effect/decal/cleanable/blood/gibs,/obj/random/meat,/obj/random/meat,/obj/random/meat,/obj/random/meat,/obj/random/meat,/obj/random/meat,/obj/random/meat,/obj/random/meat,/obj/random/meat,/obj/random/meat,/turf/simulated/floor/tiled,/area/submap/virgo2/ButcherShack)
"g" = (/obj/machinery/gibber/autogibber,/turf/simulated/floor/tiled,/area/submap/virgo2/ButcherShack)
"h" = (/turf/simulated/floor/tiled,/area/submap/virgo2/ButcherShack)
"i" = (/obj/structure/window/basic,/obj/structure/curtain,/turf/simulated/floor/wood/sif/broken,/area/submap/virgo2/ButcherShack)
"j" = (/turf/template_noop,/area/submap/virgo2/ButcherShack)
"l" = (/obj/structure/loot_pile/maint/trash,/turf/simulated/mineral/floor/bor4,/area/submap/virgo2/ButcherShack)
"m" = (/obj/structure/kitchenspike,/obj/effect/decal/cleanable/blood,/turf/simulated/floor/tiled,/area/submap/virgo2/ButcherShack)
"n" = (/obj/structure/kitchenspike,/obj/effect/decal/cleanable/blood/drip,/turf/simulated/floor/tiled,/area/submap/virgo2/ButcherShack)
"o" = (/obj/effect/decal/cleanable/blood,/turf/simulated/floor/tiled,/area/submap/virgo2/ButcherShack)
"p" = (/obj/structure/table/standard,/obj/item/clothing/suit/chef/classic,/turf/simulated/floor/tiled,/area/submap/virgo2/ButcherShack)
"q" = (/obj/structure/table/standard,/obj/effect/decal/cleanable/blood,/obj/item/weapon/material/knife/butch,/turf/simulated/floor/tiled,/area/submap/virgo2/ButcherShack)
"r" = (/obj/structure/table/standard,/obj/item/weapon/reagent_containers/food/snacks/cutlet,/obj/item/weapon/reagent_containers/food/snacks/cutlet,/obj/item/weapon/reagent_containers/food/snacks/cutlet,/obj/item/weapon/reagent_containers/food/snacks/sausage,/turf/simulated/floor/tiled,/area/submap/virgo2/ButcherShack)
"s" = (/obj/structure/coatrack,/turf/simulated/floor/tiled,/area/submap/virgo2/ButcherShack)
"t" = (/obj/structure/bed/padded,/obj/item/weapon/bedsheet/brown,/turf/simulated/floor/tiled,/area/submap/virgo2/ButcherShack)
"u" = (/obj/effect/decal/cleanable/blood/drip,/obj/machinery/door/airlock/external,/turf/simulated/floor/tiled,/area/submap/virgo2/ButcherShack)
"v" = (/turf/simulated/mineral/floor/bor4,/area/submap/virgo2/ButcherShack)
"w" = (/obj/structure/window/basic,/obj/structure/curtain,/turf/simulated/floor/wood/sif,/area/submap/virgo2/ButcherShack)
"x" = (/obj/machinery/door/airlock/external,/turf/simulated/floor/tiled,/area/submap/virgo2/ButcherShack)

(1,1,1) = {"
aaaaaaaaaa
abbbbbbbba
abdmnefgba
abhhhhohba
abhpqrhhba
absohhhtba
abbubiwbba
ajbhbllvja
ajbxbvvjja
aaaaaaaaaa
"}
