"aK" = (/obj/item/weapon/ore/silver,/obj/effect/decal/cleanable/dirt,/turf/simulated/floor/outdoors/grass/sif/forest{outdoors = 0},/area/submap/LeopardmanderDen)
"aT" = (/obj/structure/table/bench/sifwooden/padded,/mob/living/simple_mob/animal/sif/siffet,/turf/simulated/floor/outdoors/grass/sif/forest{outdoors = 0},/area/submap/LeopardmanderDen)
"bj" = (/obj/item/weapon/ore/bluespace_crystal,/turf/simulated/floor/outdoors/grass/sif,/area/submap/LeopardmanderDen)
"bO" = (/obj/item/stack/material/gold,/turf/simulated/floor/outdoors/grass/sif,/area/submap/LeopardmanderDen)
"cu" = (/turf/simulated/floor/outdoors/rocks{outdoors = 0},/area/submap/LeopardmanderDen)
"dA" = (/obj/effect/decal/cleanable/dirt,/obj/structure/simple_door/sifwood,/turf/simulated/floor/outdoors/rocks{outdoors = 0},/area/submap/LeopardmanderDen)
"eD" = (/obj/structure/railing/grey{dir = 4},/turf/simulated/floor/outdoors/dirt,/area/template_noop)
"eF" = (/obj/structure/ledge/ledge_stairs,/turf/simulated/floor/outdoors/rocks{outdoors = 0},/area/template_noop)
"fe" = (/obj/item/weapon/coin/diamond,/obj/effect/decal/cleanable/dirt,/turf/simulated/floor/outdoors/grass/sif/forest{outdoors = 0},/area/submap/LeopardmanderDen)
"fQ" = (/obj/effect/landmark/loot_spawn/low,/obj/item/weapon/ore/gold,/turf/simulated/floor/outdoors/grass/sif/forest{outdoors = 0},/area/submap/LeopardmanderDen)
"gg" = (/obj/random/obstruction,/turf/simulated/floor/outdoors/dirt,/area/template_noop)
"gC" = (/obj/item/weapon/flame/lighter/zippo/gold,/turf/simulated/floor/outdoors/grass/sif/forest{outdoors = 0},/area/submap/LeopardmanderDen)
"gD" = (/obj/structure/flora/smallbould,/turf/simulated/floor/outdoors/rocks{outdoors = 0},/area/submap/LeopardmanderDen)
"gP" = (/obj/structure/cliff/automatic,/turf/simulated/floor/outdoors/dirt,/area/template_noop)
"gU" = (/obj/item/weapon/coin/gold,/turf/simulated/floor/outdoors/grass/sif/forest{outdoors = 0},/area/submap/LeopardmanderDen)
"hi" = (/obj/structure/sign/warning/falling,/turf/simulated/wall/gold,/area/submap/LeopardmanderDen)
"hr" = (/obj/structure/flora/rocks1,/turf/simulated/floor/outdoors/grass/sif/forest{outdoors = 0},/area/submap/LeopardmanderDen)
"hw" = (/obj/structure/cliff/automatic{dir = 9},/obj/structure/railing/grey{dir = 1},/turf/simulated/floor/outdoors/dirt,/area/template_noop)
"iV" = (/obj/structure/cliff/automatic/corner{dir = 6},/turf/simulated/floor/outdoors/dirt,/area/template_noop)
"jb" = (/obj/machinery/crystal/ice,/turf/template_noop,/area/template_noop)
"jE" = (/obj/structure/cliff/automatic{dir = 8},/turf/simulated/floor/outdoors/dirt,/area/template_noop)
"ki" = (/obj/structure/table/bench/sifwooden/padded,/obj/item/clothing/head/pin/flower/violet,/turf/simulated/floor/outdoors/grass/sif/forest{outdoors = 0},/area/submap/LeopardmanderDen)
"kx" = (/obj/item/stack/material/gold,/turf/simulated/floor/outdoors/grass/sif/forest{outdoors = 0},/area/submap/LeopardmanderDen)
"kO" = (/obj/structure/cliff/automatic{dir = 6},/turf/simulated/floor/outdoors/dirt,/area/template_noop)
"lb" = (/obj/structure/cliff/automatic{dir = 10},/turf/simulated/floor/outdoors/dirt,/area/template_noop)
"ll" = (/obj/structure/cliff/automatic/corner{dir = 10},/turf/simulated/floor/outdoors/dirt,/area/template_noop)
"mi" = (/obj/structure/cliff/automatic/ramp{dir = 9},/obj/structure/railing/grey{dir = 8},/turf/simulated/floor/outdoors/dirt,/area/template_noop)
"mu" = (/obj/structure/flora/rocks2,/turf/simulated/floor/outdoors/grass/sif/forest{outdoors = 0},/area/submap/LeopardmanderDen)
"mW" = (/obj/structure/railing/grey,/obj/structure/railing/grey{dir = 4},/turf/simulated/floor/outdoors/dirt,/area/template_noop)
"nw" = (/turf/simulated/floor/water/ocean{outdoors = 0},/area/submap/LeopardmanderDen)
"nG" = (/obj/effect/decal/cleanable/dirt,/obj/effect/decal/cleanable/dirt,/turf/simulated/floor/outdoors/grass/sif/forest{outdoors = 0},/area/submap/LeopardmanderDen)
"nR" = (/mob/living/simple_mob/animal/sif/sakimm,/turf/simulated/floor/outdoors/grass/sif/forest{outdoors = 0},/area/submap/LeopardmanderDen)
"oD" = (/obj/fiftyspawner/silver,/turf/simulated/floor/outdoors/grass/sif,/area/submap/LeopardmanderDen)
"pQ" = (/obj/structure/cliff/automatic/corner,/turf/simulated/floor/outdoors/dirt,/area/template_noop)
"qa" = (/obj/effect/decal/cleanable/dirt,/turf/simulated/floor/outdoors/grass/sif,/area/submap/LeopardmanderDen)
"qg" = (/obj/structure/bed/chair/oldsofa/right{dir = 8},/turf/simulated/floor/outdoors/rocks{outdoors = 0},/area/submap/LeopardmanderDen)
"rn" = (/turf/template_noop,/area/template_noop)
"ro" = (/obj/structure/flora/lily3,/turf/simulated/floor/water/ocean{outdoors = 0},/area/submap/LeopardmanderDen)
"rD" = (/obj/structure/flora/ausbushes/brflowers,/turf/simulated/floor/outdoors/grass/sif/forest{outdoors = 0},/area/submap/LeopardmanderDen)
"rG" = (/obj/structure/flora/pottedplant/flower,/turf/simulated/floor/outdoors/grass/sif/forest{outdoors = 0},/area/submap/LeopardmanderDen)
"sl" = (/obj/machinery/crystal/ice,/obj/structure/railing/grey{dir = 4},/turf/simulated/floor/outdoors/dirt,/area/template_noop)
"sN" = (/mob/living/simple_mob/otie/red/chubby{desc = "Seems this ominous looking longdog has been infused with wicked infernal forces. What an absolute unit. It has a collar around one of its ankles that reads 'Tawny'."; faction = "sif"; name = "Tawny"},/turf/simulated/floor/outdoors/grass/sif/forest{outdoors = 0},/area/submap/LeopardmanderDen)
"sY" = (/mob/living/simple_mob/animal/sif/sakimm,/turf/template_noop,/area/template_noop)
"tP" = (/mob/living/simple_mob/animal/sif/sakimm,/turf/simulated/floor/outdoors/dirt,/area/template_noop)
"uw" = (/obj/structure/ledge/ledge_stairs{dir = 4},/turf/simulated/floor/outdoors/rocks{outdoors = 0},/area/template_noop)
"uz" = (/obj/structure/cliff/automatic{dir = 8},/obj/structure/railing/grey{dir = 8},/turf/simulated/floor/outdoors/dirt,/area/template_noop)
"vk" = (/mob/living/simple_mob/animal/sif/tymisian{faction = "sif"},/turf/template_noop,/area/template_noop)
"xf" = (/turf/simulated/floor/outdoors/grass/sif,/area/submap/LeopardmanderDen)
"xg" = (/obj/item/weapon/ore/silver,/turf/simulated/floor/outdoors/grass/sif/forest{outdoors = 0},/area/submap/LeopardmanderDen)
"xL" = (/obj/random/outcrop,/turf/simulated/floor/outdoors/rocks{outdoors = 0},/area/submap/LeopardmanderDen)
"yl" = (/turf/simulated/wall/golddiamond,/area/submap/LeopardmanderDen)
"yz" = (/obj/effect/decal/cleanable/dirt,/turf/simulated/floor/water/ocean{outdoors = 0},/area/submap/LeopardmanderDen)
"zJ" = (/mob/living/simple_mob/animal/sif/siffet,/turf/simulated/floor/outdoors/dirt,/area/template_noop)
"zW" = (/obj/structure/cliff/automatic/corner{dir = 9},/turf/simulated/floor/outdoors/dirt,/area/template_noop)
"Ah" = (/obj/structure/flora/grass/green,/turf/simulated/floor/outdoors/grass/sif/forest{outdoors = 0},/area/submap/LeopardmanderDen)
"AF" = (/turf/simulated/floor/water/ocean,/area/submap/LeopardmanderDen)
"AP" = (/obj/structure/bed/chair/oldsofa/right{dir = 4},/turf/simulated/floor/outdoors/rocks{outdoors = 0},/area/submap/LeopardmanderDen)
"BE" = (/obj/item/stack/material/diamond,/obj/effect/decal/cleanable/dirt,/turf/simulated/floor/outdoors/grass/sif,/area/submap/LeopardmanderDen)
"DI" = (/turf/simulated/floor/outdoors/grass/sif/forest{outdoors = 0},/area/submap/LeopardmanderDen)
"DJ" = (/obj/structure/flora/log1,/turf/simulated/floor/water/ocean{outdoors = 0},/area/submap/LeopardmanderDen)
"Ez" = (/obj/structure/flora/bboulder2,/turf/simulated/floor/outdoors/grass/sif/forest{outdoors = 0},/area/submap/LeopardmanderDen)
"EH" = (/obj/structure/ledge/ledge_stairs,/turf/simulated/floor/outdoors/dirt,/area/template_noop)
"Gl" = (/obj/structure/cliff/automatic{dir = 9},/turf/simulated/floor/outdoors/dirt,/area/template_noop)
"Gw" = (/obj/item/weapon/ore/gold,/obj/effect/decal/cleanable/dirt,/turf/simulated/floor/outdoors/grass/sif/forest{outdoors = 0},/area/submap/LeopardmanderDen)
"Hx" = (/obj/structure/sign/warning/falling,/turf/simulated/wall/sifwood,/area/template_noop)
"HV" = (/obj/structure/bed/chair/oldsofa/left{dir = 4},/turf/simulated/floor/outdoors/rocks{outdoors = 0},/area/submap/LeopardmanderDen)
"Ih" = (/obj/random/obstruction,/turf/template_noop,/area/template_noop)
"IQ" = (/turf/simulated/mineral/ignore_mapgen,/area/submap/LeopardmanderDen)
"Jk" = (/turf/simulated/floor/outdoors/rocks{outdoors = 0},/area/template_noop)
"Kd" = (/obj/structure/cliff/automatic,/obj/structure/railing/grey{dir = 1},/turf/simulated/floor/outdoors/dirt,/area/template_noop)
"Kv" = (/obj/random/outcrop,/turf/template_noop,/area/template_noop)
"KT" = (/obj/structure/flora/ausbushes/brflowers,/obj/structure/flora/tree/winter,/turf/simulated/floor/outdoors/grass/sif/forest,/area/submap/LeopardmanderDen)
"Lb" = (/obj/structure/cliff/automatic{dir = 5},/turf/simulated/floor/outdoors/dirt,/area/template_noop)
"Ls" = (/obj/structure/cliff/automatic{dir = 2},/turf/simulated/floor/outdoors/dirt,/area/template_noop)
"MQ" = (/obj/machinery/crystal/ice,/obj/structure/railing/grey{dir = 8},/turf/simulated/floor/outdoors/dirt,/area/template_noop)
"NS" = (/obj/structure/cliff/automatic{dir = 10},/obj/structure/railing/grey,/turf/simulated/floor/outdoors/dirt,/area/template_noop)
"Pc" = (/obj/item/stack/material/diamond,/turf/simulated/floor/outdoors/grass/sif,/area/submap/LeopardmanderDen)
"Pr" = (/turf/unsimulated/wall/bronze,/area/submap/LeopardmanderDen)
"PO" = (/obj/effect/decal/cleanable/dirt,/obj/structure/flora/rocks2,/turf/simulated/floor/outdoors/grass/sif/forest{outdoors = 0},/area/submap/LeopardmanderDen)
"Qa" = (/obj/machinery/crystal/ice,/turf/simulated/floor/outdoors/rocks{outdoors = 0},/area/submap/LeopardmanderDen)
"QQ" = (/obj/item/stack/material/gold,/obj/effect/decal/cleanable/dirt,/turf/simulated/floor/outdoors/grass/sif/forest{outdoors = 0},/area/submap/LeopardmanderDen)
"RA" = (/obj/fiftyspawner/gold,/turf/simulated/floor/outdoors/grass/sif,/area/submap/LeopardmanderDen)
"Sk" = (/obj/effect/decal/cleanable/dirt,/obj/structure/flora/rocks1,/turf/simulated/floor/outdoors/grass/sif/forest{outdoors = 0},/area/submap/LeopardmanderDen)
"Sm" = (/turf/simulated/floor/outdoors/dirt,/area/template_noop)
"SM" = (/obj/structure/flora/log2,/turf/simulated/floor/water/ocean{outdoors = 0},/area/submap/LeopardmanderDen)
"Te" = (/obj/item/weapon/coin/silver,/turf/simulated/floor/outdoors/grass/sif/forest{outdoors = 0},/area/submap/LeopardmanderDen)
"Tj" = (/mob/living/simple_mob/animal/sif/tymisian{faction = "sif"},/turf/simulated/floor/outdoors/dirt,/area/template_noop)
"Tt" = (/obj/structure/flora/ausbushes/brflowers,/obj/item/weapon/coin/iron,/turf/simulated/floor/outdoors/grass/sif/forest{outdoors = 0},/area/submap/LeopardmanderDen)
"TF" = (/obj/structure/bed/chair/oldsofa/left{dir = 8},/turf/simulated/floor/outdoors/rocks{outdoors = 0},/area/submap/LeopardmanderDen)
"Uc" = (/obj/item/weapon/ore/diamond,/turf/simulated/floor/outdoors/grass/sif,/area/submap/LeopardmanderDen)
"Ul" = (/obj/item/weapon/ore/gold,/turf/simulated/floor/outdoors/grass/sif,/area/submap/LeopardmanderDen)
"UA" = (/obj/structure/flora/ausbushes/brflowers,/obj/item/weapon/coin/gold,/turf/simulated/floor/outdoors/grass/sif/forest{outdoors = 0},/area/submap/LeopardmanderDen)
"Vi" = (/obj/structure/flora/lily2,/turf/simulated/floor/water/ocean{outdoors = 0},/area/submap/LeopardmanderDen)
"Vp" = (/obj/effect/map_effect/interval/effect_emitter/steam,/turf/simulated/floor/water/ocean{outdoors = 0},/area/submap/LeopardmanderDen)
"VM" = (/turf/simulated/wall/gold,/area/submap/LeopardmanderDen)
"VV" = (/obj/structure/flora/lily1,/turf/simulated/floor/water/ocean{outdoors = 0},/area/submap/LeopardmanderDen)
"WB" = (/obj/effect/decal/cleanable/dirt,/turf/simulated/floor/outdoors/rocks{outdoors = 0},/area/submap/LeopardmanderDen)
"Xt" = (/mob/living/simple_mob/vore/leopardmander,/turf/simulated/floor/outdoors/grass/sif/forest{outdoors = 0},/area/submap/LeopardmanderDen)
"XR" = (/obj/effect/map_effect/interval/effect_emitter/steam,/turf/simulated/floor/water/ocean,/area/submap/LeopardmanderDen)
"Yq" = (/obj/structure/cliff/automatic{dir = 4},/turf/simulated/floor/outdoors/dirt,/area/template_noop)
"YJ" = (/obj/item/weapon/ore/diamond,/turf/simulated/floor/outdoors/grass/sif/forest{outdoors = 0},/area/submap/LeopardmanderDen)
"Zj" = (/mob/living/simple_mob/animal/sif/tymisian{faction = "sif"},/turf/simulated/floor/outdoors/grass/sif,/area/submap/LeopardmanderDen)

(1,1,1) = {"
rnrniVLsLsLsLsLsLsLsLsllrnrnrnrnrnrnrnrn
IhiVkOIQIQIQIQIQIQIQIQlbllggSmSmrnSmrnrn
iVkOIQIQIQIQIQPrIQIQIQIQlbLsllggtPSmSmrn
YqIQIQcuxLxfRAxfIQcucuIQIQIQjESmrnSmrnrn
YqIQQaxfBEfeDImuQQgCxLVMIQIQlbllSmTjSmrn
YqIQylbjDIXtnwnwnwnGDIQaIQIQIQlbllSmtPSm
YqIQIQPcPOnwSMnwnwnwDIsNIQIQIQIQjESmSmSm
YqIQIQxfDIVinwAFrDVpAFaKQaIQIQIQjEHxzJSm
YqIQIQIQkxYJnwUAKTEznwTeDIIQIQIQjESmSmSm
YqIQIQPrgUyzroXRTtVVnwDJhrIQIQIQjEslEHMQ
pQLbIQIQDIAhnwnwnwAFnwAhDIxfgDIQjEeDeFmi
SmYqIQIQUcxgnRDJnwnwnwrGxfcucuhiNSmWeFuz
SmYqIQIQxLZjDIhrAFkiaTSkxfcuWBdAuwuwJkuz
SmYqIQIQcuQaPcYJfQGwUlqaxLQaIQVMhwKdKdzW
SmpQLbIQIQcuxLUcxfbOqaoDcuPrIQIQjESmSmrn
rnSmYqIQIQIQIQIQIQcuVMIQIQIQIQGlzWvkIhrn
rnsYpQLbIQIQIQQaHVcuqgIQIQIQIQjESmtPrnrn
rnrnSmpQLbIQIQIQAPcuTFIQIQIQGlzWjbrnrnrn
rnSmIhSmYqIQIQIQIQIQIQIQIQGlzWrnzJrnrnrn
rnrnrnrnpQgPgPgPgPgPgPgPgPzWrnKvrnrnrnrn
"}
