//MAP CONVERTED BY dmm2tgm.py THIS HEADER COMMENT PREVENTS RECONVERSION, DO NOT REMOVE
"a" = (
/turf/simulated/mineral/ignore_mapgen,
/area/template_noop)
"b" = (
/obj/machinery/door/airlock,
/turf/simulated/floor/tiled,
/area/submap/MechHanger)
"d" = (
/turf/simulated/floor/tiled,
/area/submap/MechHanger)
"f" = (
/turf/template_noop,
/area/submap/MechHanger)
"g" = (
/obj/random/humanoidremains{
	spawn_nothing_percentage = 60
	},
/obj/structure/table/bench/padded,
/turf/simulated/floor/tiled,
/area/submap/MechHanger)
"i" = (
/turf/simulated/mineral/ignore_mapgen,
/area/submap/MechHanger)
"p" = (
/turf/simulated/floor/tiled/red,
/area/submap/MechHanger)
"v" = (
/obj/structure/table/standard,
/obj/random/firstaid,
/turf/simulated/floor/tiled,
/area/submap/MechHanger)
"x" = (
/obj/effect/decal/mecha_wreckage/gygax,
/turf/simulated/floor/tiled/red,
/area/submap/MechHanger)
"y" = (
/mob/living/simple_mob/mechanical/mecha/combat/phazon,
/turf/template_noop,
/area/submap/MechHanger)
"z" = (
/obj/effect/decal/mecha_wreckage/durand,
/turf/simulated/floor/tiled/red,
/area/submap/MechHanger)
"A" = (
/turf/template_noop,
/area/template_noop)
"G" = (
/obj/structure/table/standard,
/obj/random/toolbox,
/turf/simulated/floor/tiled,
/area/submap/MechHanger)
"H" = (
/turf/simulated/wall/r_wall,
/area/submap/MechHanger)
"J" = (
/obj/structure/loot_pile/surface/alien/engineering,
/turf/simulated/floor/tiled,
/area/submap/MechHanger)
"M" = (
/obj/effect/decal/mecha_wreckage/ripley/deathripley,
/turf/simulated/floor/tiled/red,
/area/submap/MechHanger)
"Y" = (
/obj/effect/decal/mecha_wreckage/odysseus,
/turf/simulated/floor/tiled/red,
/area/submap/MechHanger)

(1,1,1) = {"
A
A
A
A
A
A
A
A
A
A
A
A
A
A
A
A
A
A
A
A
"}
(2,1,1) = {"
A
A
A
A
A
A
A
A
A
A
A
A
A
A
A
A
A
A
A
A
"}
(3,1,1) = {"
A
A
A
A
a
a
a
a
A
A
A
A
A
A
a
a
A
A
A
A
"}
(4,1,1) = {"
A
A
A
i
i
i
i
i
i
f
f
f
f
i
i
i
i
A
A
A
"}
(5,1,1) = {"
A
A
a
H
H
H
H
H
H
i
f
f
i
i
i
i
i
a
A
A
"}
(6,1,1) = {"
A
A
a
H
d
d
g
J
H
i
f
f
i
i
i
i
i
A
A
A
"}
(7,1,1) = {"
A
a
a
H
d
v
G
d
H
i
i
f
y
i
i
i
f
A
A
A
"}
(8,1,1) = {"
A
a
a
H
d
d
d
d
H
i
i
f
f
f
f
f
f
A
A
A
"}
(9,1,1) = {"
A
a
a
H
H
b
H
H
H
i
i
f
f
f
f
f
f
A
A
A
"}
(10,1,1) = {"
A
a
a
H
x
d
d
p
H
i
i
i
f
f
f
f
f
a
a
A
"}
(11,1,1) = {"
A
a
a
H
d
d
d
d
H
i
i
i
f
f
f
f
i
a
a
a
"}
(12,1,1) = {"
A
a
a
H
M
d
d
p
H
i
i
i
i
f
f
f
i
a
a
a
"}
(13,1,1) = {"
A
A
a
H
d
d
d
d
H
i
i
i
f
f
f
i
i
a
a
A
"}
(14,1,1) = {"
A
A
a
H
z
d
d
Y
H
i
i
f
f
f
f
f
i
a
A
A
"}
(15,1,1) = {"
A
A
a
H
d
d
d
d
H
i
f
f
f
f
f
f
f
A
A
A
"}
(16,1,1) = {"
A
A
a
H
d
d
d
d
d
f
f
f
f
f
f
f
f
A
A
A
"}
(17,1,1) = {"
A
A
a
H
d
d
d
d
d
f
f
f
i
i
f
f
f
A
A
A
"}
(18,1,1) = {"
A
A
a
H
d
d
d
d
d
f
f
i
i
i
i
f
f
A
A
A
"}
(19,1,1) = {"
A
A
a
H
H
H
H
H
H
f
i
i
i
i
f
f
f
A
A
A
"}
(20,1,1) = {"
A
A
A
i
i
i
i
i
i
f
f
i
i
i
y
f
f
a
A
A
"}
(21,1,1) = {"
A
A
A
i
i
i
i
i
i
f
f
f
i
f
f
f
i
a
a
A
"}
(22,1,1) = {"
A
A
A
f
i
i
i
i
i
f
f
f
f
f
f
i
i
a
a
A
"}
(23,1,1) = {"
A
A
A
A
a
a
a
a
A
A
A
A
A
A
A
A
a
a
A
A
"}
(24,1,1) = {"
A
A
A
A
A
a
a
a
A
A
A
A
A
A
A
A
A
A
A
A
"}
(25,1,1) = {"
A
A
A
A
A
A
A
A
A
A
A
A
A
A
A
A
A
A
A
A
"}
