//MAP CONVERTED BY dmm2tgm.py THIS HEADER COMMENT PREVENTS RECONVERSION, DO NOT REMOVE
"a" = (
/turf/simulated/floor/outdoors/dirt,
/area/submap/SyndiSniper)
"d" = (
/obj/structure/ledge/ledge_stairs,
/obj/structure/ledge/ledge_stairs,
/obj/structure/barricade,
/turf/simulated/floor/outdoors/rocks,
/area/submap/SyndiSniper)
"g" = (
/obj/structure/cliff/automatic/corner{
	dir = 9
	},
/turf/simulated/floor/outdoors/dirt,
/area/submap/SyndiSniper)
"j" = (
/obj/structure/table/sifwooden_reinforced,
/obj/item/bluespaceradio/southerncross_prelinked,
/obj/item/storage/mre/random,
/obj/item/binoculars,
/turf/simulated/floor/outdoors/rocks,
/area/submap/SyndiSniper)
"m" = (
/obj/structure/cliff/automatic{
	dir = 4
	},
/obj/structure/railing/grey{
	dir = 4
	},
/turf/simulated/floor/outdoors/dirt,
/area/submap/SyndiSniper)
"n" = (
/obj/structure/ledge/ledge_stairs,
/turf/simulated/floor/outdoors/dirt,
/area/submap/SyndiSniper)
"q" = (
/obj/structure/cliff/automatic{
	dir = 6
	},
/obj/structure/railing/grey{
	dir = 4
	},
/obj/structure/railing/grey,
/turf/simulated/floor/outdoors/dirt,
/area/submap/SyndiSniper)
"v" = (
/mob/living/simple_mob/humanoid/merc/ranged/sniper,
/turf/simulated/floor/outdoors/rocks,
/area/submap/SyndiSniper)
"z" = (
/obj/structure/cliff/automatic/corner{
	dir = 6
	},
/turf/simulated/floor/outdoors/dirt,
/area/submap/SyndiSniper)
"C" = (
/obj/structure/cliff/automatic,
/obj/structure/railing/grey{
	dir = 1
	},
/turf/simulated/floor/outdoors/dirt,
/area/submap/SyndiSniper)
"D" = (
/turf/simulated/floor/outdoors/rocks,
/area/submap/SyndiSniper)
"G" = (
/obj/structure/cliff/automatic{
	dir = 8
	},
/obj/structure/railing/grey{
	dir = 8
	},
/turf/simulated/floor/outdoors/dirt,
/area/submap/SyndiSniper)
"K" = (
/obj/structure/ledge/ledge_stairs,
/turf/simulated/floor/outdoors/rocks,
/area/submap/SyndiSniper)
"O" = (
/obj/structure/cliff/automatic/ramp,
/obj/structure/railing/grey{
	dir = 4
	},
/turf/simulated/floor/outdoors/dirt,
/area/submap/SyndiSniper)
"R" = (
/turf/template_noop,
/area/submap/SyndiSniper)
"S" = (
/obj/structure/cliff/automatic/corner,
/turf/simulated/floor/outdoors/dirt,
/area/submap/SyndiSniper)
"V" = (
/obj/structure/bed/chair,
/mob/living/simple_mob/mechanical/combat_drone{
	faction = "syndicate"
	},
/turf/simulated/floor/outdoors/rocks,
/area/submap/SyndiSniper)
"W" = (
/obj/structure/cliff/automatic/ramp{
	dir = 9
	},
/obj/structure/railing/grey{
	dir = 8
	},
/turf/simulated/floor/outdoors/dirt,
/area/submap/SyndiSniper)

(1,1,1) = {"
R
R
R
a
a
a
R
R
R
R
"}
(2,1,1) = {"
R
R
a
a
a
a
a
a
R
a
"}
(3,1,1) = {"
R
a
a
z
m
m
S
a
R
R
"}
(4,1,1) = {"
a
a
O
q
V
j
C
a
a
R
"}
(5,1,1) = {"
a
n
K
d
D
v
C
a
a
a
"}
(6,1,1) = {"
a
a
W
G
G
G
g
a
a
R
"}
(7,1,1) = {"
R
R
a
a
a
a
a
a
R
R
"}
(8,1,1) = {"
R
R
R
a
a
a
a
R
a
R
"}
(9,1,1) = {"
R
R
R
a
R
R
a
a
R
a
"}
(10,1,1) = {"
R
R
R
R
R
R
R
R
R
R
"}
