//MAP CONVERTED BY dmm2tgm.py THIS HEADER COMMENT PREVENTS RECONVERSION, DO NOT REMOVE
"a" = (
/turf/simulated/mineral/ignore_mapgen,
/area/submap/cave/ratden)
"b" = (
/turf/template_noop,
/area/template_noop)
"c" = (
/obj/effect/decal/cleanable/cobweb,
/turf/simulated/mineral/floor/ignore_mapgen,
/area/submap/cave/ratden)
"d" = (
/obj/effect/decal/cleanable/blood/tracks/paw,
/obj/effect/decal/cleanable/blood/drip,
/turf/simulated/mineral/floor/ignore_mapgen,
/area/submap/cave/ratden)
"e" = (
/obj/structure/barricade,
/turf/simulated/mineral/floor/ignore_mapgen,
/area/submap/cave/ratden)
"f" = (
/obj/structure/barricade,
/obj/effect/decal/cleanable/blood/tracks/paw,
/obj/effect/decal/cleanable/blood/drip,
/turf/simulated/mineral/floor/ignore_mapgen,
/area/submap/cave/ratden)
"g" = (
/turf/simulated/mineral/floor/ignore_mapgen,
/area/submap/cave/ratden)
"h" = (
/mob/living/simple_mob/vore/aggressive/rat,
/turf/simulated/mineral/floor/ignore_mapgen,
/area/submap/cave/ratden)
"i" = (
/obj/effect/decal/cleanable/blood/tracks/paw,
/obj/effect/decal/cleanable/blood/drip,
/obj/effect/decal/cleanable/blood/drip,
/turf/simulated/mineral/floor/ignore_mapgen,
/area/submap/cave/ratden)
"j" = (
/obj/structure/outcrop/diamond,
/turf/simulated/mineral/floor/ignore_mapgen,
/area/submap/cave/ratden)
"k" = (
/obj/effect/decal/cleanable/blood/tracks/paw,
/obj/effect/decal/cleanable/blood/tracks/paw,
/obj/effect/decal/cleanable/blood/drip,
/turf/simulated/mineral/floor/ignore_mapgen,
/area/submap/cave/ratden)
"l" = (
/obj/structure/girder,
/turf/simulated/mineral/floor/ignore_mapgen,
/area/submap/cave/ratden)
"m" = (
/obj/effect/decal/cleanable/blood,
/obj/effect/decal/cleanable/blood/drip,
/turf/simulated/mineral/floor/ignore_mapgen,
/area/submap/cave/ratden)
"n" = (
/obj/effect/decal/cleanable/blood,
/turf/simulated/mineral/floor/ignore_mapgen,
/area/submap/cave/ratden)
"o" = (
/obj/effect/decal/cleanable/blood/drip,
/turf/simulated/mineral/floor/ignore_mapgen,
/area/submap/cave/ratden)
"p" = (
/obj/item/pickaxe/diamond,
/turf/simulated/mineral/floor/ignore_mapgen,
/area/submap/cave/ratden)
"q" = (
/obj/structure/frame,
/turf/simulated/mineral/floor/ignore_mapgen,
/area/submap/cave/ratden)
"r" = (
/obj/structure/bonfire/permanent,
/turf/simulated/mineral/floor/ignore_mapgen,
/area/submap/cave/ratden)
"s" = (
/obj/structure/barricade,
/obj/effect/decal/cleanable/blood/drip,
/turf/simulated/mineral/floor/ignore_mapgen,
/area/submap/cave/ratden)
"t" = (
/obj/effect/decal/cleanable/blood,
/mob/living/simple_mob/vore/aggressive/rat,
/turf/simulated/mineral/floor/ignore_mapgen,
/area/submap/cave/ratden)

(1,1,1) = {"
b
b
b
a
a
a
a
a
a
a
a
a
"}
(2,1,1) = {"
b
b
b
a
c
g
g
g
g
n
n
a
"}
(3,1,1) = {"
b
b
b
a
g
g
g
h
g
g
n
a
"}
(4,1,1) = {"
a
a
a
a
g
g
g
g
g
g
n
a
"}
(5,1,1) = {"
c
e
g
g
g
g
g
g
g
g
g
a
"}
(6,1,1) = {"
d
d
d
i
g
g
g
q
g
g
g
a
"}
(7,1,1) = {"
e
g
g
d
g
g
g
g
g
g
g
a
"}
(8,1,1) = {"
a
a
g
d
d
m
m
r
g
g
n
a
"}
(9,1,1) = {"
a
a
a
g
d
g
o
o
g
g
g
a
"}
(10,1,1) = {"
a
a
h
j
d
n
g
o
g
g
n
a
"}
(11,1,1) = {"
f
d
d
d
k
g
p
o
g
g
g
a
"}
(12,1,1) = {"
e
g
g
g
g
g
g
o
g
g
g
a
"}
(13,1,1) = {"
a
a
a
a
g
g
g
o
g
g
g
a
"}
(14,1,1) = {"
b
b
b
a
h
g
g
o
g
g
n
a
"}
(15,1,1) = {"
b
b
b
a
l
g
g
o
g
n
t
a
"}
(16,1,1) = {"
b
b
b
a
a
a
a
s
a
a
a
a
"}
