//MAP CONVERTED BY dmm2tgm.py THIS HEADER COMMENT PREVENTS RECONVERSION, DO NOT REMOVE
"aH" = (
/obj/structure/bed/chair/office/dark{
	dir = 1
	},
/obj/effect/floor_decal/corner/paleblue/diagonal{
	dir = 4
	},
/turf/simulated/floor/tiled/white,
/area/survivalpod/superpose/AnimalHospital)
"aP" = (
/obj/structure/table/glass,
/obj/item/storage/firstaid/toxin,
/obj/item/laser_pointer,
/turf/simulated/floor/tiled/white,
/area/survivalpod/superpose/AnimalHospital)
"bc" = (
/obj/structure/table/rack/shelf/steel,
/obj/item/gps,
/obj/item/gun/energy/locked/phasegun/pistol,
/obj/item/gun/energy/locked/phasegun/pistol,
/obj/item/cell/device/weapon,
/obj/item/cell/device/weapon,
/turf/simulated/floor/tiled/white,
/area/survivalpod/superpose/AnimalHospital)
"cf" = (
/obj/structure/table/glass,
/obj/item/storage/box/gloves{
	pixel_x = 4;
	pixel_y = 4
	},
/obj/item/storage/box/masks,
/obj/item/reagent_containers/spray/cleaner,
/obj/item/reagent_containers/glass/rag,
/turf/simulated/floor/tiled/white,
/area/survivalpod/superpose/AnimalHospital)
"cG" = (
/obj/structure/table/standard,
/obj/item/stack/medical/advanced/bruise_pack,
/obj/item/surgical/bioregen,
/obj/item/autopsy_scanner,
/turf/simulated/floor/tiled/white,
/area/survivalpod/superpose/AnimalHospital)
"cS" = (
/obj/effect/floor_decal/corner/paleblue{
	dir = 9
	},
/obj/machinery/space_heater,
/turf/simulated/floor/tiled,
/area/survivalpod/superpose/AnimalHospital)
"cX" = (
/obj/structure/flora/pottedplant,
/turf/simulated/floor/tiled,
/area/survivalpod/superpose/AnimalHospital)
"cY" = (
/obj/effect/floor_decal/corner/paleblue,
/turf/simulated/floor/tiled,
/area/survivalpod/superpose/AnimalHospital)
"dy" = (
/obj/structure/sign/redcross{
	icon_state = "bluecross2";
	pixel_y = -31
	},
/obj/effect/floor_decal/corner/paleblue{
	dir = 10
	},
/turf/simulated/floor/tiled,
/area/survivalpod/superpose/AnimalHospital)
"dG" = (
/obj/effect/floor_decal/corner/red/diagonal,
/obj/machinery/door/airlock/medical{
	req_one_access = null
	},
/turf/simulated/floor/tiled,
/area/survivalpod/superpose/AnimalHospital)
"ep" = (
/obj/effect/floor_decal/corner/paleblue/full{
	dir = 4
	},
/obj/structure/bed/chair/comfy/blue{
	dir = 8
	},
/turf/simulated/floor/tiled,
/area/survivalpod/superpose/AnimalHospital)
"eN" = (
/obj/effect/floor_decal/corner/paleblue{
	dir = 5
	},
/turf/simulated/floor/tiled,
/area/survivalpod/superpose/AnimalHospital)
"eU" = (
/obj/structure/bed/roller,
/obj/machinery/light{
	dir = 4
	},
/turf/simulated/floor/tiled/white,
/area/survivalpod/superpose/AnimalHospital)
"fg" = (
/obj/structure/table/rack/shelf/steel,
/obj/item/denecrotizer/medical,
/obj/machinery/light/small{
	dir = 8
	},
/turf/simulated/floor/tiled/white,
/area/survivalpod/superpose/AnimalHospital)
"fK" = (
/obj/effect/floor_decal/corner/paleblue{
	dir = 9
	},
/obj/structure/stasis_cage,
/turf/simulated/floor/tiled,
/area/survivalpod/superpose/AnimalHospital)
"fZ" = (
/obj/structure/bed/chair/office/dark{
	dir = 4
	},
/obj/effect/floor_decal/corner/paleblue/diagonal{
	dir = 4
	},
/turf/simulated/floor/tiled/white,
/area/survivalpod/superpose/AnimalHospital)
"gy" = (
/obj/structure/closet/l3closet/virology,
/turf/simulated/floor/tiled/white,
/area/survivalpod/superpose/AnimalHospital)
"gX" = (
/obj/effect/floor_decal/corner/paleblue{
	dir = 6
	},
/turf/simulated/floor/tiled,
/area/survivalpod/superpose/AnimalHospital)
"hM" = (
/obj/structure/table/standard,
/obj/random/plushie,
/obj/effect/floor_decal/corner/paleblue/diagonal{
	dir = 4
	},
/turf/simulated/floor/tiled/white,
/area/survivalpod/superpose/AnimalHospital)
"iQ" = (
/obj/effect/floor_decal/corner/paleblue{
	dir = 6
	},
/obj/machinery/light/small{
	dir = 4
	},
/obj/structure/cable/green{
	d1 = 1;
	d2 = 2;
	icon_state = "1-2"
	},
/turf/simulated/floor/tiled,
/area/survivalpod/superpose/AnimalHospital)
"ji" = (
/obj/effect/floor_decal/corner/paleblue{
	dir = 9
	},
/obj/structure/cable{
	d1 = 1;
	d2 = 8;
	icon_state = "1-8"
	},
/turf/simulated/floor/tiled,
/area/survivalpod/superpose/AnimalHospital)
"ki" = (
/obj/structure/flora/bush,
/turf/simulated/floor/outdoors/dirt,
/area/survivalpod/superpose/AnimalHospital)
"ko" = (
/obj/structure/table/glass,
/obj/item/storage/backpack/dufflebag/med,
/obj/item/flashlight/pen,
/obj/item/clothing/accessory/stethoscope,
/turf/simulated/floor/tiled/white,
/area/survivalpod/superpose/AnimalHospital)
"kL" = (
/obj/effect/floor_decal/steeldecal/steel_decals4{
	dir = 8
	},
/obj/effect/floor_decal/steeldecal/steel_decals4{
	dir = 5
	},
/turf/simulated/floor/tiled,
/area/survivalpod/superpose/AnimalHospital)
"kW" = (
/obj/effect/floor_decal/corner/paleblue{
	dir = 5
	},
/obj/structure/table/standard,
/obj/item/reagent_containers/food/snacks/cookie{
	pixel_y = 3
	},
/obj/item/reagent_containers/food/snacks/cookie{
	pixel_y = 6
	},
/obj/machinery/light{
	dir = 1
	},
/obj/item/reagent_containers/food/snacks/cookie{
	pixel_y = 3
	},
/turf/simulated/floor/tiled,
/area/survivalpod/superpose/AnimalHospital)
"lz" = (
/obj/structure/table/rack/shelf/steel,
/obj/item/storage/box/bodybags,
/obj/item/storage/box/freezer,
/obj/item/storage/box/freezer,
/turf/simulated/floor/tiled/white,
/area/survivalpod/superpose/AnimalHospital)
"lA" = (
/obj/effect/floor_decal/corner/paleblue/diagonal{
	dir = 4
	},
/obj/machinery/light/small{
	dir = 4
	},
/turf/simulated/floor/tiled/white,
/area/survivalpod/superpose/AnimalHospital)
"lS" = (
/obj/effect/floor_decal/corner/paleblue{
	dir = 6
	},
/obj/structure/cable/green{
	d1 = 1;
	d2 = 8;
	icon_state = "1-8"
	},
/turf/simulated/floor/tiled,
/area/survivalpod/superpose/AnimalHospital)
"mC" = (
/obj/effect/floor_decal/corner/paleblue/border,
/turf/simulated/floor/tiled,
/area/survivalpod/superpose/AnimalHospital)
"mR" = (
/obj/effect/floor_decal/steeldecal/steel_decals4{
	dir = 4
	},
/obj/effect/floor_decal/steeldecal/steel_decals4{
	dir = 9
	},
/turf/simulated/floor/tiled,
/area/survivalpod/superpose/AnimalHospital)
"mU" = (
/obj/effect/floor_decal/corner/paleblue{
	dir = 6
	},
/obj/structure/cable/green{
	d1 = 1;
	d2 = 2;
	icon_state = "1-2"
	},
/turf/simulated/floor/tiled,
/area/survivalpod/superpose/AnimalHospital)
"mZ" = (
/obj/effect/floor_decal/corner/paleblue{
	dir = 6
	},
/obj/structure/bed/chair/comfy/blue{
	dir = 8
	},
/turf/simulated/floor/tiled,
/area/survivalpod/superpose/AnimalHospital)
"nT" = (
/obj/structure/table/standard,
/obj/item/surgical/FixOVein{
	pixel_x = 5
	},
/obj/item/surgical/bonegel{
	pixel_x = -5;
	pixel_y = 2
	},
/obj/item/surgical/bonesetter{
	pixel_x = 2
	},
/turf/simulated/floor/tiled/white,
/area/survivalpod/superpose/AnimalHospital)
"oa" = (
/obj/structure/table/standard,
/obj/item/surgical/hemostat{
	pixel_x = -4
	},
/obj/item/surgical/retractor,
/turf/simulated/floor/tiled/white,
/area/survivalpod/superpose/AnimalHospital)
"oC" = (
/obj/structure/closet,
/obj/item/gun/launcher/syringe,
/obj/item/storage/box/syringegun,
/obj/random/cigarettes,
/obj/item/storage/box/syringes,
/obj/item/storage/box/matches,
/obj/machinery/light/small{
	dir = 8
	},
/turf/simulated/floor/plating,
/area/survivalpod/superpose/AnimalHospital)
"py" = (
/obj/structure/table/standard,
/obj/item/flashlight/lamp,
/obj/effect/floor_decal/corner/paleblue/diagonal{
	dir = 4
	},
/turf/simulated/floor/tiled/white,
/area/survivalpod/superpose/AnimalHospital)
"qk" = (
/obj/structure/table/reinforced,
/obj/item/clothing/suit/surgicalapron,
/obj/item/clothing/gloves/sterile,
/obj/item/clothing/mask/surgical,
/turf/simulated/floor/tiled/white,
/area/survivalpod/superpose/AnimalHospital)
"qw" = (
/obj/effect/floor_decal/corner/paleblue/border,
/obj/structure/cable{
	d1 = 2;
	d2 = 4;
	icon_state = "2-4"
	},
/turf/simulated/floor/tiled,
/area/survivalpod/superpose/AnimalHospital)
"qL" = (
/obj/effect/floor_decal/corner/paleblue/diagonal{
	dir = 4
	},
/obj/machinery/light/small{
	dir = 8
	},
/turf/simulated/floor/tiled/white,
/area/survivalpod/superpose/AnimalHospital)
"qQ" = (
/obj/structure/table/glass,
/obj/item/storage/firstaid/regular,
/turf/simulated/floor/tiled/white,
/area/survivalpod/superpose/AnimalHospital)
"rl" = (
/obj/item/storage/bag/trash,
/turf/simulated/floor/outdoors/dirt,
/area/survivalpod/superpose/AnimalHospital)
"rI" = (
/obj/fiftyspawner/titanium,
/obj/item/stack/cable_coil/silver,
/obj/structure/cable{
	d1 = 1;
	d2 = 2;
	icon_state = "1-2"
	},
/obj/item/stack/material/phoron{
	amount = 25
	},
/turf/simulated/floor/plating,
/area/survivalpod/superpose/AnimalHospital)
"st" = (
/obj/machinery/light{
	dir = 4
	},
/obj/structure/bed/padded,
/turf/simulated/floor/tiled/white,
/area/survivalpod/superpose/AnimalHospital)
"su" = (
/obj/machinery/door/airlock/multi_tile/glass{
	name = "Animal Hospital"
	},
/turf/simulated/floor/tiled,
/area/survivalpod/superpose/AnimalHospital)
"sI" = (
/obj/structure/reagent_dispensers/fueltank,
/obj/item/flashlight/glowstick/blue,
/obj/item/flashlight/glowstick/blue,
/obj/item/flashlight/glowstick/blue,
/obj/item/flashlight,
/obj/machinery/light/small{
	dir = 4
	},
/obj/structure/cable{
	d1 = 1;
	d2 = 2;
	icon_state = "1-2"
	},
/turf/simulated/floor/plating,
/area/survivalpod/superpose/AnimalHospital)
"sM" = (
/obj/structure/table/standard,
/obj/item/surgical/cautery{
	pixel_x = 2
	},
/obj/item/surgical/surgicaldrill,
/turf/simulated/floor/tiled/white,
/area/survivalpod/superpose/AnimalHospital)
"sV" = (
/obj/structure/table/glass,
/obj/item/reagent_containers/dropper,
/obj/item/storage/box/beakers,
/turf/simulated/floor/tiled/white,
/area/survivalpod/superpose/AnimalHospital)
"tq" = (
/obj/effect/floor_decal/steeldecal/steel_decals4{
	dir = 1
	},
/obj/effect/floor_decal/steeldecal/steel_decals4{
	dir = 6
	},
/turf/simulated/floor/tiled,
/area/survivalpod/superpose/AnimalHospital)
"vx" = (
/obj/effect/floor_decal/corner/paleblue{
	dir = 10
	},
/turf/simulated/floor/tiled,
/area/survivalpod/superpose/AnimalHospital)
"wc" = (
/obj/structure/table/reinforced,
/turf/simulated/floor/tiled,
/area/survivalpod/superpose/AnimalHospital)
"wm" = (
/obj/structure/table/reinforced,
/obj/effect/floor_decal/corner/paleblue{
	dir = 9
	},
/obj/item/flashlight/lamp,
/turf/simulated/floor/tiled,
/area/survivalpod/superpose/AnimalHospital)
"wx" = (
/obj/structure/bed/chair/office/dark,
/turf/simulated/floor/tiled,
/area/survivalpod/superpose/AnimalHospital)
"wB" = (
/obj/machinery/vending/wallmed1/public{
	pixel_y = 32
	},
/obj/machinery/chem_master,
/turf/simulated/floor/tiled/white,
/area/survivalpod/superpose/AnimalHospital)
"wK" = (
/obj/structure/morgue,
/turf/simulated/floor/plating,
/area/survivalpod/superpose/AnimalHospital)
"wP" = (
/obj/structure/flora/ausbushes/pointybush,
/turf/simulated/floor/outdoors/dirt,
/area/survivalpod/superpose/AnimalHospital)
"yz" = (
/obj/structure/filingcabinet/chestdrawer,
/turf/simulated/floor/tiled,
/area/survivalpod/superpose/AnimalHospital)
"yU" = (
/obj/effect/floor_decal/corner/red/diagonal,
/obj/structure/sink{
	dir = 8;
	pixel_x = -12;
	pixel_y = 2
	},
/obj/structure/mirror{
	pixel_x = -28
	},
/turf/simulated/floor/tiled,
/area/survivalpod/superpose/AnimalHospital)
"zk" = (
/obj/machinery/door/airlock/glass_medical{
	req_one_access = null
	},
/turf/simulated/floor/tiled/white,
/area/survivalpod/superpose/AnimalHospital)
"zn" = (
/obj/item/toy/cat_toy,
/turf/simulated/floor/tiled/white,
/area/survivalpod/superpose/AnimalHospital)
"Ab" = (
/obj/structure/flora/ausbushes/lavendergrass,
/turf/simulated/floor/outdoors/dirt,
/area/survivalpod/superpose/AnimalHospital)
"Ai" = (
/obj/structure/noticeboard{
	dir = 1;
	pixel_y = -27
	},
/obj/effect/floor_decal/corner/paleblue/diagonal{
	dir = 4
	},
/turf/simulated/floor/tiled/white,
/area/survivalpod/superpose/AnimalHospital)
"Ax" = (
/obj/structure/table/reinforced,
/obj/item/clothing/glasses/regular,
/turf/simulated/floor/tiled,
/area/survivalpod/superpose/AnimalHospital)
"Bv" = (
/obj/effect/floor_decal/corner/paleblue/full,
/obj/structure/table/standard,
/obj/item/cell/high{
	charge = 100;
	maxcharge = 15000
	},
/obj/item/melee/baton/cattleprod,
/obj/machinery/recharger,
/turf/simulated/floor/tiled,
/area/survivalpod/superpose/AnimalHospital)
"BJ" = (
/obj/effect/floor_decal/corner/paleblue{
	dir = 4
	},
/obj/machinery/light{
	dir = 1
	},
/turf/simulated/floor/tiled,
/area/survivalpod/superpose/AnimalHospital)
"BP" = (
/obj/structure/closet/secure_closet/medical1{
	req_access = null
	},
/obj/item/storage/quickdraw/syringe_case,
/obj/item/storage/quickdraw/syringe_case,
/turf/simulated/floor/tiled/white,
/area/survivalpod/superpose/AnimalHospital)
"Cj" = (
/obj/effect/floor_decal/corner/paleblue/border{
	dir = 8
	},
/turf/simulated/floor/tiled,
/area/survivalpod/superpose/AnimalHospital)
"Di" = (
/obj/effect/floor_decal/corner/red/diagonal,
/obj/machinery/light/small{
	dir = 8
	},
/turf/simulated/floor/tiled,
/area/survivalpod/superpose/AnimalHospital)
"DG" = (
/obj/effect/floor_decal/corner/paleblue{
	dir = 9
	},
/obj/structure/cable{
	d1 = 1;
	d2 = 2;
	icon_state = "1-2"
	},
/turf/simulated/floor/tiled,
/area/survivalpod/superpose/AnimalHospital)
"FF" = (
/obj/structure/grille,
/obj/structure/window/reinforced/full,
/obj/machinery/power/terminal{
	dir = 8
	},
/obj/structure/cable{
	d2 = 4;
	icon_state = "0-4"
	},
/turf/simulated/floor/plating,
/area/survivalpod/superpose/AnimalHospital)
"GG" = (
/obj/effect/floor_decal/corner/paleblue{
	dir = 6
	},
/obj/machinery/light/small{
	dir = 4
	},
/turf/simulated/floor/tiled,
/area/survivalpod/superpose/AnimalHospital)
"Hd" = (
/obj/structure/table/glass,
/obj/item/storage/firstaid/adv{
	pixel_y = 5
	},
/obj/item/storage/firstaid/regular,
/obj/item/clothing/accessory/stethoscope,
/obj/item/clothing/suit/storage/toggle/labcoat,
/obj/item/clothing/suit/storage/toggle/labcoat,
/obj/item/clothing/suit/storage/toggle/labcoat,
/obj/item/flashlight/pen,
/obj/item/flashlight/pen,
/turf/simulated/floor/tiled/white,
/area/survivalpod/superpose/AnimalHospital)
"Hl" = (
/obj/structure/closet/crate/trashcart,
/obj/item/reagent_containers/food/drinks/bottle/vodka,
/turf/simulated/floor/outdoors/dirt,
/area/survivalpod/superpose/AnimalHospital)
"Hn" = (
/obj/effect/floor_decal/corner/paleblue{
	dir = 8
	},
/obj/structure/closet/crate/bin{
	anchored = 1
	},
/obj/item/lipstick/random,
/turf/simulated/floor/tiled,
/area/survivalpod/superpose/AnimalHospital)
"Hz" = (
/obj/structure/table/glass,
/obj/machinery/light/small,
/obj/item/storage/box/lights/mixed,
/turf/simulated/floor/tiled/white,
/area/survivalpod/superpose/AnimalHospital)
"HK" = (
/obj/effect/floor_decal/corner/paleblue{
	dir = 5
	},
/obj/structure/extinguisher_cabinet{
	pixel_y = 30
	},
/turf/simulated/floor/tiled,
/area/survivalpod/superpose/AnimalHospital)
"HP" = (
/obj/effect/floor_decal/corner/red/diagonal,
/obj/structure/toilet,
/turf/simulated/floor/tiled,
/area/survivalpod/superpose/AnimalHospital)
"Ih" = (
/obj/machinery/light{
	dir = 8
	},
/turf/simulated/floor/tiled/white,
/area/survivalpod/superpose/AnimalHospital)
"Iq" = (
/turf/simulated/floor/tiled/white,
/area/survivalpod/superpose/AnimalHospital)
"IC" = (
/obj/structure/table/reinforced,
/obj/item/paper_bin,
/obj/item/pen,
/turf/simulated/floor/tiled,
/area/survivalpod/superpose/AnimalHospital)
"IH" = (
/obj/effect/floor_decal/corner/paleblue{
	dir = 9
	},
/obj/structure/table/standard,
/obj/item/tank/oxygen,
/obj/item/clothing/mask/breath,
/obj/item/gun/energy/netgun,
/turf/simulated/floor/tiled,
/area/survivalpod/superpose/AnimalHospital)
"IW" = (
/obj/structure/table/glass,
/obj/item/storage/firstaid/fire,
/turf/simulated/floor/tiled/white,
/area/survivalpod/superpose/AnimalHospital)
"Jl" = (
/obj/effect/floor_decal/corner/paleblue/diagonal{
	dir = 4
	},
/obj/machinery/door/airlock/glass_medical{
	req_one_access = null
	},
/turf/simulated/floor/tiled/white,
/area/survivalpod/superpose/AnimalHospital)
"Jr" = (
/obj/structure/table/standard,
/obj/item/surgical/scalpel{
	pixel_y = 11
	},
/obj/item/surgical/circular_saw,
/turf/simulated/floor/tiled/white,
/area/survivalpod/superpose/AnimalHospital)
"JP" = (
/obj/structure/table/reinforced,
/obj/item/radio/phone,
/turf/simulated/floor/tiled,
/area/survivalpod/superpose/AnimalHospital)
"Kd" = (
/obj/machinery/vending/wallmed1/public{
	pixel_y = 32
	},
/turf/simulated/floor/tiled/white,
/area/survivalpod/superpose/AnimalHospital)
"KP" = (
/obj/effect/floor_decal/corner/paleblue/diagonal{
	dir = 4
	},
/turf/simulated/floor/tiled/white,
/area/survivalpod/superpose/AnimalHospital)
"KQ" = (
/turf/simulated/floor/outdoors/dirt,
/area/survivalpod/superpose/AnimalHospital)
"KZ" = (
/obj/effect/floor_decal/corner/red/diagonal,
/turf/simulated/floor/tiled,
/area/survivalpod/superpose/AnimalHospital)
"Ls" = (
/obj/effect/floor_decal/corner/paleblue{
	dir = 6
	},
/obj/machinery/power/apc{
	dir = 4;
	pixel_x = 26
	},
/obj/structure/cable/green{
	d2 = 2;
	icon_state = "0-2"
	},
/turf/simulated/floor/tiled,
/area/survivalpod/superpose/AnimalHospital)
"LW" = (
/obj/effect/floor_decal/corner/paleblue/full{
	dir = 1
	},
/obj/structure/closet/crate/medical/blood,
/obj/item/reagent_containers/blood/prelabeled/BPlus,
/obj/item/reagent_containers/blood/prelabeled/AMinus,
/obj/item/reagent_containers/blood/prelabeled/BMinus,
/obj/item/reagent_containers/blood/prelabeled/APlus,
/obj/item/reagent_containers/blood/prelabeled/OPlus,
/obj/item/reagent_containers/blood/prelabeled/OMinus,
/obj/structure/medical_stand,
/turf/simulated/floor/tiled,
/area/survivalpod/superpose/AnimalHospital)
"Mb" = (
/obj/structure/grille,
/obj/structure/window/reinforced/full,
/turf/simulated/floor/plating,
/area/survivalpod/superpose/AnimalHospital)
"Mw" = (
/obj/machinery/power/rtg/advanced,
/obj/structure/cable,
/turf/simulated/floor/plating,
/area/survivalpod/superpose/AnimalHospital)
"Mx" = (
/obj/machinery/power/port_gen/pacman,
/turf/simulated/floor/outdoors/dirt,
/area/survivalpod/superpose/AnimalHospital)
"MA" = (
/obj/structure/table/standard,
/obj/machinery/chemical_dispenser/full,
/obj/item/reagent_containers/glass/beaker/large,
/turf/simulated/floor/tiled/white,
/area/survivalpod/superpose/AnimalHospital)
"MS" = (
/obj/effect/floor_decal/corner/paleblue/full{
	dir = 4
	},
/obj/structure/closet,
/obj/item/storage/belt/medical,
/obj/item/storage/belt/medical,
/obj/item/clothing/glasses/hud/health,
/obj/item/clothing/glasses/hud/health,
/obj/item/clothing/glasses/hud/health,
/obj/item/defib_kit/loaded,
/turf/simulated/floor/tiled,
/area/survivalpod/superpose/AnimalHospital)
"Nv" = (
/obj/machinery/optable,
/turf/simulated/floor/tiled/white,
/area/survivalpod/superpose/AnimalHospital)
"ND" = (
/turf/simulated/floor/tiled,
/area/survivalpod/superpose/AnimalHospital)
"Og" = (
/turf/simulated/wall/titanium,
/area/survivalpod/superpose/AnimalHospital)
"OH" = (
/obj/effect/floor_decal/corner/paleblue{
	dir = 10
	},
/obj/structure/cable{
	d1 = 4;
	d2 = 8;
	icon_state = "4-8"
	},
/turf/simulated/floor/tiled,
/area/survivalpod/superpose/AnimalHospital)
"OL" = (
/obj/machinery/light/small{
	dir = 1
	},
/obj/machinery/power/smes/batteryrack/mapped,
/obj/structure/cable/green{
	d2 = 2;
	icon_state = "0-2"
	},
/turf/simulated/floor/tiled/white,
/area/survivalpod/superpose/AnimalHospital)
"OW" = (
/obj/machinery/door/airlock/glass_medical{
	req_one_access = null
	},
/turf/simulated/floor/tiled,
/area/survivalpod/superpose/AnimalHospital)
"Pd" = (
/obj/machinery/smartfridge/secure/medbay{
	req_one_access = null
	},
/turf/simulated/wall/titanium,
/area/survivalpod/superpose/AnimalHospital)
"PB" = (
/obj/structure/flora/ausbushes/brflowers,
/turf/simulated/floor/outdoors/dirt,
/area/survivalpod/superpose/AnimalHospital)
"PK" = (
/obj/structure/medical_stand/anesthetic,
/turf/simulated/floor/tiled/white,
/area/survivalpod/superpose/AnimalHospital)
"Qq" = (
/obj/machinery/door/airlock/medical{
	req_one_access = null
	},
/turf/simulated/floor/tiled/white,
/area/survivalpod/superpose/AnimalHospital)
"RM" = (
/obj/machinery/computer/operating{
	dir = 4
	},
/turf/simulated/floor/tiled/white,
/area/survivalpod/superpose/AnimalHospital)
"St" = (
/obj/machinery/vending/coffee,
/obj/effect/floor_decal/corner/paleblue/diagonal{
	dir = 4
	},
/turf/simulated/floor/tiled/white,
/area/survivalpod/superpose/AnimalHospital)
"SH" = (
/obj/machinery/vending/snack,
/obj/effect/floor_decal/corner/paleblue/diagonal{
	dir = 4
	},
/turf/simulated/floor/tiled/white,
/area/survivalpod/superpose/AnimalHospital)
"SY" = (
/obj/structure/table/standard,
/obj/item/taperecorder,
/obj/item/pen/blue{
	pixel_x = 5;
	pixel_y = 5
	},
/obj/effect/floor_decal/corner/paleblue/diagonal{
	dir = 4
	},
/turf/simulated/floor/tiled/white,
/area/survivalpod/superpose/AnimalHospital)
"Te" = (
/obj/effect/floor_decal/corner/paleblue{
	dir = 10
	},
/obj/machinery/light/small,
/turf/simulated/floor/tiled,
/area/survivalpod/superpose/AnimalHospital)
"Tm" = (
/obj/effect/floor_decal/corner/paleblue/full,
/obj/machinery/space_heater,
/turf/simulated/floor/tiled,
/area/survivalpod/superpose/AnimalHospital)
"Vc" = (
/obj/effect/floor_decal/corner/paleblue/full{
	dir = 1
	},
/obj/structure/bed/chair/comfy/blue{
	dir = 8
	},
/turf/simulated/floor/tiled,
/area/survivalpod/superpose/AnimalHospital)
"Vr" = (
/turf/template_noop,
/area/survivalpod/superpose/AnimalHospital)
"Vt" = (
/obj/structure/cable/green{
	d1 = 1;
	d2 = 4;
	icon_state = "1-4"
	},
/turf/simulated/floor/tiled/white,
/area/survivalpod/superpose/AnimalHospital)
"VV" = (
/obj/structure/flora/ausbushes/fullgrass,
/turf/simulated/floor/outdoors/dirt,
/area/survivalpod/superpose/AnimalHospital)
"Wq" = (
/obj/structure/bed/chair/office/dark{
	dir = 1
	},
/obj/machinery/light{
	dir = 4
	},
/turf/simulated/floor/tiled/white,
/area/survivalpod/superpose/AnimalHospital)
"Wu" = (
/obj/machinery/door/airlock/medical{
	req_one_access = null
	},
/obj/structure/cable{
	d1 = 1;
	d2 = 2;
	icon_state = "1-2"
	},
/turf/simulated/floor/plating,
/area/survivalpod/superpose/AnimalHospital)
"Ww" = (
/obj/effect/floor_decal/corner/paleblue/border{
	dir = 1
	},
/turf/simulated/floor/tiled,
/area/survivalpod/superpose/AnimalHospital)
"XF" = (
/obj/effect/floor_decal/corner/paleblue{
	dir = 8
	},
/obj/structure/cable{
	d1 = 2;
	d2 = 8;
	icon_state = "2-8"
	},
/turf/simulated/floor/tiled,
/area/survivalpod/superpose/AnimalHospital)
"XM" = (
/obj/machinery/door/airlock/glass_medical{
	req_one_access = null
	},
/obj/structure/cable/green{
	d1 = 4;
	d2 = 8;
	icon_state = "4-8"
	},
/turf/simulated/floor/tiled/white,
/area/survivalpod/superpose/AnimalHospital)
"Yb" = (
/obj/effect/floor_decal/corner/paleblue{
	dir = 5
	},
/obj/machinery/light/small{
	dir = 1
	},
/turf/simulated/floor/tiled,
/area/survivalpod/superpose/AnimalHospital)
"YV" = (
/obj/machinery/door/airlock/glass_medical{
	req_one_access = null
	},
/turf/simulated/floor/plating,
/area/survivalpod/superpose/AnimalHospital)
"Zl" = (
/obj/effect/floor_decal/corner/paleblue/border{
	dir = 8
	},
/obj/structure/cable/green{
	d1 = 4;
	d2 = 8;
	icon_state = "4-8"
	},
/turf/simulated/floor/tiled,
/area/survivalpod/superpose/AnimalHospital)
"ZZ" = (
/turf/simulated/floor/plating,
/area/survivalpod/superpose/AnimalHospital)

(1,1,1) = {"
Vr
Vr
Vr
Vr
Vr
Vr
Vr
Vr
Vr
Vr
Vr
Vr
Vr
KQ
KQ
Vr
Vr
Vr
Vr
Vr
Vr
Vr
Vr
Vr
Vr
Vr
Vr
Vr
"}
(2,1,1) = {"
Vr
Vr
Vr
Vr
KQ
KQ
Vr
Vr
Vr
KQ
KQ
KQ
Ab
KQ
KQ
KQ
KQ
KQ
KQ
Vr
Vr
Vr
Vr
Vr
Vr
Vr
Vr
Vr
"}
(3,1,1) = {"
Vr
Vr
Vr
KQ
KQ
KQ
Mx
rl
Hl
KQ
PB
Og
Og
Og
Og
Og
KQ
KQ
KQ
KQ
KQ
KQ
Vr
Vr
Vr
Vr
Vr
Vr
"}
(4,1,1) = {"
Vr
Vr
Vr
KQ
Og
Og
Og
Og
Og
OW
Og
Og
oC
wK
wK
Og
Og
Og
Og
Og
Og
KQ
Vr
Vr
Vr
Vr
Vr
Vr
"}
(5,1,1) = {"
Vr
Vr
KQ
KQ
Og
KZ
Di
yU
Og
tq
kL
YV
ZZ
ZZ
ZZ
YV
ND
Hn
wm
Tm
Og
KQ
KQ
Vr
Vr
Vr
Vr
Vr
"}
(6,1,1) = {"
Vr
Vr
Vr
KQ
Og
HP
KZ
KZ
dG
mR
cY
Og
Og
Og
Og
Og
BJ
yz
Ax
vx
Mb
PB
KQ
KQ
Vr
Vr
KQ
KQ
"}
(7,1,1) = {"
Vr
Vr
Vr
KQ
Og
Og
Og
Og
Og
HK
Te
Og
BP
ko
aP
Og
HK
wx
IC
vx
Mb
Ab
KQ
KQ
KQ
Vr
Vr
Vr
"}
(8,1,1) = {"
Vr
Vr
KQ
KQ
Og
St
qL
KP
Jl
Ww
vx
Og
Kd
Iq
zn
Og
eN
JP
wc
dy
Og
wP
PB
Vr
Vr
Vr
Vr
Vr
"}
(9,1,1) = {"
Vr
Vr
Vr
KQ
Mb
py
aH
KP
Og
eN
mC
Qq
Iq
st
Iq
Qq
Ww
ND
ND
mC
su
KQ
Vr
Vr
Vr
Vr
Vr
Vr
"}
(10,1,1) = {"
Vr
KQ
ki
KQ
Mb
SY
KP
Ai
Og
Yb
vx
Og
Og
Og
Pd
Og
kW
cX
ND
mC
ND
KQ
Vr
Vr
Vr
KQ
Vr
Vr
"}
(11,1,1) = {"
Vr
KQ
KQ
KQ
Mb
hM
fZ
KP
Og
eN
mC
Qq
Iq
Iq
Iq
Qq
Ww
ND
ND
vx
Og
VV
KQ
KQ
Vr
Vr
Vr
Vr
"}
(12,1,1) = {"
Vr
Vr
KQ
KQ
Og
SH
lA
KP
Jl
Ww
vx
Og
wB
Iq
qQ
Og
Vc
mZ
mZ
ep
Og
KQ
VV
KQ
KQ
Vr
Vr
Vr
"}
(13,1,1) = {"
Vr
KQ
KQ
PB
Og
Og
Og
Og
Og
eN
vx
Og
MA
Wq
sV
Og
Og
Og
Og
Og
Og
Og
Og
Og
KQ
Vr
Vr
Vr
"}
(14,1,1) = {"
Vr
Vr
KQ
KQ
Og
qk
Ih
PK
Og
eN
vx
Og
Og
Og
Og
Og
Hd
cf
gy
fg
bc
lz
IW
Og
KQ
Vr
Vr
Vr
"}
(15,1,1) = {"
Vr
Vr
KQ
KQ
Og
cG
Iq
Iq
Qq
Ww
qw
Wu
rI
sI
Mw
Og
OL
Vt
Iq
Iq
Iq
Iq
Hz
Og
KQ
Vr
Vr
Vr
"}
(16,1,1) = {"
Vr
Vr
Vr
KQ
Og
Jr
Iq
RM
Og
eN
OH
Og
Og
Og
Og
Og
FF
XM
Mb
Og
Mb
zk
Mb
Og
KQ
Vr
Vr
Vr
"}
(17,1,1) = {"
Vr
Vr
Vr
KQ
Og
sM
Iq
Nv
Og
Yb
XF
DG
DG
DG
DG
DG
ji
Zl
fK
IH
cS
Cj
Bv
Og
KQ
Vr
Vr
Vr
"}
(18,1,1) = {"
Vr
Vr
Vr
KQ
Og
nT
eU
oa
Og
LW
Ls
mU
mU
iQ
mU
mU
iQ
lS
gX
gX
GG
gX
MS
Og
KQ
Vr
Vr
Vr
"}
(19,1,1) = {"
Vr
Vr
Vr
KQ
Og
Og
Og
Og
Og
Og
Og
Og
Og
Og
Og
Og
Og
Og
Og
Og
Og
Og
Og
Og
KQ
Vr
Vr
Vr
"}
(20,1,1) = {"
Vr
Vr
Vr
KQ
KQ
KQ
KQ
KQ
KQ
KQ
KQ
KQ
KQ
KQ
KQ
KQ
KQ
KQ
KQ
KQ
KQ
KQ
KQ
KQ
KQ
Vr
Vr
Vr
"}
