"aH" = (/obj/structure/bed/chair/office/dark{dir = 1},/obj/effect/floor_decal/corner/paleblue/diagonal{dir = 4},/turf/simulated/floor/tiled/white,/area/survivalpod/superpose/AnimalHospital)
"aP" = (/obj/structure/table/glass,/obj/item/weapon/storage/firstaid/toxin,/obj/item/device/laser_pointer,/turf/simulated/floor/tiled/white,/area/survivalpod/superpose/AnimalHospital)
"bc" = (/obj/structure/table/rack/shelf/steel,/obj/item/device/gps,/obj/item/weapon/gun/energy/locked/phasegun/pistol,/obj/item/weapon/gun/energy/locked/phasegun/pistol,/obj/item/weapon/cell/device/weapon,/obj/item/weapon/cell/device/weapon,/turf/simulated/floor/tiled/white,/area/survivalpod/superpose/AnimalHospital)
"cf" = (/obj/structure/table/glass,/obj/item/weapon/storage/box/gloves{pixel_x = 4; pixel_y = 4},/obj/item/weapon/storage/box/masks,/obj/item/weapon/reagent_containers/spray/cleaner,/obj/item/weapon/reagent_containers/glass/rag,/turf/simulated/floor/tiled/white,/area/survivalpod/superpose/AnimalHospital)
"cG" = (/obj/structure/table/standard,/obj/item/stack/medical/advanced/bruise_pack,/obj/item/weapon/surgical/bioregen,/obj/item/weapon/autopsy_scanner,/turf/simulated/floor/tiled/white,/area/survivalpod/superpose/AnimalHospital)
"cS" = (/obj/effect/floor_decal/corner/paleblue{dir = 9},/obj/machinery/space_heater,/turf/simulated/floor/tiled,/area/survivalpod/superpose/AnimalHospital)
"cX" = (/obj/structure/flora/pottedplant,/turf/simulated/floor/tiled,/area/survivalpod/superpose/AnimalHospital)
"cY" = (/obj/effect/floor_decal/corner/paleblue,/turf/simulated/floor/tiled,/area/survivalpod/superpose/AnimalHospital)
"dy" = (/obj/structure/sign/redcross{icon_state = "bluecross2"; pixel_y = -31},/obj/effect/floor_decal/corner/paleblue{dir = 10},/turf/simulated/floor/tiled,/area/survivalpod/superpose/AnimalHospital)
"dG" = (/obj/effect/floor_decal/corner/red/diagonal,/obj/machinery/door/airlock/medical{req_one_access = null},/turf/simulated/floor/tiled,/area/survivalpod/superpose/AnimalHospital)
"ep" = (/obj/effect/floor_decal/corner/paleblue/full{dir = 4},/obj/structure/bed/chair/comfy/blue{dir = 8},/turf/simulated/floor/tiled,/area/survivalpod/superpose/AnimalHospital)
"eN" = (/obj/effect/floor_decal/corner/paleblue{dir = 5},/turf/simulated/floor/tiled,/area/survivalpod/superpose/AnimalHospital)
"eU" = (/obj/structure/bed/roller,/obj/machinery/light{dir = 4},/turf/simulated/floor/tiled/white,/area/survivalpod/superpose/AnimalHospital)
"fg" = (/obj/structure/table/rack/shelf/steel,/obj/item/device/denecrotizer/medical,/obj/machinery/light/small{dir = 8},/turf/simulated/floor/tiled/white,/area/survivalpod/superpose/AnimalHospital)
"fK" = (/obj/effect/floor_decal/corner/paleblue{dir = 9},/obj/structure/stasis_cage,/turf/simulated/floor/tiled,/area/survivalpod/superpose/AnimalHospital)
"fZ" = (/obj/structure/bed/chair/office/dark{dir = 4},/obj/effect/floor_decal/corner/paleblue/diagonal{dir = 4},/turf/simulated/floor/tiled/white,/area/survivalpod/superpose/AnimalHospital)
"gy" = (/obj/structure/closet/l3closet/virology,/turf/simulated/floor/tiled/white,/area/survivalpod/superpose/AnimalHospital)
"gX" = (/obj/effect/floor_decal/corner/paleblue{dir = 6},/turf/simulated/floor/tiled,/area/survivalpod/superpose/AnimalHospital)
"hM" = (/obj/structure/table/standard,/obj/random/plushie,/obj/effect/floor_decal/corner/paleblue/diagonal{dir = 4},/turf/simulated/floor/tiled/white,/area/survivalpod/superpose/AnimalHospital)
"ji" = (/obj/effect/floor_decal/corner/paleblue{dir = 9},/turf/simulated/floor/tiled,/area/survivalpod/superpose/AnimalHospital)
"ki" = (/obj/structure/flora/bush,/turf/simulated/floor/outdoors/dirt,/area/survivalpod/superpose/AnimalHospital)
"ko" = (/obj/structure/table/glass,/obj/item/weapon/storage/backpack/dufflebag/med,/obj/item/device/flashlight/pen,/obj/item/clothing/accessory/stethoscope,/turf/simulated/floor/tiled/white,/area/survivalpod/superpose/AnimalHospital)
"kL" = (/obj/effect/floor_decal/steeldecal/steel_decals4{dir = 8},/obj/effect/floor_decal/steeldecal/steel_decals4{dir = 5},/turf/simulated/floor/tiled,/area/survivalpod/superpose/AnimalHospital)
"kW" = (/obj/effect/floor_decal/corner/paleblue{dir = 5},/obj/structure/table/standard,/obj/item/weapon/reagent_containers/food/snacks/cookie{pixel_y = 3},/obj/item/weapon/reagent_containers/food/snacks/cookie{pixel_y = 6},/obj/machinery/light{dir = 1},/obj/item/weapon/reagent_containers/food/snacks/cookie{pixel_y = 3},/turf/simulated/floor/tiled,/area/survivalpod/superpose/AnimalHospital)
"lz" = (/obj/structure/table/rack/shelf/steel,/obj/item/weapon/storage/box/bodybags,/obj/item/weapon/storage/box/freezer,/obj/item/weapon/storage/box/freezer,/turf/simulated/floor/tiled/white,/area/survivalpod/superpose/AnimalHospital)
"lA" = (/obj/effect/floor_decal/corner/paleblue/diagonal{dir = 4},/obj/machinery/light/small{dir = 4},/turf/simulated/floor/tiled/white,/area/survivalpod/superpose/AnimalHospital)
"mC" = (/obj/effect/floor_decal/corner/paleblue/border,/turf/simulated/floor/tiled,/area/survivalpod/superpose/AnimalHospital)
"mR" = (/obj/effect/floor_decal/steeldecal/steel_decals4{dir = 4},/obj/effect/floor_decal/steeldecal/steel_decals4{dir = 9},/turf/simulated/floor/tiled,/area/survivalpod/superpose/AnimalHospital)
"mZ" = (/obj/effect/floor_decal/corner/paleblue{dir = 6},/obj/structure/bed/chair/comfy/blue{dir = 8},/turf/simulated/floor/tiled,/area/survivalpod/superpose/AnimalHospital)
"nT" = (/obj/structure/table/standard,/obj/item/weapon/surgical/FixOVein{pixel_x = 5},/obj/item/weapon/surgical/bonegel{pixel_x = -5; pixel_y = 2},/obj/item/weapon/surgical/bonesetter{pixel_x = 2},/turf/simulated/floor/tiled/white,/area/survivalpod/superpose/AnimalHospital)
"oa" = (/obj/structure/table/standard,/obj/item/weapon/surgical/hemostat{pixel_x = -4},/obj/item/weapon/surgical/retractor,/turf/simulated/floor/tiled/white,/area/survivalpod/superpose/AnimalHospital)
"oC" = (/obj/structure/closet,/obj/item/weapon/gun/launcher/syringe,/obj/item/weapon/storage/box/syringegun,/obj/random/cigarettes,/obj/item/weapon/storage/box/syringes,/obj/item/weapon/storage/box/matches,/obj/machinery/light/small{dir = 8},/turf/simulated/floor/plating,/area/survivalpod/superpose/AnimalHospital)
"py" = (/obj/structure/table/standard,/obj/item/device/flashlight/lamp,/obj/effect/floor_decal/corner/paleblue/diagonal{dir = 4},/turf/simulated/floor/tiled/white,/area/survivalpod/superpose/AnimalHospital)
"qk" = (/obj/structure/table/reinforced,/obj/item/clothing/suit/surgicalapron,/obj/item/clothing/gloves/sterile,/obj/item/clothing/mask/surgical,/turf/simulated/floor/tiled/white,/area/survivalpod/superpose/AnimalHospital)
"qL" = (/obj/effect/floor_decal/corner/paleblue/diagonal{dir = 4},/obj/machinery/light/small{dir = 8},/turf/simulated/floor/tiled/white,/area/survivalpod/superpose/AnimalHospital)
"qQ" = (/obj/structure/table/glass,/obj/item/weapon/storage/firstaid/regular,/turf/simulated/floor/tiled/white,/area/survivalpod/superpose/AnimalHospital)
"rl" = (/obj/item/weapon/storage/bag/trash,/turf/simulated/floor/outdoors/dirt,/area/survivalpod/superpose/AnimalHospital)
"rI" = (/obj/fiftyspawner/titanium,/obj/item/stack/cable_coil/silver,/turf/simulated/floor/plating,/area/survivalpod/superpose/AnimalHospital)
"st" = (/obj/machinery/light{dir = 4},/obj/structure/bed/padded,/turf/simulated/floor/tiled/white,/area/survivalpod/superpose/AnimalHospital)
"su" = (/obj/machinery/door/airlock/multi_tile/glass{name = "Animal Hospital"},/turf/simulated/floor/tiled,/area/survivalpod/superpose/AnimalHospital)
"sI" = (/obj/item/weapon/storage/toolbox/mechanical,/obj/machinery/light/small{dir = 4},/turf/simulated/floor/plating,/area/survivalpod/superpose/AnimalHospital)
"sM" = (/obj/structure/table/standard,/obj/item/weapon/surgical/cautery{pixel_x = 2},/obj/item/weapon/surgical/surgicaldrill,/turf/simulated/floor/tiled/white,/area/survivalpod/superpose/AnimalHospital)
"sV" = (/obj/structure/table/glass,/obj/item/weapon/reagent_containers/dropper,/obj/item/weapon/storage/box/beakers,/turf/simulated/floor/tiled/white,/area/survivalpod/superpose/AnimalHospital)
"tq" = (/obj/effect/floor_decal/steeldecal/steel_decals4{dir = 1},/obj/effect/floor_decal/steeldecal/steel_decals4{dir = 6},/turf/simulated/floor/tiled,/area/survivalpod/superpose/AnimalHospital)
"vx" = (/obj/effect/floor_decal/corner/paleblue{dir = 10},/turf/simulated/floor/tiled,/area/survivalpod/superpose/AnimalHospital)
"wc" = (/obj/structure/table/reinforced,/turf/simulated/floor/tiled,/area/survivalpod/superpose/AnimalHospital)
"wm" = (/obj/structure/table/reinforced,/obj/effect/floor_decal/corner/paleblue{dir = 9},/obj/item/device/flashlight/lamp,/turf/simulated/floor/tiled,/area/survivalpod/superpose/AnimalHospital)
"wx" = (/obj/structure/bed/chair/office/dark,/turf/simulated/floor/tiled,/area/survivalpod/superpose/AnimalHospital)
"wB" = (/obj/machinery/vending/wallmed1/public{pixel_y = 32},/obj/machinery/chem_master,/turf/simulated/floor/tiled/white,/area/survivalpod/superpose/AnimalHospital)
"wK" = (/obj/structure/morgue,/turf/simulated/floor/plating,/area/survivalpod/superpose/AnimalHospital)
"wP" = (/obj/structure/flora/ausbushes/pointybush,/turf/simulated/floor/outdoors/dirt,/area/survivalpod/superpose/AnimalHospital)
"yz" = (/obj/structure/filingcabinet/chestdrawer,/turf/simulated/floor/tiled,/area/survivalpod/superpose/AnimalHospital)
"yU" = (/obj/effect/floor_decal/corner/red/diagonal,/obj/structure/sink{dir = 8; pixel_x = -12; pixel_y = 2},/obj/structure/mirror{pixel_x = -28},/turf/simulated/floor/tiled,/area/survivalpod/superpose/AnimalHospital)
"zk" = (/obj/machinery/door/airlock/glass_medical{req_one_access = null},/turf/simulated/floor/tiled/white,/area/survivalpod/superpose/AnimalHospital)
"zn" = (/obj/item/toy/cat_toy,/turf/simulated/floor/tiled/white,/area/survivalpod/superpose/AnimalHospital)
"Ab" = (/obj/structure/flora/ausbushes/lavendergrass,/turf/simulated/floor/outdoors/dirt,/area/survivalpod/superpose/AnimalHospital)
"Ai" = (/obj/structure/noticeboard{dir = 1; pixel_y = -27},/obj/effect/floor_decal/corner/paleblue/diagonal{dir = 4},/turf/simulated/floor/tiled/white,/area/survivalpod/superpose/AnimalHospital)
"Ax" = (/obj/structure/table/reinforced,/obj/item/clothing/glasses/regular,/turf/simulated/floor/tiled,/area/survivalpod/superpose/AnimalHospital)
"Bv" = (/obj/effect/floor_decal/corner/paleblue/full,/obj/structure/table/standard,/obj/item/weapon/cell/high{charge = 100; maxcharge = 15000},/obj/item/weapon/melee/baton/cattleprod,/obj/machinery/recharger,/turf/simulated/floor/tiled,/area/survivalpod/superpose/AnimalHospital)
"BJ" = (/obj/effect/floor_decal/corner/paleblue{dir = 4},/obj/machinery/light{dir = 1},/turf/simulated/floor/tiled,/area/survivalpod/superpose/AnimalHospital)
"BP" = (/obj/structure/closet/secure_closet/medical1{req_access = null},/obj/item/weapon/storage/quickdraw/syringe_case,/obj/item/weapon/storage/quickdraw/syringe_case,/turf/simulated/floor/tiled/white,/area/survivalpod/superpose/AnimalHospital)
"Cj" = (/obj/effect/floor_decal/corner/paleblue/border{dir = 8},/turf/simulated/floor/tiled,/area/survivalpod/superpose/AnimalHospital)
"Di" = (/obj/effect/floor_decal/corner/red/diagonal,/obj/machinery/light/small{dir = 8},/turf/simulated/floor/tiled,/area/survivalpod/superpose/AnimalHospital)
"GG" = (/obj/effect/floor_decal/corner/paleblue{dir = 6},/obj/machinery/light/small{dir = 4},/turf/simulated/floor/tiled,/area/survivalpod/superpose/AnimalHospital)
"Hd" = (/obj/structure/table/glass,/obj/item/weapon/storage/firstaid/adv{pixel_y = 5},/obj/item/weapon/storage/firstaid/regular,/turf/simulated/floor/tiled/white,/area/survivalpod/superpose/AnimalHospital)
"Hl" = (/obj/structure/closet/crate/trashcart,/obj/item/weapon/reagent_containers/food/drinks/bottle/vodka,/turf/simulated/floor/outdoors/dirt,/area/survivalpod/superpose/AnimalHospital)
"Hn" = (/obj/effect/floor_decal/corner/paleblue{dir = 8},/obj/structure/closet/crate/bin{anchored = 1},/obj/item/weapon/lipstick/random,/turf/simulated/floor/tiled,/area/survivalpod/superpose/AnimalHospital)
"Hz" = (/obj/structure/table/glass,/obj/machinery/light/small,/obj/item/weapon/storage/box/lights/mixed,/turf/simulated/floor/tiled/white,/area/survivalpod/superpose/AnimalHospital)
"HK" = (/obj/effect/floor_decal/corner/paleblue{dir = 5},/obj/structure/extinguisher_cabinet{pixel_y = 30},/turf/simulated/floor/tiled,/area/survivalpod/superpose/AnimalHospital)
"HP" = (/obj/effect/floor_decal/corner/red/diagonal,/obj/structure/toilet,/turf/simulated/floor/tiled,/area/survivalpod/superpose/AnimalHospital)
"Ih" = (/obj/machinery/light{dir = 8},/turf/simulated/floor/tiled/white,/area/survivalpod/superpose/AnimalHospital)
"Iq" = (/turf/simulated/floor/tiled/white,/area/survivalpod/superpose/AnimalHospital)
"IC" = (/obj/structure/table/reinforced,/obj/item/weapon/paper_bin,/obj/item/weapon/pen,/turf/simulated/floor/tiled,/area/survivalpod/superpose/AnimalHospital)
"IH" = (/obj/effect/floor_decal/corner/paleblue{dir = 9},/obj/structure/table/standard,/obj/item/weapon/tank/oxygen,/obj/item/clothing/mask/breath,/obj/item/weapon/gun/energy/netgun,/turf/simulated/floor/tiled,/area/survivalpod/superpose/AnimalHospital)
"IW" = (/obj/structure/table/glass,/obj/item/weapon/storage/firstaid/fire,/turf/simulated/floor/tiled/white,/area/survivalpod/superpose/AnimalHospital)
"Jl" = (/obj/effect/floor_decal/corner/paleblue/diagonal{dir = 4},/obj/machinery/door/airlock/glass_medical{req_one_access = null},/turf/simulated/floor/tiled/white,/area/survivalpod/superpose/AnimalHospital)
"Jr" = (/obj/structure/table/standard,/obj/item/weapon/surgical/scalpel{pixel_y = 11},/obj/item/weapon/surgical/circular_saw/cyborg,/turf/simulated/floor/tiled/white,/area/survivalpod/superpose/AnimalHospital)
"JP" = (/obj/structure/table/reinforced,/obj/item/device/radio/phone,/turf/simulated/floor/tiled,/area/survivalpod/superpose/AnimalHospital)
"Kd" = (/obj/machinery/vending/wallmed1/public{pixel_y = 32},/turf/simulated/floor/tiled/white,/area/survivalpod/superpose/AnimalHospital)
"KP" = (/obj/effect/floor_decal/corner/paleblue/diagonal{dir = 4},/turf/simulated/floor/tiled/white,/area/survivalpod/superpose/AnimalHospital)
"KQ" = (/turf/simulated/floor/outdoors/dirt,/area/survivalpod/superpose/AnimalHospital)
"KZ" = (/obj/effect/floor_decal/corner/red/diagonal,/turf/simulated/floor/tiled,/area/survivalpod/superpose/AnimalHospital)
"LW" = (/obj/effect/floor_decal/corner/paleblue/full{dir = 1},/obj/structure/closet/crate/medical/blood,/obj/item/weapon/reagent_containers/blood/prelabeled/BPlus,/obj/item/weapon/reagent_containers/blood/prelabeled/AMinus,/obj/item/weapon/reagent_containers/blood/prelabeled/BMinus,/obj/item/weapon/reagent_containers/blood/prelabeled/APlus,/obj/item/weapon/reagent_containers/blood/prelabeled/OPlus,/obj/item/weapon/reagent_containers/blood/prelabeled/OMinus,/obj/structure/medical_stand,/turf/simulated/floor/tiled,/area/survivalpod/superpose/AnimalHospital)
"Mb" = (/obj/structure/grille,/obj/structure/window/reinforced/full,/turf/simulated/floor/plating,/area/survivalpod/superpose/AnimalHospital)
"Mw" = (/obj/structure/reagent_dispensers/fueltank,/obj/item/device/flashlight/glowstick/blue,/obj/item/device/flashlight/glowstick/blue,/obj/item/device/flashlight/glowstick/blue,/obj/item/device/flashlight,/turf/simulated/floor/plating,/area/survivalpod/superpose/AnimalHospital)
"MA" = (/obj/structure/table/standard,/obj/machinery/chemical_dispenser/full,/obj/item/weapon/reagent_containers/glass/beaker/large,/turf/simulated/floor/tiled/white,/area/survivalpod/superpose/AnimalHospital)
"MS" = (/obj/effect/floor_decal/corner/paleblue/full{dir = 4},/obj/structure/closet,/obj/item/weapon/storage/belt/medical,/obj/item/weapon/storage/belt/medical,/obj/item/clothing/glasses/hud/health,/obj/item/clothing/glasses/hud/health,/obj/item/clothing/glasses/hud/health,/obj/item/device/defib_kit/loaded,/turf/simulated/floor/tiled,/area/survivalpod/superpose/AnimalHospital)
"Nv" = (/obj/machinery/optable,/turf/simulated/floor/tiled/white,/area/survivalpod/superpose/AnimalHospital)
"ND" = (/turf/simulated/floor/tiled,/area/survivalpod/superpose/AnimalHospital)
"Og" = (/turf/simulated/wall/titanium,/area/survivalpod/superpose/AnimalHospital)
"OL" = (/obj/structure/table/glass,/obj/item/clothing/suit/storage/toggle/labcoat,/obj/item/clothing/suit/storage/toggle/labcoat,/obj/item/clothing/suit/storage/toggle/labcoat,/obj/item/device/flashlight/pen,/obj/item/device/flashlight/pen,/obj/item/clothing/accessory/stethoscope,/obj/item/clothing/accessory/stethoscope,/obj/machinery/light/small{dir = 1},/turf/simulated/floor/tiled/white,/area/survivalpod/superpose/AnimalHospital)
"OW" = (/obj/machinery/door/airlock/glass_medical{req_one_access = null},/turf/simulated/floor/tiled,/area/survivalpod/superpose/AnimalHospital)
"Pd" = (/obj/machinery/smartfridge/secure/medbay{req_one_access = null},/turf/simulated/wall/titanium,/area/survivalpod/superpose/AnimalHospital)
"PB" = (/obj/structure/flora/ausbushes/brflowers,/turf/simulated/floor/outdoors/dirt,/area/survivalpod/superpose/AnimalHospital)
"PK" = (/obj/structure/medical_stand/anesthetic,/turf/simulated/floor/tiled/white,/area/survivalpod/superpose/AnimalHospital)
"Qq" = (/obj/machinery/door/airlock/medical{req_one_access = null},/turf/simulated/floor/tiled/white,/area/survivalpod/superpose/AnimalHospital)
"RM" = (/obj/machinery/computer/operating{dir = 4},/turf/simulated/floor/tiled/white,/area/survivalpod/superpose/AnimalHospital)
"St" = (/obj/machinery/vending/coffee,/obj/effect/floor_decal/corner/paleblue/diagonal{dir = 4},/turf/simulated/floor/tiled/white,/area/survivalpod/superpose/AnimalHospital)
"SH" = (/obj/machinery/vending/snack,/obj/effect/floor_decal/corner/paleblue/diagonal{dir = 4},/turf/simulated/floor/tiled/white,/area/survivalpod/superpose/AnimalHospital)
"SY" = (/obj/structure/table/standard,/obj/item/device/taperecorder,/obj/item/weapon/pen/blue{pixel_x = 5; pixel_y = 5},/obj/effect/floor_decal/corner/paleblue/diagonal{dir = 4},/turf/simulated/floor/tiled/white,/area/survivalpod/superpose/AnimalHospital)
"Te" = (/obj/effect/floor_decal/corner/paleblue{dir = 10},/obj/machinery/light/small,/turf/simulated/floor/tiled,/area/survivalpod/superpose/AnimalHospital)
"Tm" = (/obj/effect/floor_decal/corner/paleblue/full,/obj/machinery/space_heater,/turf/simulated/floor/tiled,/area/survivalpod/superpose/AnimalHospital)
"Vc" = (/obj/effect/floor_decal/corner/paleblue/full{dir = 1},/obj/structure/bed/chair/comfy/blue{dir = 8},/turf/simulated/floor/tiled,/area/survivalpod/superpose/AnimalHospital)
"Vr" = (/turf/template_noop,/area/survivalpod/superpose/AnimalHospital)
"VV" = (/obj/structure/flora/ausbushes/fullgrass,/turf/simulated/floor/outdoors/dirt,/area/survivalpod/superpose/AnimalHospital)
"Wq" = (/obj/structure/bed/chair/office/dark{dir = 1},/obj/machinery/light{dir = 4},/turf/simulated/floor/tiled/white,/area/survivalpod/superpose/AnimalHospital)
"Wu" = (/obj/machinery/door/airlock/medical{req_one_access = null},/turf/simulated/floor/plating,/area/survivalpod/superpose/AnimalHospital)
"Ww" = (/obj/effect/floor_decal/corner/paleblue/border{dir = 1},/turf/simulated/floor/tiled,/area/survivalpod/superpose/AnimalHospital)
"XF" = (/obj/effect/floor_decal/corner/paleblue{dir = 8},/turf/simulated/floor/tiled,/area/survivalpod/superpose/AnimalHospital)
"Yb" = (/obj/effect/floor_decal/corner/paleblue{dir = 5},/obj/machinery/light/small{dir = 1},/turf/simulated/floor/tiled,/area/survivalpod/superpose/AnimalHospital)
"YV" = (/obj/machinery/door/airlock/glass_medical{req_one_access = null},/turf/simulated/floor/plating,/area/survivalpod/superpose/AnimalHospital)
"ZZ" = (/turf/simulated/floor/plating,/area/survivalpod/superpose/AnimalHospital)

(1,1,1) = {"
VrVrVrVrVrVrVrVrVrVrVrVrVrVrVrVrVrVrVrVr
VrVrVrVrVrVrVrVrVrKQKQVrKQVrVrVrVrVrVrVr
VrVrVrVrKQVrVrKQVrkiKQKQKQKQKQVrVrVrVrVr
VrVrKQKQKQKQKQKQKQKQKQKQPBKQKQKQKQKQKQKQ
VrKQKQOgOgOgOgOgMbMbMbOgOgOgOgOgOgOgOgKQ
VrKQKQOgKZHPOgStpySYhMSHOgqkcGJrsMnTOgKQ
VrVrKQOgDiKZOgqLaHKPfZlAOgIhIqIqIqeUOgKQ
VrVrrlOgyUKZOgKPKPAiKPKPOgPKIqRMNvoaOgKQ
VrVrHlOgOgdGOgJlOgOgOgJlOgOgQqOgOgOgOgKQ
VrKQKQOWtqmRHKWweNYbeNWweNeNWweNYbLWOgKQ
VrKQPBOgkLcYTevxmCvxmCvxvxvxmCvxXFgXOgKQ
VrKQOgOgYVOgOgOgQqOgQqOgOgOgWuOgjigXOgKQ
VrAbOgoCZZOgBPKdIqOgIqwBMAOgrIOgjigXOgKQ
KQKQOgwKZZOgkoIqstOgIqIqWqOgsIOgjiGGOgKQ
KQKQOgwKZZOgaPznIqPdIqqQsVOgMwOgjigXOgKQ
VrKQOgOgYVOgOgOgQqOgQqOgOgOgOgOgjigXOgKQ
VrKQKQOgNDBJHKeNWwkWWwVcOgHdOLMbjiGGOgKQ
VrKQKQOgHnyzwxJPNDcXNDmZOgcfIqzkCjgXOgKQ
VrKQKQOgwmAxICwcNDNDNDmZOggyIqMbfKgXOgKQ
VrVrKQOgTmvxvxdymCmCvxepOgfgIqOgIHgXOgKQ
VrVrKQOgOgMbMbOgsuNDOgOgOgbcIqMbcSGGOgKQ
VrVrKQKQKQPBAbwPKQKQVVKQOglzIqzkCjgXOgKQ
VrVrVrVrKQKQKQPBVrVrKQVVOgIWHzMbBvMSOgKQ
VrVrVrVrVrKQKQVrVrVrKQKQOgOgOgOgOgOgOgKQ
VrVrVrVrVrVrKQVrVrVrVrKQKQKQKQKQKQKQKQKQ
VrVrVrVrVrVrVrVrVrKQVrVrVrVrVrVrVrVrVrVr
VrVrVrVrVrKQVrVrVrVrVrVrVrVrVrVrVrVrVrVr
VrVrVrVrVrKQVrVrVrVrVrVrVrVrVrVrVrVrVrVr
"}
