"a" = (/turf/simulated/shuttle/wall,/area/survivalpod/superpose/BordcastingPod)
"c" = (/obj/machinery/light,/turf/simulated/shuttle/floor/voidcraft,/area/survivalpod/superpose/BordcastingPod)
"e" = (/obj/structure/bed/chair/bay/chair/padded/blue,/obj/structure/sign/nanotrasen{pixel_y = 27},/turf/simulated/floor/atoll,/area/survivalpod/superpose/BordcastingPod)
"g" = (/obj/structure/window/reinforced/survival_pod{dir = 4},/obj/item/device/gps/computer,/turf/simulated/shuttle/floor/voidcraft,/area/survivalpod/superpose/BordcastingPod)
"h" = (/obj/machinery/light{dir = 8},/turf/simulated/floor/atoll,/area/survivalpod/superpose/BordcastingPod)
"i" = (/obj/structure/table/alien/blue,/turf/simulated/floor/atoll,/area/survivalpod/superpose/BordcastingPod)
"k" = (/obj/machinery/door/airlock/freezer,/turf/simulated/shuttle/plating/skipjack,/area/survivalpod/superpose/BordcastingPod)
"l" = (/obj/structure/window/reinforced/survival_pod{dir = 4},/turf/simulated/shuttle/floor/voidcraft,/area/survivalpod/superpose/BordcastingPod)
"m" = (/obj/structure/fans,/turf/simulated/shuttle/floor/voidcraft,/area/survivalpod/superpose/BordcastingPod)
"o" = (/turf/simulated/shuttle/floor/voidcraft,/area/survivalpod/superpose/BordcastingPod)
"p" = (/obj/structure/table/alien/blue,/obj/item/device/radio/intercom/entertainment{pixel_y = 5},/turf/simulated/floor/atoll,/area/survivalpod/superpose/BordcastingPod)
"q" = (/obj/machinery/newscaster{pixel_y = 29},/turf/simulated/shuttle/floor/voidcraft,/area/survivalpod/superpose/BordcastingPod)
"r" = (/obj/machinery/status_display{pixel_y = 32},/turf/simulated/floor/atoll,/area/survivalpod/superpose/BordcastingPod)
"u" = (/obj/machinery/atmospherics/pipe/manifold/hidden{dir = 4},/turf/simulated/shuttle/floor/voidcraft,/area/survivalpod/superpose/BordcastingPod)
"v" = (/turf/simulated/floor/atoll,/area/survivalpod/superpose/BordcastingPod)
"w" = (/obj/structure/window/reinforced/survival_pod{dir = 8},/obj/machinery/atmospherics/unary/vent_pump{external_pressure_bound = 0; external_pressure_bound_default = 0; icon_state = "map_vent_in"; initialize_directions = 1; internal_pressure_bound = 4000; internal_pressure_bound_default = 4000; pressure_checks = 2; pressure_checks_default = 2; pump_direction = 0; use_power = 1},/turf/simulated/floor/bluegrid{name = "Server Base"; nitrogen = 500; oxygen = 0; temperature = 80},/area/survivalpod/superpose/BordcastingPod)
"x" = (/obj/structure/table/glass,/obj/item/clothing/suit/storage/vest/press,/obj/item/clothing/accessory/badge/press/independent,/obj/item/device/tvcamera,/obj/item/device/camera,/obj/item/device/camera_film,/turf/simulated/shuttle/floor/voidcraft,/area/survivalpod/superpose/BordcastingPod)
"y" = (/obj/structure/table/alien/blue,/obj/item/weapon/paper_bin,/obj/item/weapon/pen/fountain4,/turf/simulated/floor/atoll,/area/survivalpod/superpose/BordcastingPod)
"z" = (/obj/machinery/smartfridge/survival_pod,/obj/item/weapon/storage/mre/random,/obj/item/weapon/storage/mre/random,/obj/item/weapon/storage/mre/random,/obj/item/weapon/storage/mre/random,/obj/item/weapon/storage/mre/random,/obj/item/weapon/storage/mre/random,/obj/item/weapon/storage/mre/menu9,/obj/item/weapon/storage/mre/menu9,/obj/item/weapon/storage/mre/menu10,/obj/item/weapon/storage/mre/menu10,/obj/item/weapon/storage/mre/menu11,/obj/item/weapon/storage/mre/menu11,/obj/item/device/fbp_backup_cell,/obj/item/device/fbp_backup_cell,/obj/item/device/fbp_backup_cell,/obj/item/device/fbp_backup_cell,/obj/item/device/fbp_backup_cell,/obj/item/weapon/storage/pill_bottle/antitox,/obj/item/weapon/storage/box/survival/space,/obj/item/device/healthanalyzer,/obj/item/weapon/storage/pill_bottle/dice_nerd,/obj/machinery/light{dir = 1},/obj/item/weapon/storage/firstaid/regular,/obj/item/weapon/extinguisher/mini,/obj/item/weapon/extinguisher/mini,/obj/item/weapon/storage/box/survival/space,/obj/item/weapon/storage/box/survival/space,/obj/item/device/radio,/obj/item/device/radio,/obj/item/device/radio,/obj/item/device/starcaster_news,/obj/item/device/starcaster_news,/obj/item/device/threadneedle,/obj/item/device/flashlight,/obj/item/device/flashlight,/obj/item/weapon/storage/toolbox/emergency,/obj/item/weapon/storage/pill_bottle/spaceacillin,/obj/random/soap,/obj/item/weapon/material/knife/machete/hatchet,/obj/item/weapon/storage/box/flare,/turf/simulated/shuttle/floor/voidcraft,/area/survivalpod/superpose/BordcastingPod)
"A" = (/obj/machinery/ai_status_display{pixel_y = 32},/turf/simulated/floor/atoll,/area/survivalpod/superpose/BordcastingPod)
"C" = (/obj/machinery/door/window/survival_pod{dir = 2},/turf/simulated/floor/atoll,/area/survivalpod/superpose/BordcastingPod)
"D" = (/obj/machinery/telecomms/relay,/turf/simulated/floor/bluegrid{name = "Server Base"; nitrogen = 500; oxygen = 0; temperature = 80},/area/survivalpod/superpose/BordcastingPod)
"E" = (/obj/structure/window/reinforced/survival_pod{dir = 8},/obj/structure/window/reinforced/survival_pod,/obj/machinery/atmospherics/pipe/manifold/hidden{dir = 8},/turf/simulated/floor/bluegrid{name = "Server Base"; nitrogen = 500; oxygen = 0; temperature = 80},/area/survivalpod/superpose/BordcastingPod)
"F" = (/obj/structure/table/glass,/obj/item/device/camerabug,/turf/simulated/shuttle/floor/voidcraft,/area/survivalpod/superpose/BordcastingPod)
"G" = (/obj/structure/table/glass,/obj/machinery/light,/turf/simulated/shuttle/floor/voidcraft,/area/survivalpod/superpose/BordcastingPod)
"I" = (/obj/machinery/light{dir = 4},/turf/simulated/floor/atoll,/area/survivalpod/superpose/BordcastingPod)
"J" = (/obj/machinery/atmospherics/unary/freezer{icon_state = "freezer_1"; power_setting = 20; set_temperature = 73; use_power = 1},/obj/structure/window/reinforced/survival_pod{dir = 1},/turf/simulated/shuttle/floor/voidcraft,/area/survivalpod/superpose/BordcastingPod)
"L" = (/obj/structure/window/reinforced/survival_pod{dir = 8},/obj/machinery/atmospherics/pipe/simple/hidden{dir = 5},/turf/simulated/shuttle/floor/voidcraft,/area/survivalpod/superpose/BordcastingPod)
"M" = (/obj/structure/window/reinforced/survival_pod{dir = 8},/obj/structure/window/reinforced/survival_pod{dir = 4},/obj/structure/window/reinforced/survival_pod{dir = 1},/obj/structure/window/reinforced/survival_pod,/obj/structure/grille,/turf/simulated/floor/plating,/area/survivalpod/superpose/BordcastingPod)
"N" = (/obj/machinery/door/window/survival_pod{dir = 2},/obj/machinery/atmospherics/unary/vent_pump{dir = 8; icon_state = "map_vent_out"; use_power = 1},/turf/simulated/floor/bluegrid{name = "Server Base"; nitrogen = 500; oxygen = 0; temperature = 80},/area/survivalpod/superpose/BordcastingPod)
"O" = (/obj/machinery/light{dir = 8},/turf/simulated/shuttle/floor/voidcraft,/area/survivalpod/superpose/BordcastingPod)
"P" = (/obj/machinery/atmospherics/portables_connector{dir = 1},/obj/machinery/portable_atmospherics/canister/nitrogen,/turf/simulated/shuttle/floor/voidcraft,/area/survivalpod/superpose/BordcastingPod)
"Q" = (/obj/structure/table/glass,/obj/structure/closet/walllocker_double/survival/west,/obj/item/weapon/gun/energy/locked/frontier/holdout/unlocked,/obj/machinery/light{dir = 8},/turf/simulated/shuttle/floor/voidcraft,/area/survivalpod/superpose/BordcastingPod)
"R" = (/obj/structure/table/glass,/obj/machinery/power/apc/alarms_hidden{pixel_y = -20},/turf/simulated/shuttle/floor/voidcraft,/area/survivalpod/superpose/BordcastingPod)
"U" = (/obj/structure/window/reinforced/survival_pod{dir = 8},/obj/machinery/atmospherics/pipe/simple/hidden,/turf/simulated/shuttle/floor/voidcraft,/area/survivalpod/superpose/BordcastingPod)
"W" = (/obj/machinery/camera{dir = 1},/turf/simulated/floor/atoll,/area/survivalpod/superpose/BordcastingPod)
"Y" = (/obj/machinery/computer/security/telescreen/entertainment{pixel_y = 28},/turf/simulated/shuttle/floor/voidcraft,/area/survivalpod/superpose/BordcastingPod)

(1,1,1) = {"
aaaaaaaaaaa
amgvAervwDa
azlhpiyIENa
aOlvvvvvUoa
MxlhvWvIUJM
aQlCaaaCLua
MoooYoqooPM
aoocoGFRooa
aakaMaMaMaa
"}
