"aw" = (/turf/simulated/wall/cult,/area/survivalpod/superpose/CultShip)
"aP" = (/obj/structure/table/fancyblack,/obj/item/weapon/book/tome/imbued,/obj/item/weapon/digestion_remains/skull/unathi,/obj/item/device/soulstone,/turf/simulated/floor/tiled/techfloor,/area/survivalpod/superpose/CultShip)
"be" = (/obj/structure/cult/pylon,/turf/simulated/shuttle/floor/voidcraft/dark,/area/survivalpod/superpose/CultShip)
"bq" = (/turf/simulated/floor/tiled/techfloor,/area/survivalpod/superpose/CultShip)
"bW" = (/obj/effect/floor_decal/techfloor{dir = 1},/turf/simulated/floor/cult,/area/survivalpod/superpose/CultShip)
"cH" = (/obj/effect/floor_decal/techfloor{dir = 6},/turf/simulated/floor/cult,/area/survivalpod/superpose/CultShip)
"dJ" = (/obj/structure/grille/cult,/obj/structure/window/phoronreinforced/full,/obj/structure/window/reinforced/survival_pod{dir = 8},/obj/structure/window/reinforced/survival_pod{dir = 4},/turf/simulated/floor/tiled/steel_dirty{color = "grey"},/area/survivalpod/superpose/CultShip)
"eP" = (/obj/effect/floor_decal/techfloor,/obj/machinery/porta_turret/alien{faction = "neutral"},/turf/simulated/floor/cult,/area/survivalpod/superpose/CultShip)
"fd" = (/obj/structure/bed/double/padded,/obj/item/weapon/bedsheet/hosdouble,/turf/simulated/floor/tiled/techfloor,/area/survivalpod/superpose/CultShip)
"fw" = (/obj/machinery/light/floortube/flicker{dir = 8; pixel_x = -3},/turf/simulated/floor/cult,/area/survivalpod/superpose/CultShip)
"fZ" = (/obj/item/clothing/shoes/cult,/obj/item/clothing/suit/cultrobes/alt,/obj/item/clothing/head/helmet/space/cult,/obj/structure/table/fancyblack,/turf/simulated/shuttle/floor/voidcraft/dark,/area/survivalpod/superpose/CultShip)
"gU" = (/turf/simulated/floor/cult{icon_state = "cult-narsie"},/area/survivalpod/superpose/CultShip)
"he" = (/obj/structure/cult/pylon,/turf/simulated/shuttle/floor/voidcraft/light,/area/survivalpod/superpose/CultShip)
"iz" = (/obj/machinery/porta_turret/alien{faction = "neutral"},/turf/simulated/shuttle/floor/voidcraft/light,/area/survivalpod/superpose/CultShip)
"jq" = (/obj/effect/floor_decal/techfloor,/obj/machinery/light/floortube/flicker{pixel_y = 13},/turf/simulated/floor/cult,/area/survivalpod/superpose/CultShip)
"js" = (/obj/effect/floor_decal/techfloor/corner{dir = 4},/turf/simulated/shuttle/floor/voidcraft/light,/area/survivalpod/superpose/CultShip)
"jv" = (/obj/structure/cult/talisman,/turf/simulated/shuttle/floor/voidcraft/dark,/area/survivalpod/superpose/CultShip)
"jO" = (/obj/effect/catwalk_plated/white,/turf/simulated/floor/tiled/steel_dirty{color = "grey"},/area/survivalpod/superpose/CultShip)
"kf" = (/obj/structure/grille/cult,/obj/structure/window/phoronreinforced/full,/obj/structure/window/reinforced/survival_pod{dir = 1},/obj/structure/window/reinforced/survival_pod,/turf/simulated/floor/tiled/steel_dirty{color = "grey"},/area/survivalpod/superpose/CultShip)
"kT" = (/obj/structure/bed/chair/bay/comfy/purple{dir = 8},/obj/effect/floor_decal/techfloor{dir = 9},/turf/simulated/floor/cult,/area/survivalpod/superpose/CultShip)
"mT" = (/obj/structure/toilet/prison{name = "toilet"; pixel_y = 10},/obj/structure/window/reinforced/survival_pod{dir = 4; opacity = 1},/obj/structure/curtain/open/shower/security,/turf/simulated/floor/cult,/area/survivalpod/superpose/CultShip)
"nj" = (/obj/machinery/light/floortube/flicker{dir = 8; pixel_x = 5},/turf/simulated/shuttle/plating,/area/survivalpod/superpose/CultShip)
"nq" = (/obj/item/weapon/melee/cultblade,/obj/structure/table/fancyblack,/obj/item/device/soulstone,/turf/simulated/shuttle/floor/voidcraft/dark,/area/survivalpod/superpose/CultShip)
"oY" = (/obj/structure/cult/talisman,/turf/simulated/shuttle/floor/voidcraft/light,/area/survivalpod/superpose/CultShip)
"py" = (/obj/machinery/door/airlock/phoron,/turf/simulated/floor/tiled/techfloor,/area/survivalpod/superpose/CultShip)
"pJ" = (/obj/machinery/atmospherics/unary/vent_pump/high_volume{dir = 1},/turf/simulated/shuttle/plating,/area/survivalpod/superpose/CultShip)
"rC" = (/obj/structure/constructshell/cult,/turf/simulated/shuttle/floor/voidcraft/light,/area/survivalpod/superpose/CultShip)
"us" = (/obj/machinery/atmospherics/pipe/tank/phoron/full{dir = 4},/turf/simulated/floor/tiled/techfloor,/area/survivalpod/superpose/CultShip)
"vf" = (/turf/simulated/wall/phoron,/area/survivalpod/superpose/CultShip)
"vl" = (/obj/machinery/light/floortube/flicker{pixel_y = 5},/turf/simulated/floor/tiled/techfloor,/area/survivalpod/superpose/CultShip)
"vG" = (/obj/machinery/atmospherics/unary/vent_pump/high_volume,/turf/simulated/shuttle/plating,/area/survivalpod/superpose/CultShip)
"vX" = (/obj/structure/curtain/open/shower/security,/obj/machinery/shower{pixel_y = 20},/turf/simulated/floor/cult,/area/survivalpod/superpose/CultShip)
"wl" = (/obj/effect/floor_decal/techfloor/corner,/turf/simulated/shuttle/floor/voidcraft/dark,/area/survivalpod/superpose/CultShip)
"xg" = (/obj/effect/floor_decal/techfloor,/obj/structure/cult/forge,/turf/simulated/floor/cult,/area/survivalpod/superpose/CultShip)
"xh" = (/obj/item/clothing/shoes/cult,/obj/item/clothing/suit/cultrobes/alt,/obj/item/clothing/head/helmet/space/cult,/obj/structure/table/fancyblack,/turf/simulated/shuttle/floor/voidcraft/light,/area/survivalpod/superpose/CultShip)
"xq" = (/obj/effect/catwalk_plated/dark,/obj/machinery/pointdefense,/turf/simulated/floor/cult,/area/survivalpod/superpose/CultShip)
"yi" = (/obj/effect/floor_decal/techfloor{dir = 1},/obj/machinery/porta_turret/alien{faction = "neutral"},/turf/simulated/floor/cult,/area/survivalpod/superpose/CultShip)
"ym" = (/obj/structure/grille/cult,/obj/structure/window/phoronreinforced/full,/obj/structure/window/reinforced/survival_pod{dir = 1},/obj/structure/window/reinforced/survival_pod{dir = 8},/obj/structure/window/reinforced/survival_pod{dir = 4},/turf/simulated/floor/tiled/steel_dirty{color = "grey"},/area/survivalpod/superpose/CultShip)
"yq" = (/obj/structure/grille/cult,/obj/structure/window/phoronreinforced/full,/obj/structure/window/reinforced/survival_pod{dir = 1},/obj/structure/window/reinforced/survival_pod,/obj/structure/window/reinforced/survival_pod{dir = 8},/turf/simulated/floor/tiled/steel_dirty{color = "grey"},/area/survivalpod/superpose/CultShip)
"yE" = (/obj/structure/table/marble{color = "#B03A2E"},/obj/random/soap{pixel_y = 5},/obj/random/soap,/obj/item/weapon/towel/random{pixel_y = 4},/obj/item/weapon/towel/random{pixel_y = 4},/obj/item/weapon/towel/random{pixel_y = 8},/obj/item/weapon/towel/random{pixel_y = 8},/turf/simulated/floor/cult,/area/survivalpod/superpose/CultShip)
"Ai" = (/obj/effect/floor_decal/techfloor{dir = 1},/obj/machinery/light/floortube/flicker{pixel_y = -3},/turf/simulated/floor/cult,/area/survivalpod/superpose/CultShip)
"Bw" = (/obj/structure/bed/chair/wood/wings{dir = 4},/turf/simulated/floor/tiled/techfloor,/area/survivalpod/superpose/CultShip)
"BV" = (/obj/item/weapon/storage/backpack/cultpack,/obj/structure/table/fancyblack,/turf/simulated/shuttle/floor/voidcraft/light,/area/survivalpod/superpose/CultShip)
"CY" = (/obj/machinery/porta_turret/alien/destroyed,/obj/effect/catwalk_plated/white,/turf/simulated/floor/cult,/area/survivalpod/superpose/CultShip)
"De" = (/obj/effect/floor_decal/techfloor{dir = 4},/turf/simulated/floor/cult,/area/survivalpod/superpose/CultShip)
"Dz" = (/obj/structure/bed/chair/wood/wings{dir = 8},/turf/simulated/shuttle/floor/voidcraft/light,/area/survivalpod/superpose/CultShip)
"EA" = (/obj/structure/cult/tome,/turf/simulated/shuttle/floor/voidcraft/light,/area/survivalpod/superpose/CultShip)
"Ff" = (/obj/effect/catwalk_plated/white,/obj/machinery/pointdefense,/turf/simulated/floor/cult,/area/survivalpod/superpose/CultShip)
"Fw" = (/obj/machinery/porta_turret/alien{faction = "neutral"},/turf/simulated/shuttle/floor/voidcraft/dark,/area/survivalpod/superpose/CultShip)
"HF" = (/obj/effect/floor_decal/techfloor,/turf/simulated/floor/cult,/area/survivalpod/superpose/CultShip)
"II" = (/obj/effect/floor_decal/techfloor{dir = 5},/turf/simulated/floor/cult,/area/survivalpod/superpose/CultShip)
"IX" = (/obj/structure/simple_door/cult,/turf/simulated/floor/tiled/techfloor,/area/survivalpod/superpose/CultShip)
"Kj" = (/obj/structure/closet/cabinet,/obj/random/curseditem,/obj/random/curseditem,/obj/item/weapon/melee/cursedblade,/obj/item/weapon/melee/cultblade,/obj/item/weapon/beartrap/hunting,/obj/item/weapon/beartrap/hunting,/obj/item/stack/material/phoron{amount = 25},/obj/item/stack/material/phoron{amount = 25},/obj/item/device/soulstone,/obj/item/device/soulstone,/obj/item/weapon/storage/belt/soulstone/full,/turf/simulated/floor/tiled/techfloor,/area/survivalpod/superpose/CultShip)
"Kq" = (/obj/structure/undies_wardrobe,/turf/simulated/floor/cult,/area/survivalpod/superpose/CultShip)
"Kt" = (/obj/fiftyspawner/glass,/obj/fiftyspawner/glass,/obj/fiftyspawner/glass,/obj/fiftyspawner/glass,/obj/fiftyspawner/glass,/obj/fiftyspawner/steel,/obj/fiftyspawner/steel,/obj/fiftyspawner/steel,/obj/fiftyspawner/steel,/obj/fiftyspawner/steel,/obj/fiftyspawner/plastic,/obj/fiftyspawner/plastic,/obj/fiftyspawner/plastic,/obj/fiftyspawner/plastic,/obj/fiftyspawner/plastic,/obj/structure/table/rack/shelf/steel,/turf/simulated/floor/cult,/area/survivalpod/superpose/CultShip)
"KV" = (/obj/machinery/atmospherics/unary/engine/biggest{dir = 8},/turf/simulated/floor/tiled/steel_dirty{color = "grey"},/area/survivalpod/superpose/CultShip)
"Ln" = (/turf/simulated/floor/cult,/area/survivalpod/superpose/CultShip)
"LR" = (/obj/effect/floor_decal/techfloor{dir = 4},/obj/machinery/light/floortube/flicker{dir = 8; pixel_x = -3},/turf/simulated/floor/tiled/techfloor/grid,/area/survivalpod/superpose/CultShip)
"Md" = (/obj/machinery/porta_turret/alien/destroyed,/obj/effect/catwalk_plated/dark,/turf/simulated/floor/cult,/area/survivalpod/superpose/CultShip)
"Mg" = (/obj/effect/floor_decal/techfloor{dir = 4},/turf/simulated/floor/tiled/techfloor/grid,/area/survivalpod/superpose/CultShip)
"Mh" = (/turf/simulated/shuttle/floor/voidcraft/dark,/area/survivalpod/superpose/CultShip)
"Mo" = (/obj/effect/floor_decal/techfloor,/obj/effect/floor_decal/techfloor{dir = 4},/turf/simulated/floor/tiled/techfloor/grid,/area/survivalpod/superpose/CultShip)
"MH" = (/obj/structure/bed/chair/wood/wings{dir = 4},/turf/simulated/shuttle/floor/voidcraft/dark,/area/survivalpod/superpose/CultShip)
"Nl" = (/turf/simulated/shuttle/floor/voidcraft/light,/area/survivalpod/superpose/CultShip)
"NH" = (/obj/machinery/power/smes/buildable{icon = 'icons/obj/alien_smes.dmi'; icon_state = "unit"; input_level = 950000; name = "Alien Royal Capacitor"; output_level = 950000},/obj/effect/floor_decal/techfloor{dir = 5},/turf/simulated/floor/cult,/area/survivalpod/superpose/CultShip)
"NJ" = (/obj/item/weapon/material/knife/ritual,/obj/structure/table/fancyblack,/turf/simulated/shuttle/floor/voidcraft/dark,/area/survivalpod/superpose/CultShip)
"NQ" = (/obj/effect/catwalk_plated/dark,/turf/simulated/floor/tiled/steel_dirty{color = "grey"},/area/survivalpod/superpose/CultShip)
"Oh" = (/obj/structure/salvageable/console_os{dir = 4},/turf/simulated/shuttle/floor/voidcraft/light,/area/survivalpod/superpose/CultShip)
"Op" = (/obj/structure/constructshell/cult,/turf/simulated/shuttle/floor/voidcraft/dark,/area/survivalpod/superpose/CultShip)
"ON" = (/obj/structure/salvageable/computer,/turf/simulated/shuttle/floor/voidcraft/dark,/area/survivalpod/superpose/CultShip)
"OU" = (/obj/structure/sink{dir = 4; pixel_x = 11},/obj/structure/mirror{dir = 8; pixel_x = 25},/turf/simulated/floor/cult,/area/survivalpod/superpose/CultShip)
"Pi" = (/obj/machinery/atmospherics/pipe/tank/phoron/full{dir = 4},/turf/simulated/floor/redgrid/animated,/area/survivalpod/superpose/CultShip)
"PR" = (/turf/simulated/floor/redgrid/animated,/area/survivalpod/superpose/CultShip)
"Qh" = (/obj/structure/grille/cult,/obj/structure/window/phoronreinforced/full,/obj/structure/window/reinforced/survival_pod{dir = 1},/obj/structure/window/reinforced/survival_pod,/obj/structure/window/reinforced/survival_pod{dir = 4},/turf/simulated/floor/tiled/steel_dirty{color = "grey"},/area/survivalpod/superpose/CultShip)
"UE" = (/obj/structure/bed/chair/bay/comfy/purple{dir = 8},/obj/effect/floor_decal/techfloor{dir = 10},/turf/simulated/floor/cult,/area/survivalpod/superpose/CultShip)
"UG" = (/turf/template_noop,/area/template_noop)
"VA" = (/obj/effect/floor_decal/emblem/black,/turf/simulated/floor/tiled/techfloor,/area/survivalpod/superpose/CultShip)
"VL" = (/obj/effect/floor_decal/techfloor/corner,/turf/simulated/floor/cult,/area/survivalpod/superpose/CultShip)
"Wd" = (/obj/structure/simple_door/cult,/turf/simulated/shuttle/floor/voidcraft/dark,/area/survivalpod/superpose/CultShip)
"Wm" = (/obj/effect/floor_decal/techfloor{dir = 6},/obj/machinery/power/smes/buildable{icon = 'icons/obj/alien_smes.dmi'; icon_state = "unit"; input_level = 950000; name = "Alien Royal Capacitor"; output_level = 950000},/turf/simulated/floor/cult,/area/survivalpod/superpose/CultShip)
"WT" = (/obj/structure/table/fancyblack,/obj/item/weapon/flame/candle/candelabra/everburn{pixel_y = 8},/turf/simulated/floor/tiled/techfloor,/area/survivalpod/superpose/CultShip)
"Xw" = (/obj/structure/grille/cult,/obj/structure/window/phoronreinforced/full,/obj/structure/window/reinforced/survival_pod,/obj/structure/window/reinforced/survival_pod{dir = 8},/obj/structure/window/reinforced/survival_pod{dir = 4},/turf/simulated/floor/tiled/steel_dirty{color = "grey"},/area/survivalpod/superpose/CultShip)
"Yl" = (/obj/effect/floor_decal/techfloor/corner{dir = 4},/turf/simulated/floor/cult,/area/survivalpod/superpose/CultShip)
"Yu" = (/obj/machinery/door/airlock/phoron,/obj/structure/fans/hardlight/colorable/abductor,/turf/simulated/shuttle/plating,/area/survivalpod/superpose/CultShip)
"YN" = (/obj/effect/floor_decal/techfloor{dir = 4},/obj/machinery/power/apc/alarms_hidden{dir = 1; pixel_y = 20},/turf/simulated/floor/tiled/techfloor/grid,/area/survivalpod/superpose/CultShip)
"YO" = (/obj/structure/cult/talisman,/obj/item/device/soulstone,/turf/simulated/shuttle/floor/voidcraft/dark,/area/survivalpod/superpose/CultShip)
"ZJ" = (/turf/simulated/floor/tiled/steel_dirty{color = "grey"},/area/survivalpod/superpose/CultShip)

(1,1,1) = {"
UGUGUGUGUGUGUGUGUGUGUGUGUGUGUGUGUGUGUGUGUGUGUGUGUGUGUGUG
UGUGUGUGUGUGUGUGUGUGUGUGUGUGUGUGUGUGUGUGUGCYawawawUGUGUG
UGUGUGUGUGUGUGUGUGUGUGUGUGUGvfawyqkfQhawawawawZJZJUGUGUG
UGUGUGUGUGUGUGUGUGxqawyqkfQhawbeNlMhizawYNKtawZJZJUGUGUG
UGUGUGUGUGvfawYuawawawxhfZxhMhNlMhNlwlIXMgPRawKVZJUGUGUG
UGMdawyqQhawpJnjawFwNlMhNlVLHFHFjqHFWmawLRgUawNQjONQUGUG
UGawawjvheawvGnjawNlOpNlOpDeawawyqQhawawMgPiawawawjOUGUG
UGymOhUEePawawYuawHFHFHFHFcHawKjbqbqfdawMoxgvfawZJZJUGUG
UGdJONvlbqWdbqvlbqVAvlbqvlbqpybqbqbqWTawvlusvfawZJZJUGUG
UGXwOhkTyiawbWbWbWbWbWbWbWIIawBwaPbqfdawawawvfawKVZJUGUG
UGawawoYbeawNlMhNlMhrCMhrCDeawawyqQhawawmTvXawawawNQUGUG
UGCYawyqQhawMHEAYODzMhNlMhYlbWbWAibWNHawfwLnawjONQjOUGUG
UGUGUGUGUGvfawawawawawnqBVNJNlMhNlMhjsIXLnOUawZJZJUGUGUG
UGUGUGUGUGUGUGUGUGFfawyqkfQhawheMhNlFwawKqyEawZJZJUGUGUG
UGUGUGUGUGUGUGUGUGUGUGUGUGUGvfawyqkfQhawawawawKVZJUGUGUG
UGUGUGUGUGUGUGUGUGUGUGUGUGUGUGUGUGUGUGUGUGMdawawawUGUGUG
UGUGUGUGUGUGUGUGUGUGUGUGUGUGUGUGUGUGUGUGUGUGUGUGUGUGUGUG
"}
