//MAP CONVERTED BY dmm2tgm.py THIS HEADER COMMENT PREVENTS RECONVERSION, DO NOT REMOVE
"aD" = (
/turf/simulated/floor/outdoors/newdirt,
/area/survivalpod/superpose/DragonCave)
"aL" = (
/obj/item/weapon/bone/skull/tajaran,
/obj/item/clothing/accessory/collar/gold,
/turf/simulated/floor/outdoors/dirt,
/area/survivalpod/superpose/DragonCave)
"bV" = (
/obj/item/weapon/storage/mre/random,
/obj/item/weapon/storage/mre/random,
/obj/item/weapon/storage/mre/random,
/obj/item/weapon/storage/mre/random,
/obj/item/weapon/storage/mre/random,
/obj/item/weapon/storage/mre/random,
/obj/item/weapon/storage/mre/menu9,
/obj/item/weapon/storage/mre/menu9,
/obj/item/weapon/storage/mre/menu10,
/obj/item/weapon/storage/mre/menu10,
/obj/item/weapon/storage/mre/menu11,
/obj/item/weapon/storage/mre/menu11,
/obj/item/device/fbp_backup_cell,
/obj/item/device/fbp_backup_cell,
/obj/item/device/fbp_backup_cell,
/obj/item/device/fbp_backup_cell,
/obj/item/device/fbp_backup_cell,
/obj/item/weapon/storage/pill_bottle/antitox,
/obj/item/weapon/storage/box/survival/space,
/obj/item/device/healthanalyzer,
/obj/item/weapon/storage/pill_bottle/dice_nerd,
/obj/item/weapon/storage/firstaid/regular,
/obj/item/weapon/extinguisher/mini,
/obj/item/weapon/extinguisher/mini,
/obj/item/weapon/storage/box/survival/space,
/obj/item/weapon/storage/box/survival/space,
/obj/item/device/radio,
/obj/item/device/radio,
/obj/item/device/radio,
/obj/item/device/starcaster_news,
/obj/item/device/starcaster_news,
/obj/item/device/threadneedle,
/obj/item/device/flashlight,
/obj/item/device/flashlight,
/obj/item/weapon/storage/toolbox/emergency,
/obj/item/weapon/storage/pill_bottle/spaceacillin,
/obj/random/soap,
/obj/item/weapon/material/knife/machete/hatchet,
/obj/item/weapon/storage/box/flare,
/obj/item/weapon/cell/high,
/obj/item/weapon/cell/high,
/obj/item/weapon/cell/high,
/obj/item/weapon/stock_parts/matter_bin,
/obj/item/weapon/stock_parts/capacitor,
/obj/item/weapon/stock_parts/capacitor,
/obj/item/weapon/stock_parts/capacitor,
/obj/item/weapon/circuitboard/batteryrack,
/obj/item/weapon/material/knife/machete,
/obj/structure/closet/cabinet,
/turf/simulated/floor/outdoors/dirt,
/area/survivalpod/superpose/DragonCave)
"cY" = (
/obj/item/weapon/material/sword/katana,
/turf/simulated/floor/outdoors/newdirt,
/area/survivalpod/superpose/DragonCave)
"db" = (
/obj/effect/decal/cleanable/filth,
/turf/simulated/floor/outdoors/newdirt,
/area/survivalpod/superpose/DragonCave)
"dc" = (
/obj/effect/decal/cleanable/blood/tracks{
	color = "red";
	desc = "Your instincts say you shouldn't be following these.";
	dir = 4;
	icon = 'icons/effects/blood.dmi';
	icon_state = "tracks"
	},
/turf/simulated/floor/outdoors/rocks,
/area/survivalpod/superpose/DragonCave)
"fw" = (
/obj/effect/decal/remains/ribcage,
/turf/simulated/floor/outdoors/dirt,
/area/survivalpod/superpose/DragonCave)
"fK" = (
/obj/item/clothing/shoes/tribalwear,
/obj/item/clothing/under/tribalwear/hunter,
/obj/item/weapon/material/twohanded/spear,
/turf/simulated/floor/outdoors/dirt,
/area/survivalpod/superpose/DragonCave)
"fN" = (
/obj/effect/decal/cleanable/blood,
/turf/simulated/floor/outdoors/dirt,
/area/survivalpod/superpose/DragonCave)
"fW" = (
/obj/effect/decal/cleanable/blood/splatter{
	color = "red"
	},
/turf/simulated/floor/outdoors/rocks,
/area/survivalpod/superpose/DragonCave)
"gJ" = (
/obj/item/weapon/material/twohanded/longsword,
/turf/simulated/floor/outdoors/newdirt,
/area/survivalpod/superpose/DragonCave)
"hc" = (
/turf/simulated/floor/outdoors/dirt,
/area/survivalpod/superpose/DragonCave)
"jp" = (
/obj/structure/ledge/ledge_stairs,
/turf/simulated/floor/outdoors/dirt,
/area/survivalpod/superpose/DragonCave)
"jC" = (
/obj/effect/map_effect/interval/effect_emitter/steam,
/turf/simulated/floor/water/hotspring,
/area/survivalpod/superpose/DragonCave)
"kT" = (
/obj/structure/flora/lily3,
/turf/simulated/floor/water/hotspring,
/area/survivalpod/superpose/DragonCave)
"mh" = (
/obj/item/weapon/reagent_containers/food/snacks/meat,
/obj/item/weapon/reagent_containers/food/snacks/meat,
/obj/item/weapon/reagent_containers/food/snacks/meat,
/turf/simulated/floor/outdoors/dirt,
/area/survivalpod/superpose/DragonCave)
"mV" = (
/obj/item/weapon/bone/skull/tajaran,
/turf/simulated/floor/outdoors/dirt,
/area/survivalpod/superpose/DragonCave)
"na" = (
/turf/simulated/floor/outdoors/rocks,
/area/survivalpod/superpose/DragonCave)
"oa" = (
/obj/structure/outcrop/lead,
/turf/template_noop,
/area/template_noop)
"oy" = (
/obj/item/device/bluespaceradio/southerncross_prelinked,
/obj/structure/table/sifwooden_reinforced,
/obj/item/device/binoculars,
/turf/simulated/floor/outdoors/dirt,
/area/survivalpod/superpose/DragonCave)
"pa" = (
/obj/effect/decal/remains/mouse,
/turf/simulated/floor/outdoors/newdirt,
/area/survivalpod/superpose/DragonCave)
"pF" = (
/obj/structure/flora/log2,
/turf/simulated/floor/water/hotspring,
/area/survivalpod/superpose/DragonCave)
"qX" = (
/obj/structure/curtain/black,
/turf/simulated/floor/outdoors/dirt,
/area/survivalpod/superpose/DragonCave)
"qZ" = (
/obj/effect/decal/remains/unathi,
/obj/effect/decal/cleanable/filth,
/turf/simulated/floor/outdoors/dirt,
/area/survivalpod/superpose/DragonCave)
"sB" = (
/obj/item/weapon/ore/gold,
/turf/simulated/floor/outdoors/newdirt,
/area/survivalpod/superpose/DragonCave)
"sW" = (
/obj/effect/decal/remains/tajaran,
/obj/effect/decal/cleanable/blood/splatter{
	color = "red"
	},
/turf/simulated/floor/outdoors/dirt,
/area/survivalpod/superpose/DragonCave)
"uh" = (
/obj/effect/decal/remains/xeno,
/obj/item/clothing/accessory/collar/holo,
/obj/effect/decal/cleanable/filth,
/turf/simulated/floor/outdoors/dirt,
/area/survivalpod/superpose/DragonCave)
"wn" = (
/obj/item/clothing/under/tribalwear/common1,
/obj/item/clothing/shoes/tribalwear,
/obj/item/weapon/material/twohanded/spear,
/turf/simulated/floor/outdoors/dirt,
/area/survivalpod/superpose/DragonCave)
"wt" = (
/obj/item/weapon/bone/skull/tajaran,
/obj/item/clothing/accessory/collar/silver,
/obj/effect/decal/cleanable/blood,
/turf/simulated/floor/outdoors/dirt,
/area/survivalpod/superpose/DragonCave)
"wy" = (
/obj/effect/decal/cleanable/filth,
/obj/effect/decal/cleanable/blood/tracks{
	color = "red";
	desc = "Your instincts say you shouldn't be following these.";
	icon = 'icons/effects/blood.dmi';
	icon_state = "tracks"
	},
/turf/simulated/floor/outdoors/dirt,
/area/survivalpod/superpose/DragonCave)
"xc" = (
/obj/item/weapon/ore/gold{
	pixel_x = 8;
	pixel_y = -9
	},
/turf/simulated/floor/outdoors/newdirt,
/area/survivalpod/superpose/DragonCave)
"xS" = (
/obj/structure/outcrop/gold,
/turf/template_noop,
/area/template_noop)
"yw" = (
/obj/machinery/power/port_gen/pacman,
/obj/item/stack/material/phoron{
	amount = 25
	},
/turf/simulated/floor/outdoors/dirt,
/area/survivalpod/superpose/DragonCave)
"yB" = (
/obj/effect/decal/remains/deer,
/obj/effect/decal/cleanable/blood/splatter{
	color = "red"
	},
/obj/item/weapon/coin/gold,
/turf/simulated/floor/outdoors/newdirt,
/area/survivalpod/superpose/DragonCave)
"yE" = (
/obj/item/weapon/coin/gold,
/turf/simulated/floor/outdoors/newdirt,
/area/survivalpod/superpose/DragonCave)
"zh" = (
/obj/item/weapon/ore/gold,
/turf/simulated/floor/outdoors/dirt,
/area/survivalpod/superpose/DragonCave)
"zp" = (
/obj/effect/decal/cleanable/blood/tracks{
	color = "red";
	desc = "Your instincts say you shouldn't be following these.";
	icon = 'icons/effects/blood.dmi';
	icon_state = "tracks"
	},
/turf/simulated/floor/outdoors/dirt,
/area/survivalpod/superpose/DragonCave)
"AK" = (
/obj/effect/decal/cleanable/blood/tracks{
	color = "red";
	desc = "Your instincts say you shouldn't be following these.";
	icon = 'icons/effects/blood.dmi';
	icon_state = "tracks"
	},
/turf/simulated/floor/outdoors/rocks,
/area/survivalpod/superpose/DragonCave)
"Bi" = (
/obj/item/clothing/shoes/tribalwear,
/obj/item/clothing/under/tribalwear/common2,
/obj/item/weapon/material/twohanded/spear,
/obj/structure/dogbed,
/turf/simulated/floor/outdoors/dirt,
/area/survivalpod/superpose/DragonCave)
"Bk" = (
/obj/effect/decal/remains/lizard,
/turf/simulated/floor/outdoors/dirt,
/area/survivalpod/superpose/DragonCave)
"DI" = (
/obj/effect/decal/cleanable/blood/tracks{
	color = "red";
	desc = "Your instincts say you shouldn't be following these.";
	dir = 4;
	icon = 'icons/effects/blood.dmi';
	icon_state = "tracks"
	},
/turf/simulated/floor/outdoors/dirt,
/area/survivalpod/superpose/DragonCave)
"Ef" = (
/turf/template_noop,
/area/template_noop)
"Er" = (
/obj/fiftyspawner/gold,
/obj/item/slime_extract/gold,
/obj/item/weapon/flame/lighter/zippo/gold{
	pixel_x = 11;
	pixel_y = -5
	},
/turf/simulated/floor/outdoors/newdirt,
/area/survivalpod/superpose/DragonCave)
"EH" = (
/turf/simulated/floor/water/hotspring,
/area/survivalpod/superpose/DragonCave)
"FN" = (
/turf/simulated/wall/wood,
/area/survivalpod/superpose/DragonCave)
"Hn" = (
/obj/item/weapon/potion_material/golden_scale{
	pixel_x = 7;
	pixel_y = -9
	},
/turf/simulated/floor/outdoors/newdirt,
/area/survivalpod/superpose/DragonCave)
"Ho" = (
/obj/structure/flora/sif/subterranean{
	icon_state = "glowplant1"
	},
/turf/simulated/floor/outdoors/dirt,
/area/survivalpod/superpose/DragonCave)
"HG" = (
/obj/structure/bonfire/permanent/sifwood,
/turf/simulated/floor/outdoors/dirt,
/area/survivalpod/superpose/DragonCave)
"Iu" = (
/obj/structure/flora/rocks2,
/turf/simulated/floor/outdoors/rocks,
/area/survivalpod/superpose/DragonCave)
"Jp" = (
/obj/structure/ledge/ledge_stairs{
	dir = 8
	},
/turf/simulated/floor/outdoors/rocks,
/area/survivalpod/superpose/DragonCave)
"Kq" = (
/turf/simulated/floor/outdoors/dirt,
/area/survivalpod/superpose/DragonCave)
"KG" = (
/obj/structure/flora/rocks1,
/turf/simulated/floor/outdoors/rocks,
/area/survivalpod/superpose/DragonCave)
"LI" = (
/obj/structure/flora/bboulder1,
/turf/simulated/floor/outdoors/rocks,
/area/survivalpod/superpose/DragonCave)
"MA" = (
/obj/structure/dogbed,
/turf/simulated/floor/outdoors/dirt,
/area/survivalpod/superpose/DragonCave)
"Nh" = (
/obj/structure/outcrop/iron,
/turf/template_noop,
/area/template_noop)
"Ph" = (
/obj/item/clothing/gloves/ring/material/gold,
/obj/item/clothing/ears/earring/stud/gold,
/obj/item/weapon/gun/projectile/deagle/gold{
	pixel_x = -11;
	pixel_y = -22
	},
/obj/item/weapon/coin/gold{
	pixel_x = -7;
	pixel_y = -2
	},
/obj/item/weapon/coin/gold{
	pixel_x = 5;
	pixel_y = 7
	},
/turf/simulated/floor/outdoors/newdirt,
/area/survivalpod/superpose/DragonCave)
"Pt" = (
/obj/item/clothing/accessory/bracelet/material/gold{
	pixel_x = -7;
	pixel_y = 20
	},
/obj/item/clothing/ears/earring/dangle/gold,
/obj/item/instrument/violin/golden{
	pixel_x = 7
	},
/obj/item/weapon/flame/lighter/zippo/gold,
/turf/simulated/floor/outdoors/newdirt,
/area/survivalpod/superpose/DragonCave)
"Qa" = (
/obj/structure/table/sifwooden_reinforced,
/obj/fiftyspawner/glass,
/obj/fiftyspawner/steel,
/turf/simulated/floor/outdoors/dirt,
/area/survivalpod/superpose/DragonCave)
"RK" = (
/turf/simulated/mineral/ignore_mapgen,
/area/survivalpod/superpose/DragonCave)
"RS" = (
/obj/item/weapon/flame/lighter/zippo/gold{
	pixel_x = -6;
	pixel_y = -8
	},
/obj/item/weapon/coin/gold,
/turf/simulated/floor/outdoors/newdirt,
/area/survivalpod/superpose/DragonCave)
"Sp" = (
/obj/item/clothing/shoes/tribalwear,
/obj/item/clothing/under/tribalwear/shaman,
/obj/item/weapon/material/twohanded/spear,
/turf/simulated/floor/outdoors/dirt,
/area/survivalpod/superpose/DragonCave)
"SM" = (
/obj/item/weapon/material/twohanded/spear/flint,
/obj/item/weapon/coin/gold{
	pixel_x = -14;
	pixel_y = 8
	},
/obj/item/weapon/coin/gold{
	pixel_x = 4;
	pixel_y = 7
	},
/obj/item/weapon/coin/gold{
	pixel_x = -13;
	pixel_y = -6
	},
/turf/simulated/floor/outdoors/newdirt,
/area/survivalpod/superpose/DragonCave)
"Tz" = (
/obj/item/clothing/accessory/medal/solgov/gold/sun,
/obj/item/weapon/pickaxe/gold{
	pixel_x = -12;
	pixel_y = 9
	},
/obj/item/weapon/reagent_containers/food/drinks/golden_cup{
	pixel_x = -10;
	pixel_y = -5
	},
/turf/simulated/floor/outdoors/newdirt,
/area/survivalpod/superpose/DragonCave)
"TB" = (
/obj/structure/flora/sif/subterranean{
	icon_state = "glowplant2"
	},
/turf/simulated/floor/outdoors/dirt,
/area/survivalpod/superpose/DragonCave)
"TQ" = (
/obj/structure/outcrop/gold,
/turf/simulated/floor/outdoors/dirt,
/area/survivalpod/superpose/DragonCave)
"Ud" = (
/obj/item/stack/material/gold,
/turf/simulated/floor/outdoors/newdirt,
/area/survivalpod/superpose/DragonCave)
"VL" = (
/obj/machinery/power/apc/alarms_hidden{
	dir = 1;
	pixel_y = 20
	},
/turf/simulated/floor/outdoors/dirt,
/area/survivalpod/superpose/DragonCave)
"Wd" = (
/obj/item/weapon/reagent_containers/food/snacks/meat,
/obj/item/weapon/reagent_containers/food/snacks/meat,
/obj/item/weapon/reagent_containers/food/snacks/meat,
/obj/effect/decal/cleanable/filth,
/turf/simulated/floor/outdoors/dirt,
/area/survivalpod/superpose/DragonCave)
"WJ" = (
/obj/structure/flora/lily1,
/turf/simulated/floor/water/hotspring,
/area/survivalpod/superpose/DragonCave)
"WN" = (
/obj/effect/decal/cleanable/filth,
/turf/simulated/floor/outdoors/dirt,
/area/survivalpod/superpose/DragonCave)
"XZ" = (
/obj/structure/flora/sif/subterranean{
	icon_state = "glowplant1"
	},
/turf/simulated/floor/outdoors/newdirt,
/area/survivalpod/superpose/DragonCave)
"Zn" = (
/obj/effect/decal/cleanable/blood/splatter{
	color = "red"
	},
/turf/simulated/floor/outdoors/dirt,
/area/survivalpod/superpose/DragonCave)
"ZE" = (
/obj/effect/decal/remains/deer,
/turf/simulated/floor/outdoors/dirt,
/area/survivalpod/superpose/DragonCave)

(1,1,1) = {"
Ef
Ef
Ef
Ef
Ef
Ef
Ef
RK
RK
RK
RK
RK
RK
RK
RK
Ef
Ef
Ef
"}
(2,1,1) = {"
Ef
RK
RK
xS
Ef
RK
RK
RK
RK
TQ
TQ
Kq
mh
RK
RK
RK
RK
Ef
"}
(3,1,1) = {"
RK
RK
RK
RK
RK
RK
RK
TQ
Kq
Kq
fw
fN
Kq
TQ
TB
gJ
RK
Nh
"}
(4,1,1) = {"
RK
RK
RK
RK
RK
RK
Kq
Kq
Ho
Kq
Kq
Kq
Kq
zh
sB
aD
RK
RK
"}
(5,1,1) = {"
RK
RK
RK
RK
Kq
Kq
Kq
Zn
Kq
Kq
WN
Kq
fN
aD
cY
yB
RK
RK
"}
(6,1,1) = {"
RK
RK
RK
Kq
Kq
Kq
Kq
Kq
Kq
fN
Kq
Kq
Kq
aD
xc
Ud
RK
RK
"}
(7,1,1) = {"
RK
RK
Kq
Kq
zp
Kq
zp
zp
Bk
wy
zp
aL
Kq
db
Hn
Er
Pt
RK
"}
(8,1,1) = {"
RK
RK
Kq
Kq
Kq
RK
Kq
Kq
Kq
Kq
Kq
WN
ZE
aD
pa
Ph
Tz
RK
"}
(9,1,1) = {"
RK
RK
Jp
Jp
Jp
RK
TQ
Kq
mh
Kq
sW
Kq
WN
Kq
yE
RS
SM
RK
"}
(10,1,1) = {"
RK
Iu
na
dc
LI
RK
TB
Kq
Zn
Kq
Kq
qZ
Kq
mV
Kq
XZ
RK
RK
"}
(11,1,1) = {"
jp
AK
AK
KG
RK
RK
RK
RK
Kq
wt
DI
WN
TQ
fN
zh
RK
RK
RK
"}
(12,1,1) = {"
jp
KG
na
RK
RK
RK
RK
RK
RK
TQ
Wd
uh
FN
qX
qX
RK
RK
Ef
"}
(13,1,1) = {"
jp
fW
RK
RK
RK
oy
Qa
yw
RK
RK
RK
RK
FN
Kq
Kq
RK
RK
Ef
"}
(14,1,1) = {"
RK
RK
RK
RK
hc
Kq
Kq
Kq
bV
RK
RK
RK
Kq
Kq
Kq
pF
RK
RK
"}
(15,1,1) = {"
RK
RK
RK
FN
VL
Kq
Kq
Kq
Kq
wn
RK
Sp
Kq
Kq
EH
WJ
RK
RK
"}
(16,1,1) = {"
RK
RK
RK
RK
RK
MA
HG
Bi
Kq
Kq
Kq
Kq
Kq
Kq
EH
jC
RK
RK
"}
(17,1,1) = {"
RK
RK
RK
RK
RK
RK
RK
RK
fK
Kq
Kq
Kq
TB
kT
EH
RK
RK
Ef
"}
(18,1,1) = {"
Ef
RK
RK
Nh
Ef
RK
RK
RK
RK
RK
RK
RK
RK
RK
RK
RK
oa
Ef
"}
