//MAP CONVERTED BY dmm2tgm.py THIS HEADER COMMENT PREVENTS RECONVERSION, DO NOT REMOVE
"aa" = (
/turf/template_noop,
/area/survivalpod/superpose/ExplorerHome)
"ab" = (
/obj/structure/railing,
/turf/template_noop,
/area/survivalpod/superpose/ExplorerHome)
"ac" = (
/obj/structure/railing{
	dir = 4
	},
/turf/template_noop,
/area/survivalpod/superpose/ExplorerHome)
"ad" = (
/turf/simulated/floor/outdoors/grass/sif,
/area/survivalpod/superpose/ExplorerHome)
"ae" = (
/obj/structure/railing{
	dir = 8
	},
/turf/template_noop,
/area/survivalpod/superpose/ExplorerHome)
"af" = (
/obj/structure/railing{
	dir = 4
	},
/turf/simulated/floor/outdoors/grass/sif,
/area/survivalpod/superpose/ExplorerHome)
"ag" = (
/turf/simulated/floor/outdoors/dirt,
/area/survivalpod/superpose/ExplorerHome)
"ah" = (
/obj/structure/table/bench/wooden,
/turf/simulated/floor/outdoors/dirt,
/area/survivalpod/superpose/ExplorerHome)
"ai" = (
/obj/structure/railing{
	dir = 8
	},
/turf/simulated/floor/outdoors/grass/sif,
/area/survivalpod/superpose/ExplorerHome)
"aj" = (
/obj/structure/target_stake,
/turf/simulated/floor/outdoors/dirt,
/area/survivalpod/superpose/ExplorerHome)
"ak" = (
/obj/item/target,
/turf/simulated/floor/outdoors/grass/sif,
/area/survivalpod/superpose/ExplorerHome)
"al" = (
/obj/item/target/syndicate,
/turf/simulated/floor/outdoors/grass/sif,
/area/survivalpod/superpose/ExplorerHome)
"am" = (
/turf/simulated/wall/wood,
/area/survivalpod/superpose/ExplorerHome)
"an" = (
/obj/structure/simple_door/wood,
/turf/simulated/floor/wood,
/area/survivalpod/superpose/ExplorerHome)
"ao" = (
/obj/structure/closet/crate,
/obj/item/stack/material/cardboard{
	amount = 50
	},
/obj/item/stack/material/cardboard{
	amount = 50
	},
/obj/item/stack/material/cardboard{
	amount = 50
	},
/obj/item/stack/material/cardboard{
	amount = 50
	},
/obj/fiftyspawner/blucarpet,
/obj/fiftyspawner/oracarpet,
/obj/fiftyspawner/purcarpet,
/obj/fiftyspawner/sblucarpet,
/obj/fiftyspawner/tealcarpet,
/obj/fiftyspawner/turcarpet,
/obj/item/stack/material/wood{
	amount = 50;
	color = "#824B28"
	},
/obj/item/stack/material/wood{
	amount = 50;
	color = "#824B28"
	},
/obj/item/stack/material/wood/hard{
	amount = 50
	},
/obj/item/stack/material/wood/hard{
	amount = 50
	},
/obj/item/stack/material/wood/sif{
	amount = 50
	},
/obj/item/stack/material/wood/sif{
	amount = 50
	},
/obj/item/stack/material/marble{
	amount = 50
	},
/obj/item/stack/material/marble{
	amount = 50
	},
/obj/item/stack/material/marble{
	amount = 50
	},
/obj/item/stack/material/cloth{
	amount = 50
	},
/obj/item/stack/material/cloth{
	amount = 50
	},
/obj/item/stack/material/algae{
	amount = 50
	},
/obj/item/stack/material/sandstone,
/obj/item/stack/material/sandstone,
/obj/item/stack/material/sandstone,
/obj/item/stack/material/lead{
	amount = 30
	},
/obj/item/stack/material/plasteel{
	amount = 30;
	pixel_y = 5
	},
/obj/item/stack/material/resin{
	amount = 50
	},
/obj/item/stack/material/smolebricks{
	amount = 50
	},
/obj/item/stack/material/smolebricks{
	amount = 50
	},
/turf/simulated/floor/plating,
/area/survivalpod/superpose/ExplorerHome)
"ap" = (
/turf/simulated/floor/wood,
/area/survivalpod/superpose/ExplorerHome)
"aq" = (
/obj/structure/table/marble,
/obj/item/material/kitchen/rollingpin,
/turf/simulated/floor/tiled,
/area/survivalpod/superpose/ExplorerHome)
"ar" = (
/obj/structure/table/marble,
/obj/item/material/knife,
/turf/simulated/floor/tiled,
/area/survivalpod/superpose/ExplorerHome)
"as" = (
/obj/structure/grille/rustic,
/obj/structure/window/reinforced/full,
/turf/simulated/floor/plating,
/area/survivalpod/superpose/ExplorerHome)
"at" = (
/obj/structure/table/standard,
/obj/item/reagent_containers/hypospray/autoinjector/biginjector/brute,
/obj/item/reagent_containers/hypospray/autoinjector/biginjector/burn,
/obj/item/reagent_containers/hypospray/autoinjector/biginjector/purity,
/turf/simulated/floor/tiled/freezer,
/area/survivalpod/superpose/ExplorerHome)
"au" = (
/obj/structure/toilet,
/turf/simulated/floor/tiled/freezer,
/area/survivalpod/superpose/ExplorerHome)
"av" = (
/obj/structure/table/marble,
/obj/random/drinkbottle,
/turf/simulated/floor/tiled,
/area/survivalpod/superpose/ExplorerHome)
"aw" = (
/obj/item/flashlight/lantern,
/turf/simulated/floor/tiled,
/area/survivalpod/superpose/ExplorerHome)
"ax" = (
/obj/structure/table/glass,
/obj/structure/window/reinforced,
/obj/item/coin/phoron,
/turf/simulated/floor/wood,
/area/survivalpod/superpose/ExplorerHome)
"ay" = (
/obj/item/clothing/head/bearpelt{
	pixel_y = 6
	},
/obj/structure/table/glass,
/obj/structure/window/reinforced,
/turf/simulated/floor/wood,
/area/survivalpod/superpose/ExplorerHome)
"az" = (
/obj/item/material/harpoon,
/obj/structure/table/glass,
/obj/structure/window/reinforced,
/turf/simulated/floor/wood,
/area/survivalpod/superpose/ExplorerHome)
"aA" = (
/obj/structure/table/glass,
/obj/structure/window/reinforced,
/obj/item/clothing/accessory/medal/conduct{
	pixel_y = 6
	},
/turf/simulated/floor/wood,
/area/survivalpod/superpose/ExplorerHome)
"aB" = (
/obj/structure/sink{
	dir = 8;
	pixel_x = -12;
	pixel_y = 2
	},
/obj/structure/mirror{
	dir = 4;
	pixel_x = -28
	},
/turf/simulated/floor/tiled/freezer,
/area/survivalpod/superpose/ExplorerHome)
"aC" = (
/obj/item/towel,
/turf/simulated/floor/tiled/freezer,
/area/survivalpod/superpose/ExplorerHome)
"aD" = (
/obj/structure/closet/secure_closet/freezer/fridge,
/turf/simulated/floor/tiled,
/area/survivalpod/superpose/ExplorerHome)
"aE" = (
/turf/simulated/floor/tiled,
/area/survivalpod/superpose/ExplorerHome)
"aF" = (
/obj/structure/simple_door/wood,
/turf/simulated/floor/tiled,
/area/survivalpod/superpose/ExplorerHome)
"aG" = (
/obj/structure/simple_door/wood,
/turf/simulated/floor/tiled/freezer,
/area/survivalpod/superpose/ExplorerHome)
"aH" = (
/obj/item/flashlight/lantern,
/turf/simulated/floor/tiled/freezer,
/area/survivalpod/superpose/ExplorerHome)
"aI" = (
/obj/structure/window/reinforced/tinted{
	dir = 8
	},
/obj/machinery/shower{
	dir = 1
	},
/obj/random/soap,
/turf/simulated/floor/tiled/freezer,
/area/survivalpod/superpose/ExplorerHome)
"aJ" = (
/turf/simulated/floor/carpet/turcarpet,
/area/survivalpod/superpose/ExplorerHome)
"aK" = (
/obj/structure/bed/chair/wood,
/turf/simulated/floor/carpet/turcarpet,
/area/survivalpod/superpose/ExplorerHome)
"aL" = (
/obj/structure/bed/chair/wood{
	dir = 4
	},
/turf/simulated/floor/carpet/turcarpet,
/area/survivalpod/superpose/ExplorerHome)
"aM" = (
/obj/structure/table/wooden_reinforced,
/obj/item/storage/fancy/candle_box,
/turf/simulated/floor/carpet/turcarpet,
/area/survivalpod/superpose/ExplorerHome)
"aN" = (
/obj/structure/table/wooden_reinforced,
/obj/item/binoculars/spyglass,
/turf/simulated/floor/carpet/turcarpet,
/area/survivalpod/superpose/ExplorerHome)
"aO" = (
/obj/structure/table/wooden_reinforced,
/obj/item/flashlight/lantern,
/turf/simulated/floor/carpet/turcarpet,
/area/survivalpod/superpose/ExplorerHome)
"aP" = (
/obj/structure/bed/chair/wood{
	dir = 1
	},
/turf/simulated/floor/carpet/turcarpet,
/area/survivalpod/superpose/ExplorerHome)
"aQ" = (
/obj/structure/closet/walllocker_double/north,
/obj/item/gps,
/obj/item/sticky_pad/random,
/obj/item/starcaster_news,
/obj/item/pen/blue,
/obj/item/pda,
/obj/item/card/id/external,
/obj/item/storage/mre/random,
/obj/item/storage/mre/random,
/obj/item/reagent_containers/food/drinks/cans/waterbottle,
/obj/item/reagent_containers/food/drinks/cans/waterbottle,
/obj/item/reagent_containers/food/snacks/sosjerky,
/obj/item/reagent_containers/food/snacks/sosjerky,
/obj/item/clothing/accessory/permit/gun,
/obj/item/camera,
/obj/item/binoculars,
/obj/item/threadneedle,
/obj/random/soap,
/obj/item/towel/random,
/obj/item/bodybag/cryobag,
/obj/item/flashlight/flare,
/obj/item/flashlight/flare,
/obj/item/flashlight/color/yellow,
/obj/item/radio,
/obj/item/radio,
/obj/item/flame/lighter/random,
/obj/item/cell/device/hyper,
/obj/item/cell/device/hyper,
/obj/item/extinguisher/mini,
/obj/item/reagent_containers/glass/beaker/vial/tricordrazine,
/obj/item/reagent_containers/glass/beaker/vial/tricordrazine,
/obj/item/reagent_containers/pill/spaceacillin,
/obj/item/reagent_containers/pill/spaceacillin,
/obj/item/fbp_backup_cell,
/obj/item/fbp_backup_cell,
/obj/item/suit_cooling_unit/emergency,
/obj/item/stack/nanopaste,
/obj/item/reagent_containers/hypospray/autoinjector/biginjector/clotting,
/obj/item/storage/backpack/messenger,
/obj/item/clothing/accessory/storage/black_drop_pouches,
/obj/item/clothing/accessory/poncho/thermal,
/obj/item/storage/box/survival/comp,
/obj/item/storage/toolbox/brass,
/obj/item/storage/box/khcrystal,
/turf/simulated/floor/wood,
/area/survivalpod/superpose/ExplorerHome)
"aR" = (
/obj/structure/simple_door/wood,
/turf/simulated/floor/carpet/sblucarpet,
/area/survivalpod/superpose/ExplorerHome)
"aS" = (
/turf/simulated/floor/carpet/sblucarpet,
/area/survivalpod/superpose/ExplorerHome)
"aT" = (
/obj/machinery/space_heater,
/turf/simulated/floor/carpet/sblucarpet,
/area/survivalpod/superpose/ExplorerHome)
"aU" = (
/obj/structure/closet/crate,
/obj/item/stack/material/plastic{
	amount = 50
	},
/obj/item/stack/material/plastic{
	amount = 50
	},
/obj/item/stack/material/plastic{
	amount = 50
	},
/obj/item/stack/material/plastic{
	amount = 50
	},
/obj/item/stack/material/steel{
	amount = 50
	},
/obj/item/stack/material/steel{
	amount = 50
	},
/obj/item/stack/material/steel{
	amount = 50
	},
/obj/item/stack/material/steel{
	amount = 50
	},
/obj/item/stack/material/glass{
	amount = 50
	},
/obj/item/stack/material/glass{
	amount = 50
	},
/obj/item/stack/material/glass{
	amount = 50
	},
/obj/item/stack/material/glass{
	amount = 50
	},
/obj/item/stack/rods{
	amount = 50
	},
/obj/item/stack/rods{
	amount = 50
	},
/obj/item/stack/rods{
	amount = 50
	},
/obj/item/stack/rods{
	amount = 50
	},
/obj/item/stack/cable_coil{
	pixel_x = 3;
	pixel_y = 3
	},
/obj/item/stack/cable_coil{
	pixel_x = 3;
	pixel_y = 3
	},
/obj/item/stack/cable_coil/green,
/obj/item/stack/cable_coil/blue,
/obj/item/storage/briefcase/inflatable,
/obj/item/storage/briefcase/inflatable,
/obj/item/storage/briefcase/inflatable,
/obj/item/storage/briefcase/inflatable,
/turf/simulated/floor/wood,
/area/survivalpod/superpose/ExplorerHome)
"aV" = (
/obj/item/flashlight/lantern,
/turf/simulated/floor/wood,
/area/survivalpod/superpose/ExplorerHome)
"aW" = (
/obj/machinery/space_heater,
/turf/simulated/floor/wood,
/area/survivalpod/superpose/ExplorerHome)
"aX" = (
/obj/machinery/power/port_gen/pacman,
/obj/item/stack/material/phoron{
	amount = 25
	},
/turf/simulated/floor/wood,
/area/survivalpod/superpose/ExplorerHome)
"aY" = (
/obj/item/clothing/suit/storage/hooded/explorer,
/obj/item/clothing/mask/gas/explorer,
/obj/item/material/knife/tacknife/survival,
/obj/structure/table/rack/shelf,
/obj/item/cell/device,
/obj/item/cell/device,
/obj/item/cell/device,
/obj/item/clothing/under/explorer,
/turf/simulated/floor/wood,
/area/survivalpod/superpose/ExplorerHome)
"aZ" = (
/obj/item/clothing/shoes/boots/winter/explorer,
/obj/item/gun/launcher/crossbow/bow/hardlight,
/turf/simulated/floor/wood,
/area/survivalpod/superpose/ExplorerHome)
"ba" = (
/obj/structure/table/woodentable,
/obj/random/action_figure,
/obj/item/flashlight/lantern,
/turf/simulated/floor/carpet/sblucarpet,
/area/survivalpod/superpose/ExplorerHome)
"bb" = (
/obj/item/bedsheet/hopdouble,
/obj/structure/bed/double/padded,
/turf/simulated/floor/carpet/sblucarpet,
/area/survivalpod/superpose/ExplorerHome)
"bc" = (
/obj/machinery/portable_atmospherics/hydroponics/soil,
/turf/simulated/floor/outdoors/dirt,
/area/survivalpod/superpose/ExplorerHome)
"bd" = (
/obj/structure/table/glass,
/obj/structure/window/reinforced{
	dir = 4;
	health = 1e+006
	},
/obj/item/twohanded/fireaxe/fluff/mjollnir,
/turf/simulated/floor/wood,
/area/survivalpod/superpose/ExplorerHome)
"be" = (
/obj/structure/sign/kiddieplaque{
	desc = "To anyone reading this, you'll note that I'm not home right now, and unfortunately due to reassignment, I won't be for a very long time. Exploring somewhere really far and dangerous now. You can stay if you want, but please try to keep my home in good condition.";
	name = "read me visitors"
	},
/turf/simulated/wall/wood,
/area/survivalpod/superpose/ExplorerHome)
"bf" = (
/obj/structure/bonfire/sifwood,
/turf/simulated/floor/outdoors/dirt,
/area/survivalpod/superpose/ExplorerHome)
"eB" = (
/obj/machinery/smartfridge/survival_pod,
/obj/item/tape_roll,
/obj/item/sticky_pad/random,
/obj/item/pen/blue,
/obj/item/pen/blue,
/obj/item/fulton_core,
/obj/item/fulton_core,
/obj/item/extraction_pack,
/obj/item/extraction_pack,
/obj/item/modular_computer/laptop/preset/custom_loadout/standard,
/obj/item/pickaxe/hand,
/obj/item/flashlight/color/yellow,
/obj/item/flashlight/color/orange,
/obj/item/threadneedle,
/obj/item/radio,
/obj/item/radio,
/obj/item/radio,
/obj/item/extinguisher/mini,
/obj/item/extinguisher/mini,
/obj/item/flame/lighter/zippo,
/obj/item/flame/lighter/zippo,
/obj/item/flashlight/lantern,
/obj/random/soap,
/obj/random/soap,
/obj/item/towel/random,
/obj/item/towel/random,
/obj/item/bodybag/cryobag,
/obj/item/bodybag/cryobag,
/obj/item/storage/pill_bottle/spaceacillin,
/obj/item/storage/pill_bottle/antitox,
/obj/item/healthanalyzer,
/obj/item/storage/firstaid/regular,
/obj/item/storage/firstaid/o2,
/obj/item/fbp_backup_cell,
/obj/item/fbp_backup_cell,
/obj/item/stack/nanopaste,
/obj/item/suit_cooling_unit/emergency,
/obj/item/suit_cooling_unit/emergency,
/obj/item/reagent_containers/hypospray/autoinjector/biginjector/clotting,
/obj/item/reagent_containers/hypospray/autoinjector/biginjector/clotting,
/obj/item/storage/toolbox/brass,
/obj/item/storage/box/survival/space,
/obj/item/storage/box/survival/space,
/obj/item/storage/box/survival/space,
/obj/item/storage/pill_bottle/dice_nerd,
/obj/item/storage/box/flare,
/obj/item/storage/box/khcrystal,
/obj/item/storage/box/khcrystal,
/obj/item/storage/briefcase/inflatable,
/obj/item/stack/marker_beacon/ten,
/obj/item/starcaster_news,
/obj/item/mapping_unit,
/obj/item/storage/box/dosimeter,
/obj/item/gps,
/obj/item/gps,
/obj/item/cell/device/hyper,
/obj/item/cell/device/hyper,
/obj/item/cell/device/hyper,
/obj/item/pda,
/obj/item/pda,
/obj/item/card/id/external,
/obj/item/card/id/external,
/obj/item/storage/mre/random,
/obj/item/storage/mre/random,
/obj/item/storage/mre/random,
/obj/item/storage/mre/random,
/obj/item/storage/mre/random,
/obj/item/storage/mre/random,
/obj/item/reagent_containers/food/drinks/cans/waterbottle,
/obj/item/reagent_containers/food/drinks/cans/waterbottle,
/obj/item/reagent_containers/food/drinks/cans/waterbottle,
/obj/item/reagent_containers/food/drinks/cans/waterbottle,
/obj/item/gun/energy/locked/phasegun/pistol,
/obj/item/gun/energy/locked/phasegun,
/obj/item/cell/device/weapon{
	pixel_x = -2;
	pixel_y = -2
	},
/obj/item/cell/device/weapon{
	pixel_x = -2;
	pixel_y = -2
	},
/obj/item/clothing/accessory/permit/gun,
/obj/item/clothing/accessory/permit/gun,
/obj/item/material/knife/machete,
/obj/item/material/fishing_net,
/obj/item/storage/backpack/sport,
/obj/item/storage/backpack/sport,
/obj/item/clothing/accessory/storage/black_drop_pouches,
/obj/item/clothing/accessory/storage/black_drop_pouches,
/obj/item/storage/belt,
/obj/item/clothing/accessory/poncho/thermal,
/turf/simulated/floor/plating,
/area/survivalpod/superpose/ExplorerHome)
"fb" = (
/obj/machinery/power/terminal{
	dir = 1
	},
/turf/simulated/floor/plating,
/area/survivalpod/superpose/ExplorerHome)
"qU" = (
/obj/machinery/power/apc{
	dir = 8;
	pixel_x = -26
	},
/obj/structure/cable/green{
	d2 = 2;
	icon_state = "0-2"
	},
/turf/simulated/floor/wood,
/area/survivalpod/superpose/ExplorerHome)
"sV" = (
/obj/structure/cable/green{
	d1 = 1;
	d2 = 2;
	icon_state = "1-2"
	},
/turf/simulated/floor/wood,
/area/survivalpod/superpose/ExplorerHome)
"th" = (
/obj/item/stack/material/phoron{
	amount = 25
	},
/turf/simulated/floor/wood,
/area/survivalpod/superpose/ExplorerHome)
"zc" = (
/obj/structure/grille/rustic,
/obj/structure/window/reinforced/full,
/obj/structure/cable/green{
	d1 = 1;
	d2 = 2;
	icon_state = "1-2"
	},
/turf/simulated/floor/plating,
/area/survivalpod/superpose/ExplorerHome)
"Dg" = (
/obj/machinery/power/smes/batteryrack/mapped,
/obj/structure/cable/green,
/turf/simulated/floor/plating,
/area/survivalpod/superpose/ExplorerHome)
"GN" = (
/obj/machinery/portable_atmospherics/canister/air,
/turf/simulated/floor/wood,
/area/survivalpod/superpose/ExplorerHome)
"Ky" = (
/obj/structure/table/glass,
/obj/structure/window/reinforced{
	dir = 8
	},
/obj/item/ore/diamond,
/turf/simulated/floor/wood,
/area/survivalpod/superpose/ExplorerHome)

(1,1,1) = {"
aa
ac
af
af
af
af
ad
ad
ad
ad
ad
ad
ad
ad
ad
ad
ad
ad
ad
ad
"}
(2,1,1) = {"
ab
ad
ad
ag
ad
ak
am
am
as
am
am
ad
am
am
as
am
am
bc
ag
ag
"}
(3,1,1) = {"
ab
ad
ag
aj
ag
al
am
aq
av
aD
am
ad
am
aQ
aU
aY
am
bc
ag
ag
"}
(4,1,1) = {"
ab
ad
ag
ag
ag
ak
am
ar
aw
aE
am
ad
am
ap
aV
aZ
am
bc
ag
ag
"}
(5,1,1) = {"
ab
ad
ag
ag
ag
ad
am
am
am
aF
am
am
am
an
am
am
am
bc
ag
ag
"}
(6,1,1) = {"
ab
ad
ag
ag
ag
ad
ad
as
ax
ap
ap
GN
qU
sV
sV
zc
Dg
fb
ag
ag
"}
(7,1,1) = {"
ab
ad
ag
ag
ag
am
am
am
ay
ap
aJ
aL
aJ
ap
aW
am
am
am
ag
ag
"}
(8,1,1) = {"
ab
ad
ag
ag
ag
am
ao
am
am
ap
aK
aM
aP
ap
am
am
bd
am
ag
ag
"}
(9,1,1) = {"
ab
ad
ag
ag
ag
an
ap
ap
an
ap
aK
aN
aP
ap
an
ap
ap
an
ag
ag
"}
(10,1,1) = {"
ab
ad
ag
ag
ag
am
eB
am
am
ap
aK
aO
aP
ap
am
am
Ky
be
ag
ag
"}
(11,1,1) = {"
ab
ad
ag
ag
ag
am
am
am
az
ap
aJ
aP
aJ
ap
aX
am
am
am
ag
ag
"}
(12,1,1) = {"
ab
ad
ah
ag
ah
ad
ad
as
aA
ap
ap
ap
ap
ap
th
as
ad
ad
ag
ag
"}
(13,1,1) = {"
ab
ad
ah
bf
ah
ad
am
am
am
aG
am
am
am
aR
am
am
am
bc
ag
ag
"}
(14,1,1) = {"
ab
ad
ah
ag
ah
ad
am
at
aB
aH
am
ad
am
aS
aS
ba
am
bc
ag
ag
"}
(15,1,1) = {"
ab
ad
ag
ag
ag
ad
am
au
aC
aI
am
ad
am
aT
aS
bb
am
bc
ag
ag
"}
(16,1,1) = {"
ab
ad
ad
ag
ad
ad
am
am
am
am
am
ad
am
am
as
am
am
bc
ag
ag
"}
(17,1,1) = {"
aa
ae
ai
ai
ai
ai
ad
ad
ad
ad
ad
ad
ad
ad
ad
ad
ad
ad
ad
ad
"}
