//MAP CONVERTED BY dmm2tgm.py THIS HEADER COMMENT PREVENTS RECONVERSION, DO NOT REMOVE
"av" = (
/obj/machinery/portable_atmospherics/hydroponics/soil,
/obj/item/seeds/icepepperseed,
/turf/simulated/floor/outdoors/dirt{
	outdoors = 0
	},
/area/submap/farm)
"cs" = (
/obj/machinery/seed_storage/garden,
/turf/simulated/floor/plating,
/area/submap/farm)
"cz" = (
/obj/structure/bed/double/padded,
/obj/item/weapon/bedsheet/yellowdouble,
/turf/simulated/floor/wood,
/area/submap/farm)
"db" = (
/obj/structure/table/woodentable,
/obj/item/weapon/storage/fancy/candle_box,
/turf/simulated/floor/wood,
/area/submap/farm)
"dx" = (
/obj/structure/table/marble,
/obj/item/weapon/material/knife,
/turf/simulated/floor/wood,
/area/submap/farm)
"dJ" = (
/turf/simulated/floor/outdoors/dirt,
/area/submap/farm)
"dM" = (
/obj/item/weapon/material/knife/machete/hatchet,
/turf/simulated/floor/outdoors/mud{
	outdoors = 0
	},
/area/submap/farm)
"dV" = (
/obj/structure/table/bench/sifwooden,
/turf/simulated/floor/outdoors/rocks,
/area/submap/farm)
"eb" = (
/obj/machinery/power/port_gen/pacman,
/turf/simulated/floor/plating,
/area/submap/farm)
"ec" = (
/obj/structure/window/reinforced/full{
	dir = 8
	},
/obj/structure/window/reinforced/full{
	dir = 4
	},
/obj/machinery/portable_atmospherics/powered/scrubber/huge/stationary,
/turf/simulated/floor/plating,
/area/submap/farm)
"eq" = (
/turf/template_noop,
/area/template_noop)
"fp" = (
/obj/structure/bed/chair/wood{
	dir = 8;
	icon_state = "wooden_chair"
	},
/turf/simulated/floor/wood,
/area/submap/farm)
"gq" = (
/obj/structure/table/woodentable,
/obj/item/trash/candle,
/turf/simulated/floor/wood,
/area/submap/farm)
"gB" = (
/turf/simulated/floor/outdoors/dirt{
	outdoors = 0
	},
/area/submap/farm)
"gG" = (
/obj/machinery/portable_atmospherics/hydroponics/soil,
/obj/item/seeds/cornseed,
/turf/simulated/floor/outdoors/dirt{
	outdoors = 0
	},
/area/submap/farm)
"hQ" = (
/turf/simulated/floor/water,
/area/submap/farm)
"kb" = (
/obj/machinery/portable_atmospherics/canister/oxygen,
/turf/simulated/floor/plating,
/area/submap/farm)
"kd" = (
/obj/item/weapon/material/fishing_rod/modern/strong,
/turf/simulated/floor/outdoors/rocks,
/area/submap/farm)
"my" = (
/obj/machinery/portable_atmospherics/hydroponics/soil,
/obj/item/seeds/wheatseed,
/turf/simulated/floor/outdoors/dirt{
	outdoors = 0
	},
/area/submap/farm)
"mB" = (
/obj/structure/sink/puddle,
/turf/simulated/floor/outdoors/mud{
	outdoors = 0
	},
/area/submap/farm)
"oc" = (
/obj/structure/railing{
	dir = 8;
	icon_state = "railing0"
	},
/turf/simulated/floor/outdoors/dirt,
/area/submap/farm)
"or" = (
/obj/structure/grille/rustic,
/obj/structure/window/reinforced/full,
/turf/simulated/floor/plating,
/area/submap/farm)
"pU" = (
/obj/machinery/door/window/eastleft,
/obj/machinery/door/window/westleft,
/turf/simulated/floor/outdoors/dirt,
/area/submap/farm)
"qW" = (
/obj/structure/table/steel,
/obj/machinery/cell_charger,
/turf/simulated/floor/plating,
/area/submap/farm)
"te" = (
/obj/machinery/vending/hydronutrients,
/turf/simulated/floor/plating,
/area/submap/farm)
"ty" = (
/obj/structure/railing{
	dir = 1;
	icon_state = "railing0"
	},
/turf/simulated/floor/outdoors/dirt,
/area/submap/farm)
"vN" = (
/turf/simulated/floor/wood,
/area/submap/farm)
"wH" = (
/obj/machinery/portable_atmospherics/hydroponics/soil,
/obj/item/seeds/bluetomatoseed,
/turf/simulated/floor/outdoors/dirt{
	outdoors = 0
	},
/area/submap/farm)
"ys" = (
/obj/structure/table/marble,
/obj/machinery/microwave,
/turf/simulated/floor/wood,
/area/submap/farm)
"Ah" = (
/obj/item/clothing/shoes/boots/winter/hydro,
/obj/item/clothing/suit/storage/hooded/wintercoat/hydro,
/turf/simulated/floor/wood,
/area/submap/farm)
"Bb" = (
/obj/machinery/portable_atmospherics/powered/scrubber/huge/stationary,
/turf/simulated/floor/wood,
/area/submap/farm)
"Bz" = (
/obj/structure/reagent_dispensers/fueltank/high,
/turf/simulated/floor/plating,
/area/submap/farm)
"BI" = (
/obj/structure/reagent_dispensers/watertank/high,
/turf/simulated/floor/plating,
/area/submap/farm)
"BR" = (
/obj/structure/closet/crate/bin,
/turf/simulated/floor/wood,
/area/submap/farm)
"Eu" = (
/obj/machinery/space_heater,
/turf/simulated/floor/wood,
/area/submap/farm)
"Fe" = (
/obj/structure/railing,
/turf/simulated/floor/outdoors/dirt,
/area/submap/farm)
"FS" = (
/obj/structure/closet/crate,
/obj/fiftyspawner/glass,
/obj/fiftyspawner/glass,
/obj/fiftyspawner/glass,
/obj/fiftyspawner/glass,
/obj/fiftyspawner/glass,
/obj/fiftyspawner/steel,
/obj/fiftyspawner/steel,
/obj/fiftyspawner/steel,
/obj/fiftyspawner/steel,
/obj/fiftyspawner/steel,
/obj/fiftyspawner/plastic,
/obj/fiftyspawner/plastic,
/obj/fiftyspawner/plastic,
/obj/fiftyspawner/plastic,
/obj/fiftyspawner/plastic,
/turf/simulated/floor/plating,
/area/submap/farm)
"Gm" = (
/turf/simulated/wall/wood,
/area/submap/farm)
"GK" = (
/obj/machinery/floodlight,
/turf/simulated/floor/plating,
/area/submap/farm)
"GQ" = (
/obj/item/weapon/storage/box/wormcan/deluxe,
/turf/simulated/floor/outdoors/rocks,
/area/submap/farm)
"GX" = (
/mob/living/bot/farmbot,
/turf/simulated/floor/outdoors/dirt{
	outdoors = 0
	},
/area/submap/farm)
"Hv" = (
/obj/structure/closet/secure_closet/freezer/fridge,
/obj/random/meat,
/obj/random/meat,
/obj/random/meat,
/obj/random/meat,
/obj/random/meat,
/turf/simulated/floor/wood,
/area/submap/farm)
"If" = (
/obj/structure/bookcase,
/obj/item/weapon/book/manual/hydroponics_pod_people,
/turf/simulated/floor/wood,
/area/submap/farm)
"Ip" = (
/obj/structure/closet/crate/hydroponics/prespawned,
/obj/item/stack/cable_coil,
/obj/item/stack/cable_coil,
/turf/simulated/floor/plating,
/area/submap/farm)
"Ir" = (
/turf/simulated/floor/outdoors/mud{
	outdoors = 0
	},
/area/submap/farm)
"Is" = (
/obj/structure/railing{
	dir = 4;
	icon_state = "railing0"
	},
/turf/simulated/floor/outdoors/dirt,
/area/submap/farm)
"Iw" = (
/obj/item/weapon/storage/backpack/messenger,
/obj/item/weapon/reagent_containers/food/drinks/cans/waterbottle,
/obj/item/weapon/reagent_containers/food/drinks/cans/waterbottle,
/obj/item/weapon/material/knife/tacknife/survival,
/obj/item/weapon/reagent_containers/food/snacks/sosjerky,
/obj/item/weapon/cell/device/hyper,
/obj/item/weapon/reagent_containers/hypospray/autoinjector/trauma,
/obj/item/weapon/reagent_containers/hypospray/autoinjector/oxy,
/obj/item/weapon/flame/lighter/random,
/obj/item/weapon/storage/box/survival/space,
/obj/item/device/radio,
/obj/item/clothing/accessory/storage/black_drop_pouches,
/obj/item/weapon/reagent_containers/pill/dylovene,
/obj/item/weapon/reagent_containers/pill/dylovene,
/obj/item/device/flashlight/maglight,
/obj/item/device/flashlight/flare,
/obj/item/device/flashlight/flare,
/obj/random/soap,
/obj/item/weapon/gun/energy/locked/frontier/holdout/unlocked,
/obj/item/device/fbp_backup_cell,
/obj/item/device/pda,
/obj/item/weapon/storage/mre/menu11,
/obj/item/weapon/storage/mre/menu11,
/obj/item/device/starcaster_news,
/obj/effect/floor_decal/spline/fancy/wood{
	dir = 4
	},
/obj/item/device/suit_cooling_unit/emergency,
/obj/item/device/gps,
/obj/structure/closet{
	name = "Survival closet"
	},
/turf/simulated/floor/plating,
/area/submap/farm)
"IS" = (
/obj/structure/table/marble,
/turf/simulated/floor/wood,
/area/submap/farm)
"Ju" = (
/obj/structure/table/marble,
/obj/item/weapon/material/kitchen/rollingpin,
/turf/simulated/floor/wood,
/area/submap/farm)
"JM" = (
/obj/machinery/appliance/cooker/oven,
/turf/simulated/floor/wood,
/area/submap/farm)
"LM" = (
/obj/machinery/power/apc/alarms_hidden{
	dir = 1;
	pixel_y = 20
	},
/turf/simulated/floor/plating,
/area/submap/farm)
"Ny" = (
/turf/simulated/floor/plating,
/area/submap/farm)
"Oe" = (
/turf/simulated/floor/outdoors/grass/sif,
/area/submap/farm)
"On" = (
/obj/structure/table/woodentable,
/obj/item/weapon/storage/box/matches,
/obj/item/weapon/flame/match,
/turf/simulated/floor/wood,
/area/submap/farm)
"Ox" = (
/obj/structure/table/steel,
/turf/simulated/floor/plating,
/area/submap/farm)
"OW" = (
/obj/structure/simple_door/wood,
/turf/simulated/floor/wood,
/area/submap/farm)
"SV" = (
/obj/structure/window/reinforced/full,
/obj/structure/grille/rustic,
/turf/simulated/floor/plating,
/area/submap/farm)
"TA" = (
/obj/structure/table/woodentable,
/turf/simulated/floor/wood,
/area/submap/farm)
"UW" = (
/turf/simulated/floor/outdoors/rocks,
/area/submap/farm)
"VN" = (
/obj/structure/closet/crate,
/obj/fiftyspawner/wood,
/obj/fiftyspawner/wood,
/obj/fiftyspawner/wood/sif,
/obj/fiftyspawner/wood/sif,
/obj/fiftyspawner/turcarpet,
/obj/fiftyspawner/tealcarpet,
/obj/fiftyspawner/sblucarpet,
/obj/fiftyspawner/purcarpet,
/obj/fiftyspawner/oracarpet,
/obj/fiftyspawner/blucarpet,
/obj/fiftyspawner/marble,
/obj/item/weapon/storage/briefcase/inflatable,
/obj/item/weapon/storage/briefcase/inflatable,
/obj/item/weapon/storage/briefcase/inflatable,
/obj/fiftyspawner/cardboard,
/obj/fiftyspawner/cardboard,
/turf/simulated/floor/plating,
/area/submap/farm)
"WM" = (
/obj/machinery/autolathe,
/turf/simulated/floor/plating,
/area/submap/farm)
"Xe" = (
/obj/structure/bonfire/permanent/sifwood,
/obj/item/weapon/reagent_containers/cooking_container/grill,
/turf/simulated/floor/outdoors/grass/sif,
/area/submap/farm)
"Zf" = (
/obj/structure/table/bench/sifwooden,
/turf/simulated/floor/outdoors/grass/sif,
/area/submap/farm)

(1,1,1) = {"
eq
eq
eq
eq
eq
eq
eq
eq
eq
eq
eq
eq
eq
eq
eq
eq
eq
eq
eq
eq
eq
eq
eq
eq
eq
eq
eq
eq
eq
eq
eq
eq
"}
(2,1,1) = {"
eq
eq
dJ
Is
Is
Is
Is
Is
Is
Is
Is
Is
Is
Is
Is
Is
Is
Is
Is
Is
Is
Is
Is
Is
Is
Is
Is
Is
dJ
eq
eq
eq
"}
(3,1,1) = {"
eq
eq
Fe
Oe
Oe
Oe
Oe
Oe
Oe
Oe
Oe
Oe
Oe
Oe
Oe
Oe
Oe
Oe
Oe
Oe
Oe
dJ
Oe
Oe
Oe
Oe
Oe
Oe
ty
eq
eq
eq
"}
(4,1,1) = {"
eq
eq
Fe
Oe
Oe
Oe
Oe
Oe
Oe
Gm
Gm
or
or
Gm
Gm
Gm
Gm
Gm
Oe
dJ
dJ
dJ
dJ
dJ
dJ
Oe
Oe
Oe
ty
eq
eq
eq
"}
(5,1,1) = {"
eq
eq
Fe
Oe
Oe
Gm
Gm
Gm
Gm
Gm
On
TA
db
BR
Gm
If
Eu
Gm
dJ
dJ
UW
UW
UW
dJ
dJ
Oe
dJ
Oe
ty
eq
eq
eq
"}
(6,1,1) = {"
eq
eq
Fe
Oe
Oe
Gm
JM
vN
Hv
Gm
TA
fp
vN
vN
OW
vN
vN
Gm
dJ
UW
UW
hQ
UW
UW
dJ
dJ
Oe
Oe
ty
eq
eq
eq
"}
(7,1,1) = {"
eq
eq
Fe
Oe
Oe
or
ys
vN
vN
OW
vN
vN
vN
vN
Gm
vN
vN
Gm
dJ
UW
hQ
hQ
hQ
UW
UW
dJ
dJ
Oe
ty
eq
eq
eq
"}
(8,1,1) = {"
eq
eq
Fe
Oe
Oe
or
IS
vN
vN
Gm
Ah
vN
vN
Eu
Gm
cz
gq
Gm
dJ
UW
hQ
hQ
hQ
hQ
UW
UW
dJ
Oe
ty
eq
eq
eq
"}
(9,1,1) = {"
eq
eq
Fe
Oe
Oe
Gm
Ju
IS
dx
Gm
Gm
Gm
OW
Gm
Gm
Gm
Gm
Gm
dJ
UW
hQ
hQ
hQ
hQ
hQ
UW
dJ
Oe
ty
eq
eq
eq
"}
(10,1,1) = {"
eq
eq
Fe
Oe
Oe
Gm
Gm
or
Gm
Gm
Gm
Bb
vN
Gm
cs
Oe
Oe
Oe
dJ
UW
hQ
hQ
hQ
hQ
hQ
UW
dJ
Oe
ty
eq
eq
eq
"}
(11,1,1) = {"
eq
eq
Fe
Oe
Oe
Oe
Oe
Oe
Oe
Oe
Gm
vN
vN
Gm
te
Oe
Oe
Oe
dJ
kd
dV
hQ
hQ
hQ
hQ
UW
dJ
Oe
ty
eq
eq
eq
"}
(12,1,1) = {"
eq
eq
Fe
Oe
Oe
dJ
dJ
Oe
dJ
dJ
Gm
Gm
OW
Gm
Ox
dJ
dJ
dJ
dJ
dJ
GQ
dV
hQ
hQ
hQ
UW
dJ
Oe
ty
eq
eq
eq
"}
(13,1,1) = {"
eq
eq
Fe
Oe
Oe
Oe
Oe
dJ
dJ
dJ
dJ
dJ
dJ
dJ
dJ
dJ
dJ
Oe
Zf
dJ
dJ
kd
dV
hQ
UW
UW
dJ
Oe
ty
eq
eq
eq
"}
(14,1,1) = {"
eq
eq
Fe
Oe
Oe
Oe
Oe
Oe
Oe
dJ
dJ
Oe
Oe
Oe
Oe
dJ
dJ
Zf
Xe
Zf
dJ
dJ
GQ
UW
UW
dJ
dJ
Oe
ty
eq
eq
eq
"}
(15,1,1) = {"
eq
eq
Fe
Oe
Oe
SV
SV
SV
ec
pU
SV
SV
SV
SV
Oe
Oe
dJ
dJ
Zf
Oe
dJ
dJ
dJ
dJ
dJ
dJ
dJ
Oe
ty
eq
eq
eq
"}
(16,1,1) = {"
eq
eq
Fe
Oe
Oe
SV
gG
gB
wH
GX
wH
gB
my
SV
Oe
dJ
dJ
Oe
Oe
Oe
Oe
Oe
Oe
Oe
Oe
Oe
dJ
Oe
ty
eq
eq
eq
"}
(17,1,1) = {"
eq
eq
Fe
Oe
Oe
SV
gG
gB
wH
gB
wH
gB
my
SV
Oe
Oe
dJ
Oe
Oe
Gm
Gm
or
or
or
Gm
Gm
Oe
Oe
ty
eq
eq
eq
"}
(18,1,1) = {"
eq
eq
Fe
Oe
Oe
SV
gG
gB
wH
gB
wH
gB
my
SV
Oe
Oe
dJ
dJ
Oe
Gm
FS
eb
Iw
Ip
VN
Gm
dJ
Oe
ty
eq
eq
eq
"}
(19,1,1) = {"
eq
eq
Fe
Oe
Oe
SV
gG
gB
Ir
Ir
Ir
gB
my
SV
Oe
Oe
dJ
dJ
Oe
Gm
LM
Ny
Ny
Ny
Ny
Gm
Oe
Oe
ty
eq
eq
eq
"}
(20,1,1) = {"
eq
eq
Fe
Oe
Oe
SV
gG
gB
Ir
mB
Ir
gB
my
SV
Oe
dJ
dJ
dJ
dJ
Ny
Ny
Ny
Ny
Ny
qW
Gm
Oe
Oe
ty
eq
eq
eq
"}
(21,1,1) = {"
eq
eq
Fe
Oe
Oe
SV
gG
gB
Ir
dM
Ir
gB
my
SV
Oe
dJ
dJ
dJ
dJ
Ny
Ny
Ny
WM
Ny
Ox
Gm
Oe
Oe
ty
eq
eq
eq
"}
(22,1,1) = {"
eq
eq
Fe
Oe
Oe
SV
gG
gB
av
gB
av
gB
my
SV
Oe
dJ
dJ
dJ
dJ
Ny
Ny
Ny
Ny
Ny
Ox
Gm
Oe
Oe
ty
eq
eq
eq
"}
(23,1,1) = {"
eq
eq
Fe
Oe
Oe
SV
gG
gB
av
gB
av
gB
my
SV
Oe
dJ
dJ
dJ
Oe
Gm
Ny
Ny
Ny
Ny
Ny
Gm
Oe
Oe
ty
eq
eq
eq
"}
(24,1,1) = {"
eq
eq
Fe
Oe
Oe
SV
gG
gB
av
gB
av
gB
my
SV
Oe
dJ
dJ
dJ
Oe
Gm
BI
Bz
GK
GK
kb
Gm
Oe
Oe
ty
eq
eq
eq
"}
(25,1,1) = {"
eq
eq
Fe
Oe
Oe
SV
SV
SV
SV
SV
SV
SV
SV
SV
Oe
dJ
dJ
dJ
Oe
Gm
Gm
or
or
or
Gm
Gm
Oe
Oe
ty
eq
eq
eq
"}
(26,1,1) = {"
eq
eq
Fe
Oe
Oe
Oe
Oe
Oe
Oe
Oe
Oe
Oe
Oe
Oe
Oe
dJ
dJ
dJ
Oe
Oe
Oe
Oe
Oe
Oe
Oe
Oe
Oe
Oe
ty
eq
eq
eq
"}
(27,1,1) = {"
eq
eq
dJ
oc
oc
oc
oc
oc
oc
oc
oc
oc
oc
oc
oc
dJ
dJ
dJ
oc
oc
oc
oc
oc
oc
oc
oc
oc
oc
dJ
eq
eq
eq
"}
(28,1,1) = {"
eq
eq
eq
eq
eq
eq
eq
eq
eq
eq
eq
eq
eq
eq
eq
dJ
dJ
dJ
eq
eq
eq
eq
eq
eq
eq
eq
eq
eq
eq
eq
eq
eq
"}
(29,1,1) = {"
eq
eq
eq
eq
eq
eq
eq
eq
eq
eq
eq
eq
eq
eq
eq
dJ
dJ
dJ
eq
eq
eq
eq
eq
eq
eq
eq
eq
eq
eq
eq
eq
eq
"}
(30,1,1) = {"
eq
eq
eq
eq
eq
eq
eq
eq
eq
eq
eq
eq
eq
eq
eq
dJ
dJ
dJ
eq
eq
eq
eq
eq
eq
eq
eq
eq
eq
eq
eq
eq
eq
"}
(31,1,1) = {"
eq
eq
eq
eq
eq
eq
eq
eq
eq
eq
eq
eq
eq
eq
eq
dJ
dJ
dJ
eq
eq
eq
eq
eq
eq
eq
eq
eq
eq
eq
eq
eq
eq
"}
(32,1,1) = {"
eq
eq
eq
eq
eq
eq
eq
eq
eq
eq
eq
eq
eq
eq
eq
eq
eq
eq
eq
eq
eq
eq
eq
eq
eq
eq
eq
eq
eq
eq
eq
eq
"}
