//MAP CONVERTED BY dmm2tgm.py THIS HEADER COMMENT PREVENTS RECONVERSION, DO NOT REMOVE
"aG" = (
/obj/structure/table/standard,
/obj/item/weapon/storage/toolbox,
/obj/random/tool,
/turf/simulated/floor/tiled/steel_dirty,
/area/survivalpod/superpose/FieldLab)
"cq" = (
/obj/machinery/light/small{
	dir = 8
	},
/turf/simulated/floor/tiled/steel_dirty,
/area/survivalpod/superpose/FieldLab)
"eZ" = (
/obj/item/robot_parts/chest,
/obj/item/robot_parts/l_arm,
/obj/item/robot_parts/r_arm,
/turf/simulated/floor/tiled/steel_dirty,
/area/survivalpod/superpose/FieldLab)
"fc" = (
/obj/structure/closet/secure_closet/hydroponics,
/turf/simulated/floor/tiled/steel_dirty,
/area/survivalpod/superpose/FieldLab)
"fl" = (
/turf/template_noop,
/area/survivalpod/superpose/FieldLab)
"gS" = (
/obj/structure/table/standard,
/obj/item/device/multitool,
/obj/item/clothing/glasses/welding,
/turf/simulated/floor/tiled/steel_dirty,
/area/survivalpod/superpose/FieldLab)
"hx" = (
/obj/structure/sink{
	dir = 4;
	icon_state = "sink";
	pixel_x = 11;
	pixel_y = 0
	},
/turf/simulated/floor/tiled/steel_dirty,
/area/survivalpod/superpose/FieldLab)
"hM" = (
/obj/structure/reagent_dispensers/fueltank/high,
/turf/simulated/floor,
/area/survivalpod/superpose/FieldLab)
"ja" = (
/obj/machinery/light{
	dir = 8;
	icon_state = "tube1"
	},
/turf/simulated/floor/tiled/steel_dirty,
/area/survivalpod/superpose/FieldLab)
"ll" = (
/obj/machinery/floodlight,
/turf/simulated/floor,
/area/survivalpod/superpose/FieldLab)
"lI" = (
/obj/machinery/light/small{
	dir = 4
	},
/turf/simulated/floor/tiled/steel_dirty,
/area/survivalpod/superpose/FieldLab)
"mb" = (
/obj/machinery/door/airlock,
/turf/simulated/floor/tiled/steel_dirty,
/area/survivalpod/superpose/FieldLab)
"mm" = (
/obj/structure/grille,
/obj/structure/window/reinforced{
	dir = 1
	},
/obj/structure/window/reinforced,
/obj/machinery/door/firedoor/border_only,
/obj/structure/window/reinforced{
	dir = 8
	},
/turf/simulated/floor/plating,
/area/survivalpod/superpose/FieldLab)
"mo" = (
/obj/machinery/door/airlock/external,
/turf/simulated/floor/tiled/steel_dirty,
/area/survivalpod/superpose/FieldLab)
"mF" = (
/obj/structure/reagent_dispensers/watertank/high,
/turf/simulated/floor,
/area/survivalpod/superpose/FieldLab)
"mV" = (
/obj/structure/grille,
/obj/structure/window/reinforced{
	dir = 1
	},
/obj/structure/window/reinforced,
/obj/structure/window/reinforced{
	dir = 4
	},
/obj/machinery/door/firedoor/border_only,
/turf/simulated/floor/plating,
/area/survivalpod/superpose/FieldLab)
"nn" = (
/obj/machinery/mecha_part_fabricator/pros,
/turf/simulated/floor/tiled/steel_dirty,
/area/survivalpod/superpose/FieldLab)
"ns" = (
/obj/machinery/autolathe,
/obj/item/weapon/rcd/advanced/loaded{
	pixel_x = -5;
	pixel_y = 9
	},
/obj/item/weapon/rcd_ammo/large,
/obj/item/weapon/rcd_ammo/large,
/turf/simulated/floor/plating,
/area/survivalpod/superpose/FieldLab)
"pr" = (
/obj/machinery/light/small{
	dir = 1
	},
/turf/simulated/floor/tiled/steel_dirty,
/area/survivalpod/superpose/FieldLab)
"py" = (
/obj/structure/table/standard,
/obj/machinery/cell_charger,
/turf/simulated/floor/tiled/steel_dirty,
/area/survivalpod/superpose/FieldLab)
"qO" = (
/obj/machinery/light/small,
/turf/simulated/floor/tiled/steel_dirty,
/area/survivalpod/superpose/FieldLab)
"sx" = (
/obj/structure/table/standard,
/obj/item/weapon/paper{
	desc = "Gladstone for the last fucking time, We have crowbars for a REASON. Stop breaking in through the goddamn windows! We big red shiny doors for god's sakes!"
	},
/turf/simulated/floor/tiled/steel_dirty,
/area/survivalpod/superpose/FieldLab)
"tb" = (
/obj/structure/table/standard,
/obj/fiftyspawner/steel,
/obj/fiftyspawner/glass,
/turf/simulated/floor/tiled/steel_dirty,
/area/survivalpod/superpose/FieldLab)
"wi" = (
/obj/machinery/optable,
/turf/simulated/floor/tiled/steel_dirty,
/area/survivalpod/superpose/FieldLab)
"xf" = (
/obj/machinery/power/smes/buildable/point_of_interest,
/turf/simulated/floor/tiled/steel_dirty,
/area/survivalpod/superpose/FieldLab)
"xJ" = (
/obj/machinery/power/apc{
	cell_type = /obj/item/weapon/cell/hyper;
	dir = 8;
	name = "Unknown APC";
	operating = 0;
	pixel_x = -24
	},
/obj/structure/cable{
	d2 = 4;
	icon_state = "0-4"
	},
/turf/simulated/floor/tiled/steel_dirty,
/area/survivalpod/superpose/FieldLab)
"xU" = (
/obj/structure/table/standard,
/obj/random/tool,
/turf/simulated/floor/tiled/steel_dirty,
/area/survivalpod/superpose/FieldLab)
"yX" = (
/obj/structure/table/standard,
/obj/random/toolbox,
/obj/item/weapon/cell/super,
/turf/simulated/floor/tiled/steel_dirty,
/area/survivalpod/superpose/FieldLab)
"zX" = (
/obj/machinery/portable_atmospherics/hydroponics,
/obj/machinery/light{
	dir = 8;
	icon_state = "tube1"
	},
/turf/simulated/floor/tiled/steel_dirty,
/area/survivalpod/superpose/FieldLab)
"AB" = (
/obj/structure/bed,
/obj/item/weapon/bedsheet,
/turf/simulated/floor/tiled/steel_dirty,
/area/survivalpod/superpose/FieldLab)
"AZ" = (
/obj/item/weapon/storage/bag/circuits,
/obj/structure/table/standard,
/turf/simulated/floor/tiled/steel_dirty,
/area/survivalpod/superpose/FieldLab)
"Br" = (
/obj/machinery/vending/hydronutrients,
/turf/simulated/floor/tiled/steel_dirty,
/area/survivalpod/superpose/FieldLab)
"DW" = (
/turf/simulated/wall/r_wall,
/area/survivalpod/superpose/FieldLab)
"Gk" = (
/obj/structure/closet/crate,
/obj/fiftyspawner/plasteel,
/obj/fiftyspawner/plasteel,
/obj/fiftyspawner/phoronrglass,
/obj/fiftyspawner/phoronrglass,
/obj/item/stack/material/lead{
	amount = 50
	},
/obj/item/stack/material/lead{
	amount = 50
	},
/obj/fiftyspawner/gold,
/obj/fiftyspawner/phoron,
/turf/simulated/floor/plating,
/area/survivalpod/superpose/FieldLab)
"Gt" = (
/obj/machinery/space_heater,
/turf/simulated/floor,
/area/survivalpod/superpose/FieldLab)
"HA" = (
/obj/structure/closet/crate/hydroponics,
/turf/simulated/floor/tiled/steel_dirty,
/area/survivalpod/superpose/FieldLab)
"HQ" = (
/turf/simulated/floor/tiled/steel_dirty,
/area/survivalpod/superpose/FieldLab)
"Iq" = (
/turf/simulated/floor,
/area/survivalpod/superpose/FieldLab)
"IO" = (
/obj/machinery/portable_atmospherics/hydroponics,
/turf/simulated/floor/tiled/steel_dirty,
/area/survivalpod/superpose/FieldLab)
"IV" = (
/obj/structure/grille,
/obj/structure/window/reinforced{
	dir = 1
	},
/obj/structure/window/reinforced,
/obj/machinery/door/firedoor/border_only,
/turf/simulated/floor/plating,
/area/survivalpod/superpose/FieldLab)
"Jg" = (
/obj/structure/table/standard,
/obj/item/weapon/storage/toolbox/mechanical,
/turf/simulated/floor/tiled/steel_dirty,
/area/survivalpod/superpose/FieldLab)
"Kk" = (
/obj/item/weapon/storage/backpack/messenger,
/obj/item/weapon/reagent_containers/food/drinks/cans/waterbottle,
/obj/item/weapon/reagent_containers/food/drinks/cans/waterbottle,
/obj/item/weapon/material/knife/tacknife/survival,
/obj/item/weapon/reagent_containers/food/snacks/sosjerky,
/obj/item/weapon/cell/device/hyper,
/obj/item/weapon/reagent_containers/hypospray/autoinjector/trauma,
/obj/item/weapon/reagent_containers/hypospray/autoinjector/oxy,
/obj/item/weapon/flame/lighter/random,
/obj/item/weapon/storage/box/survival/space,
/obj/item/device/radio,
/obj/item/clothing/accessory/storage/black_drop_pouches,
/obj/item/weapon/reagent_containers/pill/dylovene,
/obj/item/weapon/reagent_containers/pill/dylovene,
/obj/item/device/flashlight/maglight,
/obj/item/device/flashlight/flare,
/obj/item/device/flashlight/flare,
/obj/random/soap,
/obj/item/weapon/gun/energy/locked/frontier/holdout/unlocked,
/obj/item/device/fbp_backup_cell,
/obj/item/device/pda,
/obj/item/weapon/storage/mre/menu11,
/obj/item/weapon/storage/mre/menu11,
/obj/item/device/starcaster_news,
/obj/effect/floor_decal/spline/fancy/wood{
	dir = 4
	},
/obj/item/device/suit_cooling_unit/emergency,
/obj/item/device/gps,
/obj/structure/closet{
	name = "Survival closet"
	},
/turf/simulated/floor/plating,
/area/survivalpod/superpose/FieldLab)
"KC" = (
/obj/structure/table/standard,
/obj/item/device/flashlight/lamp,
/turf/simulated/floor/tiled/steel_dirty,
/area/survivalpod/superpose/FieldLab)
"Me" = (
/obj/structure/closet/crate,
/obj/fiftyspawner/wood,
/obj/fiftyspawner/wood,
/obj/fiftyspawner/wood/sif,
/obj/fiftyspawner/wood/sif,
/obj/fiftyspawner/turcarpet,
/obj/fiftyspawner/tealcarpet,
/obj/fiftyspawner/sblucarpet,
/obj/fiftyspawner/purcarpet,
/obj/fiftyspawner/oracarpet,
/obj/fiftyspawner/blucarpet,
/obj/fiftyspawner/marble,
/obj/item/weapon/storage/briefcase/inflatable,
/obj/item/weapon/storage/briefcase/inflatable,
/obj/item/weapon/storage/briefcase/inflatable,
/obj/fiftyspawner/cardboard,
/obj/fiftyspawner/cardboard,
/turf/simulated/floor/plating,
/area/survivalpod/superpose/FieldLab)
"MD" = (
/obj/machinery/vending/tool,
/obj/machinery/light{
	dir = 4;
	icon_state = "tube1"
	},
/turf/simulated/floor/tiled/steel_dirty,
/area/survivalpod/superpose/FieldLab)
"MK" = (
/obj/machinery/power/port_gen/pacman,
/obj/item/stack/material/phoron{
	amount = 25
	},
/turf/simulated/floor/plating,
/area/survivalpod/superpose/FieldLab)
"MT" = (
/obj/structure/table/rack,
/obj/item/clothing/suit/storage/hooded/wintercoat,
/obj/item/clothing/shoes/boots/winter,
/turf/simulated/floor/tiled/steel_dirty,
/area/survivalpod/superpose/FieldLab)
"NN" = (
/obj/machinery/vending/robotics,
/turf/simulated/floor/tiled/steel_dirty,
/area/survivalpod/superpose/FieldLab)
"Oe" = (
/obj/machinery/light{
	dir = 4;
	icon_state = "tube1"
	},
/turf/simulated/floor/tiled/steel_dirty,
/area/survivalpod/superpose/FieldLab)
"Pk" = (
/obj/structure/closet/toolcloset,
/turf/simulated/floor/tiled/steel_dirty,
/area/survivalpod/superpose/FieldLab)
"Qn" = (
/obj/structure/table/rack,
/obj/item/clothing/suit/storage/hooded/wintercoat,
/obj/item/clothing/shoes/boots/winter,
/obj/machinery/light{
	dir = 8;
	icon_state = "tube1"
	},
/turf/simulated/floor/tiled/steel_dirty,
/area/survivalpod/superpose/FieldLab)
"RT" = (
/obj/structure/closet/crate,
/obj/fiftyspawner/glass,
/obj/fiftyspawner/glass,
/obj/fiftyspawner/glass,
/obj/fiftyspawner/glass,
/obj/fiftyspawner/glass,
/obj/fiftyspawner/steel,
/obj/fiftyspawner/steel,
/obj/fiftyspawner/steel,
/obj/fiftyspawner/steel,
/obj/fiftyspawner/steel,
/obj/fiftyspawner/plastic,
/obj/fiftyspawner/plastic,
/obj/fiftyspawner/plastic,
/obj/fiftyspawner/plastic,
/obj/fiftyspawner/plastic,
/turf/simulated/floor,
/area/survivalpod/superpose/FieldLab)
"Ue" = (
/obj/machinery/vending/hydroseeds,
/turf/simulated/floor/tiled/steel_dirty,
/area/survivalpod/superpose/FieldLab)
"Vh" = (
/obj/machinery/portable_atmospherics/canister/oxygen,
/turf/simulated/floor,
/area/survivalpod/superpose/FieldLab)
"Wc" = (
/turf/template_noop,
/area/template_noop)
"Xa" = (
/obj/machinery/power/terminal{
	dir = 4
	},
/obj/structure/cable{
	d2 = 8;
	icon_state = "0-8"
	},
/turf/simulated/floor/tiled/steel_dirty,
/area/survivalpod/superpose/FieldLab)
"Xv" = (
/obj/item/weapon/cell/super,
/turf/simulated/floor/tiled/steel_dirty,
/area/survivalpod/superpose/FieldLab)
"XW" = (
/obj/structure/table/standard,
/obj/item/seeds/ambrosiavulgarisseed,
/turf/simulated/floor/tiled/steel_dirty,
/area/survivalpod/superpose/FieldLab)
"XZ" = (
/obj/machinery/vending/engivend{
	emagged = 1;
	req_access = null;
	req_log_access = null
	},
/turf/simulated/floor/tiled/steel_dirty,
/area/survivalpod/superpose/FieldLab)

(1,1,1) = {"
Wc
Wc
Wc
Wc
Wc
Wc
Wc
Wc
Wc
Wc
Wc
Wc
Wc
Wc
Wc
Wc
Wc
Wc
Wc
Wc
"}
(2,1,1) = {"
Wc
fl
DW
DW
DW
DW
DW
DW
DW
fl
fl
DW
DW
DW
DW
DW
DW
DW
fl
Wc
"}
(3,1,1) = {"
Wc
fl
mm
HQ
aG
xU
yX
xJ
mm
fl
fl
mm
HQ
IO
zX
IO
HA
mm
fl
Wc
"}
(4,1,1) = {"
Wc
fl
IV
HQ
HQ
HQ
HQ
Xa
IV
fl
fl
IV
Br
HQ
HQ
HQ
fc
IV
fl
Wc
"}
(5,1,1) = {"
Wc
fl
mV
HQ
XZ
MD
Pk
xf
mV
fl
fl
mV
Ue
hx
Oe
HQ
XW
mV
fl
Wc
"}
(6,1,1) = {"
Wc
fl
DW
mb
DW
DW
DW
DW
DW
HQ
HQ
DW
DW
DW
DW
mb
DW
DW
fl
Wc
"}
(7,1,1) = {"
Wc
fl
mm
HQ
mm
Vh
Gt
ns
MK
HQ
HQ
Iq
Kk
RT
mm
HQ
mm
fl
fl
Wc
"}
(8,1,1) = {"
Wc
fl
IV
HQ
mV
Vh
Gt
Iq
Iq
HQ
HQ
Iq
Gk
Me
mV
HQ
IV
fl
fl
Wc
"}
(9,1,1) = {"
Wc
fl
IV
qO
DW
DW
DW
DW
DW
HQ
HQ
DW
DW
DW
DW
pr
IV
fl
fl
Wc
"}
(10,1,1) = {"
Wc
fl
IV
HQ
mo
HQ
cq
HQ
mo
HQ
HQ
mo
HQ
HQ
mo
HQ
IV
fl
fl
Wc
"}
(11,1,1) = {"
Wc
fl
IV
HQ
mo
HQ
HQ
HQ
mo
HQ
HQ
mo
lI
HQ
mo
HQ
IV
fl
fl
Wc
"}
(12,1,1) = {"
Wc
fl
IV
qO
DW
DW
DW
DW
DW
HQ
HQ
DW
DW
DW
DW
pr
IV
fl
fl
Wc
"}
(13,1,1) = {"
Wc
fl
IV
HQ
mm
ll
ll
Iq
Iq
HQ
HQ
Iq
Iq
mF
mm
HQ
IV
fl
fl
Wc
"}
(14,1,1) = {"
Wc
fl
mV
HQ
mV
ll
ll
Iq
Iq
HQ
HQ
Iq
Iq
hM
mV
HQ
mV
fl
fl
Wc
"}
(15,1,1) = {"
Wc
fl
DW
mb
DW
DW
DW
DW
DW
HQ
HQ
DW
DW
DW
DW
mb
DW
DW
fl
Wc
"}
(16,1,1) = {"
Wc
fl
mm
HQ
HQ
Qn
AB
sx
mm
fl
fl
mm
Jg
ja
HQ
HQ
NN
mm
fl
Wc
"}
(17,1,1) = {"
Wc
fl
IV
HQ
HQ
HQ
HQ
HQ
IV
fl
fl
IV
tb
Xv
HQ
HQ
py
IV
fl
Wc
"}
(18,1,1) = {"
Wc
fl
mV
HQ
HQ
MT
AB
KC
mV
fl
fl
mV
gS
nn
AZ
eZ
wi
mV
fl
Wc
"}
(19,1,1) = {"
Wc
fl
DW
DW
DW
DW
DW
DW
DW
fl
fl
DW
DW
DW
DW
DW
DW
DW
fl
Wc
"}
(20,1,1) = {"
Wc
Wc
Wc
Wc
Wc
Wc
Wc
Wc
Wc
Wc
Wc
Wc
Wc
Wc
Wc
Wc
Wc
Wc
Wc
Wc
"}
