//MAP CONVERTED BY dmm2tgm.py THIS HEADER COMMENT PREVENTS RECONVERSION, DO NOT REMOVE
"a" = (
/turf/simulated/floor/outdoors/rocks,
/area/survivalpod/superpose/HillOutpost)
"b" = (
/obj/structure/cliff/automatic{
	dir = 2
	},
/obj/structure/railing/grey,
/turf/simulated/floor/outdoors/dirt,
/area/survivalpod/superpose/HillOutpost)
"c" = (
/turf/simulated/floor/outdoors/dirt,
/area/survivalpod/superpose/HillOutpost)
"d" = (
/obj/structure/cliff/automatic{
	dir = 5
	},
/obj/structure/railing/grey{
	dir = 1
	},
/obj/structure/railing/grey{
	dir = 4
	},
/turf/simulated/floor/outdoors/dirt,
/area/survivalpod/superpose/HillOutpost)
"g" = (
/turf/template_noop,
/area/survivalpod/superpose/HillOutpost)
"h" = (
/obj/structure/bonfire/sifwood,
/turf/simulated/floor/outdoors/rocks,
/area/survivalpod/superpose/HillOutpost)
"j" = (
/obj/structure/cliff/automatic{
	dir = 4
	},
/turf/simulated/floor/outdoors/dirt,
/area/survivalpod/superpose/HillOutpost)
"k" = (
/obj/structure/bed/chair{
	dir = 1
	},
/turf/simulated/floor/outdoors/rocks,
/area/survivalpod/superpose/HillOutpost)
"l" = (
/obj/structure/cliff/automatic{
	dir = 2
	},
/turf/simulated/floor/outdoors/dirt,
/area/survivalpod/superpose/HillOutpost)
"m" = (
/obj/structure/bed/chair{
	dir = 4
	},
/turf/simulated/floor/outdoors/rocks,
/area/survivalpod/superpose/HillOutpost)
"o" = (
/obj/structure/ledge/ledge_stairs,
/obj/structure/railing/grey{
	dir = 8
	},
/turf/simulated/floor/outdoors/rocks,
/area/survivalpod/superpose/HillOutpost)
"p" = (
/obj/structure/cliff/automatic/corner,
/turf/simulated/floor/outdoors/dirt,
/area/survivalpod/superpose/HillOutpost)
"q" = (
/obj/structure/railing/grey{
	dir = 4
	},
/obj/structure/cliff/automatic{
	dir = 6
	},
/obj/structure/railing/grey,
/turf/simulated/floor/outdoors/dirt,
/area/survivalpod/superpose/HillOutpost)
"r" = (
/obj/structure/cliff/automatic{
	dir = 8
	},
/obj/structure/railing/grey{
	dir = 8
	},
/turf/simulated/floor/outdoors/dirt,
/area/survivalpod/superpose/HillOutpost)
"s" = (
/turf/simulated/floor/wood/alt/tile/broken,
/area/survivalpod/superpose/HillOutpost)
"t" = (
/obj/structure/railing/grey{
	dir = 8
	},
/obj/machinery/autolathe,
/turf/simulated/floor/wood/alt/tile,
/area/survivalpod/superpose/HillOutpost)
"u" = (
/obj/structure/railing/grey,
/obj/structure/closet/secure_closet/guncabinet{
	locked = 0
	},
/obj/item/gun/projectile/SVD,
/obj/item/ammo_magazine/m762svd,
/obj/item/ammo_magazine/m762svd,
/turf/simulated/floor/wood/alt/tile,
/area/survivalpod/superpose/HillOutpost)
"w" = (
/obj/structure/closet/crate/solar,
/turf/simulated/floor/outdoors/rocks,
/area/survivalpod/superpose/HillOutpost)
"x" = (
/obj/structure/cliff/automatic/corner{
	dir = 10
	},
/turf/simulated/floor/outdoors/dirt,
/area/survivalpod/superpose/HillOutpost)
"y" = (
/obj/structure/cliff/automatic/ramp{
	dir = 9
	},
/obj/structure/railing/grey{
	dir = 8
	},
/turf/simulated/floor/outdoors/dirt,
/area/survivalpod/superpose/HillOutpost)
"z" = (
/obj/machinery/power/apc/alarms_hidden{
	dir = 1;
	pixel_y = 20
	},
/turf/simulated/floor/wood/alt/tile,
/area/survivalpod/superpose/HillOutpost)
"A" = (
/obj/structure/railing/grey{
	dir = 8
	},
/obj/structure/cliff/automatic{
	dir = 8
	},
/turf/simulated/floor/outdoors/dirt,
/area/survivalpod/superpose/HillOutpost)
"B" = (
/obj/machinery/power/port_gen/pacman,
/obj/item/stack/material/phoron{
	amount = 25
	},
/turf/simulated/floor/outdoors/rocks,
/area/survivalpod/superpose/HillOutpost)
"D" = (
/obj/structure/table/sifwooden_reinforced,
/obj/item/binoculars,
/obj/item/bluespaceradio/southerncross_prelinked,
/turf/simulated/floor/outdoors/rocks,
/area/survivalpod/superpose/HillOutpost)
"E" = (
/turf/simulated/floor/wood/alt/tile,
/area/survivalpod/superpose/HillOutpost)
"G" = (
/obj/structure/railing/grey{
	dir = 1
	},
/obj/item/gps/computer,
/turf/simulated/floor/wood/alt/tile,
/area/survivalpod/superpose/HillOutpost)
"J" = (
/obj/structure/bed/chair{
	dir = 8
	},
/turf/simulated/floor/outdoors/rocks,
/area/survivalpod/superpose/HillOutpost)
"K" = (
/turf/simulated/wall/wood,
/area/survivalpod/superpose/HillOutpost)
"L" = (
/obj/structure/cliff/automatic/corner{
	dir = 6
	},
/turf/simulated/floor/outdoors/dirt,
/area/survivalpod/superpose/HillOutpost)
"M" = (
/obj/structure/cliff/automatic,
/obj/structure/railing/grey{
	dir = 1
	},
/turf/simulated/floor/outdoors/dirt,
/area/survivalpod/superpose/HillOutpost)
"N" = (
/obj/structure/railing/grey{
	dir = 8
	},
/turf/simulated/floor/outdoors/dirt,
/area/survivalpod/superpose/HillOutpost)
"O" = (
/obj/structure/bed/chair,
/turf/simulated/floor/outdoors/rocks,
/area/survivalpod/superpose/HillOutpost)
"P" = (
/obj/structure/railing/grey,
/obj/structure/cliff/automatic{
	dir = 2
	},
/turf/simulated/floor/outdoors/dirt,
/area/survivalpod/superpose/HillOutpost)
"Q" = (
/obj/structure/cliff/automatic/corner{
	dir = 9
	},
/turf/simulated/floor/outdoors/dirt,
/area/survivalpod/superpose/HillOutpost)
"R" = (
/obj/structure/cliff/automatic,
/turf/simulated/floor/outdoors/dirt,
/area/survivalpod/superpose/HillOutpost)
"S" = (
/obj/structure/railing/grey{
	dir = 8
	},
/obj/structure/table/sifwooden_reinforced,
/obj/fiftyspawner/steel,
/obj/fiftyspawner/glass,
/turf/simulated/floor/wood/alt/tile/broken,
/area/survivalpod/superpose/HillOutpost)
"U" = (
/obj/machinery/smartfridge/survival_pod,
/obj/item/storage/mre/random,
/obj/item/storage/mre/random,
/obj/item/storage/mre/random,
/obj/item/storage/mre/random,
/obj/item/storage/mre/random,
/obj/item/storage/mre/random,
/obj/item/storage/mre/menu9,
/obj/item/storage/mre/menu9,
/obj/item/storage/mre/menu10,
/obj/item/storage/mre/menu10,
/obj/item/storage/mre/menu11,
/obj/item/storage/mre/menu11,
/obj/item/fbp_backup_cell,
/obj/item/fbp_backup_cell,
/obj/item/fbp_backup_cell,
/obj/item/fbp_backup_cell,
/obj/item/fbp_backup_cell,
/obj/item/storage/pill_bottle/antitox,
/obj/item/storage/box/survival/space,
/obj/item/healthanalyzer,
/obj/item/storage/pill_bottle/dice_nerd,
/obj/machinery/light{
	dir = 1
	},
/obj/item/storage/firstaid/regular,
/obj/item/extinguisher/mini,
/obj/item/extinguisher/mini,
/obj/item/storage/box/survival/space,
/obj/item/storage/box/survival/space,
/obj/item/radio,
/obj/item/radio,
/obj/item/radio,
/obj/item/starcaster_news,
/obj/item/starcaster_news,
/obj/item/threadneedle,
/obj/item/flashlight,
/obj/item/flashlight,
/obj/item/storage/toolbox/emergency,
/obj/item/storage/pill_bottle/spaceacillin,
/obj/random/soap,
/obj/item/material/knife/machete/hatchet,
/obj/item/storage/box/flare,
/obj/item/cell/high,
/obj/item/cell/high,
/obj/item/cell/high,
/obj/item/stock_parts/matter_bin,
/obj/item/stock_parts/capacitor,
/obj/item/stock_parts/capacitor,
/obj/item/stock_parts/capacitor,
/obj/item/circuitboard/batteryrack,
/turf/simulated/floor/wood/alt/tile/broken,
/area/survivalpod/superpose/HillOutpost)
"W" = (
/obj/structure/railing/grey{
	dir = 1
	},
/obj/structure/cliff/automatic,
/turf/simulated/floor/outdoors/dirt,
/area/survivalpod/superpose/HillOutpost)
"X" = (
/obj/structure/cliff/automatic{
	dir = 4
	},
/obj/structure/railing/grey{
	dir = 4
	},
/turf/simulated/floor/outdoors/dirt,
/area/survivalpod/superpose/HillOutpost)
"Y" = (
/obj/structure/railing/grey,
/obj/structure/railing/grey{
	dir = 8
	},
/obj/structure/cliff/automatic{
	dir = 10
	},
/turf/simulated/floor/outdoors/dirt,
/area/survivalpod/superpose/HillOutpost)

(1,1,1) = {"
g
c
c
c
c
c
g
g
g
g
g
"}
(2,1,1) = {"
c
L
j
j
j
j
p
c
g
g
g
"}
(3,1,1) = {"
c
l
K
S
t
K
R
c
g
g
g
"}
(4,1,1) = {"
c
l
G
E
E
u
R
c
g
g
g
"}
(5,1,1) = {"
L
q
K
z
s
K
M
c
c
g
g
"}
(6,1,1) = {"
P
D
s
E
E
U
W
c
c
c
g
"}
(7,1,1) = {"
P
k
a
a
a
w
W
c
c
c
c
"}
(8,1,1) = {"
P
a
a
a
a
B
M
c
c
c
c
"}
(9,1,1) = {"
x
Y
a
a
a
a
d
X
X
p
c
"}
(10,1,1) = {"
c
P
a
a
m
a
a
a
a
M
c
"}
(11,1,1) = {"
c
b
a
O
h
J
a
a
a
M
c
"}
(12,1,1) = {"
c
b
a
a
J
a
a
a
a
M
c
"}
(13,1,1) = {"
c
b
a
a
a
a
a
a
a
M
g
"}
(14,1,1) = {"
g
x
r
A
N
o
o
o
a
W
g
"}
(15,1,1) = {"
g
g
g
g
c
y
A
A
A
Q
g
"}
