"ak" = (/obj/structure/window/reinforced/survival_pod{dir = 1},/obj/structure/window/reinforced/survival_pod{dir = 8},/turf/simulated/floor/tiled/techfloor,/area/space)
"av" = (/obj/structure/salvageable/computer,/turf/simulated/floor/tiled/asteroid_steel,/area/space)
"ax" = (/obj/structure/table/rack/shelf/steel,/obj/item/mecha_parts/mecha_equipment/cloak,/obj/item/mecha_parts/mecha_equipment/tool/jetpack,/obj/item/mecha_parts/mecha_equipment/tool/passenger,/turf/simulated/floor/plating/external,/area/space)
"aI" = (/obj/machinery/portable_atmospherics/canister/air,/turf/simulated/floor/plating/external,/area/space)
"ba" = (/obj/machinery/power/port_gen/pacman,/obj/structure/cable,/turf/simulated/floor/plating/external,/area/space)
"bE" = (/turf/simulated/floor/tiled/techfloor/grid,/area/space)
"bQ" = (/obj/random/maintenance,/turf/simulated/floor/tiled/asteroid_steel,/area/space)
"ca" = (/obj/structure/table/rack/shelf/steel,/obj/item/mecha_parts/mecha_equipment/anticcw_armor_booster,/obj/item/mecha_parts/mecha_equipment/repair_droid,/obj/item/mecha_parts/mecha_equipment/tool/passenger,/obj/item/mecha_parts/mecha_equipment/weapon/ballistic/missile_rack/grenade/clusterbang,/turf/simulated/floor/plating/external,/area/space)
"cS" = (/obj/structure/window/reinforced/survival_pod,/obj/machinery/field_generator{anchored = 1; state = 1},/turf/simulated/floor/tiled/techfloor,/area/space)
"df" = (/obj/machinery/atmospherics/pipe/simple/hidden{dir = 4},/turf/simulated/floor/tiled/steel_dirty,/area/space)
"dt" = (/obj/structure/bed/double/padded,/turf/simulated/floor/wood/sif/broken,/area/space)
"dA" = (/obj/machinery/icecream_vat,/turf/simulated/floor/tiled/asteroid_steel,/area/space)
"dG" = (/turf/template_noop,/area/space)
"dH" = (/obj/random/maintenance,/obj/random/maintenance/engineering,/turf/simulated/floor/tiled/steel_dirty,/area/space)
"ea" = (/obj/structure/table/reinforced,/turf/simulated/floor/tiled/steel_dirty,/area/space)
"ez" = (/obj/structure/curtain/black{icon_state = "open"; layer = 2; name = "privacy curtain"; opacity = 0},/turf/simulated/floor/wood/sif,/area/space)
"fq" = (/obj/structure/window/reinforced/survival_pod,/obj/structure/window/reinforced/survival_pod{dir = 8},/turf/simulated/floor/tiled/techfloor,/area/space)
"gG" = (/obj/machinery/fusion_fuel_compressor,/turf/simulated/floor/tiled/asteroid_steel,/area/space)
"gT" = (/obj/machinery/atmospherics/pipe/simple/hidden{dir = 6},/turf/simulated/floor/plating/external,/area/space)
"ho" = (/obj/structure/reagent_dispensers/fueltank/high,/turf/simulated/floor/plating/external,/area/space)
"hr" = (/obj/structure/table/reinforced,/turf/simulated/floor/tiled/asteroid_steel,/area/space)
"hK" = (/obj/structure/reagent_dispensers/watertank/high,/turf/simulated/floor/plating/external,/area/space)
"ij" = (/obj/structure/cable/green{d2 = 4; icon_state = "0-4"},/obj/machinery/power/apc/alarms_hidden{dir = 8; pixel_x = -24},/turf/simulated/floor/plating/external,/area/space)
"in" = (/obj/machinery/atmospherics/pipe/simple/hidden{dir = 4},/obj/machinery/door/airlock/maintenance/common,/turf/simulated/floor/plating/external,/area/space)
"iH" = (/obj/machinery/atmospherics/pipe/simple/hidden{dir = 4},/obj/machinery/alarm/alarms_hidden{dir = 1; pixel_y = -22},/turf/simulated/floor/plating/external,/area/space)
"jq" = (/obj/mecha/working/hoverpod/shuttlecraft{dir = 8},/turf/template_noop,/area/space)
"ju" = (/obj/structure/salvageable/bliss,/turf/simulated/floor/tiled/asteroid_steel,/area/space)
"kd" = (/obj/machinery/atmospherics/unary/vent_pump/on,/turf/simulated/floor/tiled/techfloor/grid,/area/space)
"lc" = (/obj/random/maintenance/engineering,/obj/structure/bed/chair{dir = 8},/turf/simulated/floor/tiled/asteroid_steel,/area/space)
"lk" = (/obj/structure/table/rack/shelf/steel,/obj/item/mecha_parts/component/hull/lightweight,/obj/item/mecha_parts/mecha_equipment/weapon/ballistic/scattershot,/obj/item/mecha_parts/mecha_equipment/weapon/phoron_bore,/obj/item/mecha_parts/mecha_equipment/weapon/energy/taser/rigged,/turf/simulated/floor/plating/external,/area/space)
"ly" = (/obj/machinery/atmospherics/pipe/simple/hidden,/turf/simulated/floor/tiled/steel_dirty,/area/space)
"lA" = (/obj/random/maintenance/engineering,/turf/simulated/floor/plating/external,/area/space)
"lX" = (/obj/structure/window/reinforced/survival_pod,/obj/structure/window/reinforced/survival_pod{dir = 4},/obj/machinery/ion_engine,/turf/simulated/floor/tiled/techfloor/grid,/area/space)
"mB" = (/obj/structure/table/steel_reinforced,/obj/item/weapon/storage/briefcase/inflatable{pixel_y = 3},/obj/item/weapon/storage/toolbox/syndicate/powertools,/turf/simulated/floor/tiled/asteroid_steel,/area/space)
"nc" = (/obj/structure/bed/double/padded,/obj/item/weapon/bedsheet/rainbowdouble,/obj/machinery/partyalarm{pixel_y = -18},/turf/simulated/floor/wood/sif,/area/space)
"nh" = (/obj/structure/table/rack/shelf/steel,/obj/item/mecha_parts/component/armor/alien,/obj/item/mecha_parts/mecha_equipment/crisis_drone/rad,/obj/item/mecha_parts/mecha_equipment/tool/passenger,/obj/item/mecha_parts/mecha_equipment/weapon/ballistic/lmg/rigged,/obj/item/mecha_parts/mecha_equipment/weapon/energy/laser/heavy/rigged,/obj/item/mecha_parts/mecha_equipment/weapon/energy/medigun,/turf/simulated/floor/plating/external,/area/space)
"ns" = (/obj/machinery/vending/tool{emagged = 1},/turf/simulated/floor/tiled/steel_dirty,/area/space)
"nz" = (/obj/machinery/atmospherics/unary/vent_pump/on,/turf/simulated/floor/tiled/steel_dirty,/area/space)
"nH" = (/obj/machinery/atmospherics/pipe/manifold/hidden,/obj/random/junk,/turf/simulated/floor/plating/external,/area/space)
"nJ" = (/obj/machinery/atmospherics/unary/vent_pump/on,/obj/machinery/alarm/alarms_hidden{dir = 4; pixel_x = -22},/turf/simulated/floor/tiled/asteroid_steel,/area/space)
"nZ" = (/obj/machinery/atmospherics/pipe/manifold/hidden,/turf/simulated/floor/tiled/asteroid_steel,/area/space)
"oh" = (/obj/machinery/door/airlock/maintenance/int,/obj/structure/fans/hardlight,/turf/simulated/floor/plating/external,/area/space)
"oW" = (/obj/machinery/sleeper{dir = 4},/turf/simulated/floor/tiled/asteroid_steel,/area/space)
"pw" = (/obj/random/junk,/turf/simulated/floor/tiled/asteroid_steel,/area/space)
"pA" = (/turf/simulated/floor/tiled/asteroid_steel,/area/space)
"qa" = (/obj/machinery/mech_recharger,/obj/effect/floor_decal/industrial/outline/yellow,/obj/structure/loot_pile/mecha/marauder/mauler,/turf/simulated/floor/tiled/techmaint,/area/space)
"qb" = (/obj/machinery/atmospherics/unary/vent_pump/on{dir = 1},/turf/simulated/floor/tiled/techfloor/grid,/area/space)
"qf" = (/obj/machinery/atmospherics/unary/vent_pump/on,/turf/simulated/floor/tiled/asteroid_steel,/area/space)
"qp" = (/obj/structure/curtain/black{icon_state = "open"; layer = 2; name = "privacy curtain"; opacity = 0},/turf/simulated/floor/wood/sif/broken,/area/space)
"qy" = (/obj/structure/cable/green{d1 = 1; d2 = 4; icon_state = "1-4"},/turf/simulated/floor/plating/external,/area/space)
"qE" = (/obj/machinery/autolathe{hacked = 1; name = "hacked autolathe"},/turf/simulated/floor/tiled/asteroid_steel,/area/space)
"qY" = (/obj/machinery/atmospherics/pipe/simple/hidden{dir = 4},/turf/simulated/floor/plating/external,/area/space)
"rj" = (/obj/machinery/atmospherics/unary/vent_pump/on{dir = 1},/obj/machinery/alarm/alarms_hidden{dir = 4; pixel_x = -22},/turf/simulated/floor/tiled/asteroid_steel,/area/space)
"rl" = (/obj/structure/cable/green{d1 = 1; d2 = 2; icon_state = "1-2"},/turf/simulated/floor/plating/external,/area/space)
"rp" = (/obj/random/maintenance,/turf/simulated/floor/tiled/steel_dirty,/area/space)
"rM" = (/obj/machinery/door/airlock/maintenance/common,/turf/simulated/floor/plating/external,/area/space)
"sd" = (/obj/machinery/atmospherics/pipe/simple/hidden{dir = 9},/turf/simulated/floor/tiled/asteroid_steel,/area/space)
"sk" = (/obj/random/junk,/turf/simulated/floor/plating/external,/area/space)
"sK" = (/obj/vehicle/boat{dir = 8},/obj/structure/lattice,/turf/template_noop,/area/space)
"tl" = (/obj/machinery/floorlayer,/turf/simulated/floor/tiled/asteroid_steel,/area/space)
"to" = (/obj/machinery/atmospherics/pipe/simple/hidden{dir = 9},/obj/machinery/gear_dispenser/suit_old,/turf/simulated/floor/plating/external,/area/space)
"tw" = (/turf/simulated/floor/plating/external,/area/space)
"tH" = (/obj/machinery/atmospherics/pipe/manifold/hidden{dir = 8},/turf/simulated/floor/tiled/steel_dirty,/area/space)
"tK" = (/obj/effect/wingrille_spawn/reinforced,/obj/structure/fans/hardlight,/turf/simulated/floor/plating/external,/area/space)
"tO" = (/obj/structure/table/rack/shelf/steel,/obj/item/mecha_parts/mecha_equipment/generator/nuclear,/obj/item/mecha_parts/mecha_equipment/weapon/ballistic/missile_rack/explosive/rigged,/obj/item/mecha_parts/mecha_equipment/weapon/energy/ion/rigged,/turf/simulated/floor/plating/external,/area/space)
"tV" = (/obj/structure/table/rack/shelf/steel,/obj/item/mecha_parts/component/gas/reinforced,/obj/item/mecha_parts/mecha_equipment/hardpoint_actuator,/obj/item/mecha_parts/mecha_equipment/tesla_energy_relay,/obj/item/mecha_parts/mecha_equipment/weapon/ballistic/cannon,/obj/item/mecha_parts/mecha_equipment/weapon/ballistic/missile_rack/grenade/rigged,/obj/item/mecha_parts/mecha_equipment/wormhole_generator,/turf/simulated/floor/plating/external,/area/space)
"tW" = (/obj/structure/closet/walllocker_double/kitchen/north{dir = 8; name = "Ration Cabinet"; pixel_x = -32; pixel_y = 0},/obj/item/weapon/storage/mre/random,/obj/item/weapon/storage/mre/random,/obj/item/weapon/storage/mre/random,/obj/item/weapon/storage/mre/random,/obj/item/weapon/storage/mre/random,/obj/item/device/radio{pixel_x = -5; pixel_y = 5},/obj/item/device/radio{pixel_x = 5; pixel_y = 5},/turf/simulated/floor/plating/external,/area/space)
"us" = (/obj/machinery/artifact_scanpad,/obj/effect/simple_portal/linked,/obj/effect/map_effect/interval/effect_emitter/sparks,/turf/simulated/floor/tiled/techfloor,/area/space)
"uJ" = (/obj/effect/floor_decal/industrial/outline/blue,/obj/structure/closet/jcloset,/obj/item/weapon/mop,/obj/structure/mopbucket,/obj/item/weapon/reagent_containers/glass/bucket,/obj/item/weapon/reagent_containers/spray/cleaner,/obj/item/weapon/reagent_containers/spray/cleaner,/turf/simulated/floor/tiled/steel_dirty,/area/space)
"vG" = (/obj/machinery/mech_recharger,/obj/effect/floor_decal/industrial/outline/yellow,/obj/structure/loot_pile/mecha/odysseus/murdysseus,/turf/simulated/floor/tiled/techmaint,/area/space)
"wg" = (/obj/random/junk,/obj/random/maintenance,/turf/simulated/floor/tiled/asteroid_steel,/area/space)
"wU" = (/obj/structure/salvageable/server,/turf/simulated/floor/plating/external,/area/space)
"yc" = (/obj/machinery/feeder,/turf/simulated/floor/tiled/asteroid_steel,/area/space)
"yF" = (/obj/structure/lattice,/turf/template_noop,/area/space)
"yH" = (/obj/machinery/door/airlock/maintenance/engi{req_one_access = null},/turf/simulated/floor/plating/external,/area/space)
"zb" = (/obj/structure/salvageable/autolathe,/turf/simulated/floor/tiled/asteroid_steel,/area/space)
"Ah" = (/obj/structure/window/reinforced/survival_pod{dir = 1},/obj/structure/window/reinforced/survival_pod{dir = 4},/obj/structure/cryofeed{dir = 1},/turf/simulated/floor/tiled/techfloor/grid,/area/space)
"Ao" = (/turf/simulated/wall/skipjack,/area/space)
"Ar" = (/obj/structure/cable{d1 = 2; d2 = 8; icon_state = "2-8"},/turf/simulated/floor/plating/external,/area/space)
"Au" = (/obj/machinery/mech_recharger,/obj/effect/floor_decal/industrial/outline/yellow,/obj/structure/loot_pile/mecha/gygax/dark/adv,/turf/simulated/floor/tiled/techmaint,/area/space)
"AD" = (/obj/effect/wingrille_spawn/reinforced,/turf/simulated/floor/plating/external,/area/space)
"BC" = (/obj/machinery/portable_atmospherics/canister/air,/obj/machinery/atmospherics/portables_connector,/turf/simulated/floor/plating/external,/area/space)
"CN" = (/obj/structure/cryofeed{dir = 1},/obj/structure/window/reinforced/survival_pod{dir = 1},/obj/structure/window/reinforced/survival_pod{dir = 4},/turf/simulated/floor/tiled/techfloor/grid,/area/space)
"Df" = (/obj/machinery/alarm/alarms_hidden{dir = 4; pixel_x = -22},/obj/item/pizzavoucher,/turf/simulated/floor/tiled/asteroid_steel,/area/space)
"Dr" = (/obj/machinery/atmospherics/pipe/simple/hidden{dir = 4},/obj/machinery/alarm/alarms_hidden{pixel_y = 22},/obj/random/maintenance,/turf/simulated/floor/tiled/asteroid_steel,/area/space)
"EE" = (/obj/machinery/mech_recharger,/obj/effect/floor_decal/industrial/outline/yellow,/obj/mecha/combat/gygax/old,/turf/simulated/floor/tiled/techmaint,/area/space)
"EY" = (/obj/machinery/mech_recharger,/obj/effect/floor_decal/industrial/outline/yellow,/obj/mecha/combat/durand/old,/turf/simulated/floor/tiled/techmaint,/area/space)
"Ga" = (/obj/machinery/atmospherics/pipe/simple/hidden{dir = 5},/obj/random/maintenance/engineering,/turf/simulated/floor/plating/external,/area/space)
"Go" = (/obj/machinery/power/smes/buildable/hybrid,/obj/structure/cable/green{d2 = 8; icon_state = "0-8"},/turf/simulated/floor/plating/external,/area/space)
"GI" = (/obj/structure/table/rack/shelf/steel,/obj/item/mecha_parts/mecha_equipment/combat_shield,/obj/item/mecha_parts/mecha_equipment/repair_droid,/obj/item/mecha_parts/mecha_equipment/tool/sleeper,/obj/item/mecha_parts/mecha_equipment/weapon/ballistic/mortar,/obj/item/mecha_parts/mecha_equipment/weapon/energy/flamer/rigged,/turf/simulated/floor/plating/external,/area/space)
"GX" = (/obj/machinery/atmospherics/unary/vent_pump/on{dir = 4},/obj/random/maintenance,/turf/simulated/floor/tiled/steel_dirty,/area/space)
"HE" = (/obj/item/weapon/storage/backpack/messenger,/obj/item/weapon/reagent_containers/food/drinks/cans/waterbottle,/obj/item/weapon/reagent_containers/food/drinks/cans/waterbottle,/obj/item/weapon/material/knife/tacknife/survival,/obj/item/weapon/reagent_containers/food/snacks/sosjerky,/obj/item/weapon/cell/device/hyper,/obj/item/weapon/reagent_containers/hypospray/autoinjector/trauma,/obj/item/weapon/reagent_containers/hypospray/autoinjector/oxy,/obj/item/weapon/flame/lighter/random,/obj/item/weapon/storage/box/survival/space,/obj/item/device/radio,/obj/item/clothing/accessory/storage/black_drop_pouches,/obj/item/weapon/reagent_containers/pill/dylovene,/obj/item/weapon/reagent_containers/pill/dylovene,/obj/item/device/flashlight/maglight,/obj/item/device/flashlight/flare,/obj/item/device/flashlight/flare,/obj/random/soap,/obj/item/weapon/gun/energy/locked/frontier/holdout/unlocked,/obj/item/device/fbp_backup_cell,/obj/item/device/pda,/obj/item/weapon/storage/mre/menu11,/obj/item/weapon/storage/mre/menu11,/obj/item/device/starcaster_news,/obj/effect/floor_decal/spline/fancy/wood{dir = 4},/obj/item/device/suit_cooling_unit/emergency,/obj/item/device/gps,/obj/structure/closet{name = "Survival closet"},/turf/simulated/shuttle/floor{icon_state = "floor_yellow"},/area/space)
"Ib" = (/obj/machinery/atmospherics/pipe/manifold/hidden{dir = 4},/turf/simulated/floor/plating/external,/area/space)
"IE" = (/obj/machinery/mech_recharger,/obj/effect/floor_decal/industrial/outline/yellow,/obj/mecha/combat/marauder/seraph,/turf/simulated/floor/tiled/techmaint,/area/space)
"IN" = (/obj/item/weapon/bedsheet/piratedouble,/obj/structure/curtain/black{icon_state = "open"; layer = 2; name = "privacy curtain"; opacity = 0},/turf/simulated/floor/wood/sif,/area/space)
"IS" = (/obj/machinery/atmospherics/pipe/simple/hidden,/turf/simulated/floor/plating/external,/area/space)
"IX" = (/obj/machinery/power/terminal,/obj/structure/cable{d2 = 4; icon_state = "0-4"},/turf/simulated/floor/plating/external,/area/space)
"Jh" = (/obj/structure/closet/secure_closet/engineering_electrical{req_access = null},/obj/random/maintenance,/obj/random/maintenance,/turf/simulated/floor/plating/external,/area/space)
"Jo" = (/obj/machinery/atmospherics/valve{dir = 8},/obj/structure/dispenser{phorontanks = 0},/turf/simulated/floor/plating/external,/area/space)
"JE" = (/obj/machinery/atmospherics/binary/passive_gate{dir = 8; regulate_mode = 0; unlocked = 1},/turf/simulated/floor/plating/external,/area/space)
"JR" = (/obj/mecha/working/hoverpod/combatpod{dir = 8},/turf/template_noop,/area/space)
"JT" = (/obj/machinery/mech_recharger,/obj/effect/floor_decal/industrial/outline/yellow,/obj/structure/loot_pile/mecha/durand,/turf/simulated/floor/tiled/techmaint,/area/space)
"JV" = (/obj/structure/closet/crate/large,/obj/fiftyspawner/steel,/obj/item/stack/material/plasteel{amount = 30},/obj/item/stack/material/phoron{amount = 25},/obj/item/stack/material/glass/phoronrglass{amount = 20},/obj/fiftyspawner/steel,/turf/simulated/floor/tiled/asteroid_steel,/area/space)
"Ke" = (/obj/machinery/robotic_fabricator,/turf/simulated/floor/tiled/asteroid_steel,/area/space)
"Kt" = (/obj/machinery/alarm/alarms_hidden{dir = 8; pixel_x = 22},/obj/machinery/holoplant,/turf/simulated/floor/tiled/asteroid_steel,/area/space)
"KE" = (/obj/machinery/atmospherics/pipe/simple/hidden{dir = 9},/obj/random/maintenance,/turf/simulated/floor/tiled/asteroid_steel,/area/space)
"KN" = (/obj/machinery/sleep_console{dir = 4},/turf/simulated/floor/tiled/asteroid_steel,/area/space)
"Lh" = (/obj/structure/closet/crate,/obj/fiftyspawner/glass,/obj/fiftyspawner/glass,/obj/fiftyspawner/glass,/obj/fiftyspawner/glass,/obj/fiftyspawner/glass,/obj/fiftyspawner/steel,/obj/fiftyspawner/steel,/obj/fiftyspawner/steel,/obj/fiftyspawner/steel,/obj/fiftyspawner/steel,/obj/fiftyspawner/plastic,/obj/fiftyspawner/plastic,/obj/fiftyspawner/plastic,/obj/fiftyspawner/plastic,/obj/fiftyspawner/plastic,/turf/simulated/floor/plating,/area/space)
"Lp" = (/obj/structure/table/reinforced,/obj/machinery/cell_charger,/turf/simulated/floor/tiled/asteroid_steel,/area/space)
"Ls" = (/obj/random/maintenance/engineering,/turf/simulated/floor/tiled/asteroid_steel,/area/space)
"Ma" = (/obj/structure/closet/walllocker_double/kitchen/north{dir = 8; name = "Ration Cabinet"; pixel_x = -32; pixel_y = 0},/obj/item/weapon/storage/mre/random,/obj/item/weapon/storage/mre/random,/obj/item/weapon/storage/mre/random,/obj/item/weapon/storage/mre/random,/obj/item/weapon/storage/mre/random,/obj/item/device/radio{pixel_x = -5; pixel_y = 5},/obj/item/device/radio{pixel_x = 5; pixel_y = 5},/obj/machinery/atmospherics/pipe/simple/hidden,/turf/simulated/floor/tiled/steel_dirty,/area/space)
"Ml" = (/obj/structure/table/rack/shelf/steel,/obj/item/mecha_parts/component/armor/military,/obj/item/mecha_parts/component/gas/reinforced,/obj/item/mecha_parts/mecha_equipment/omni_shield,/obj/item/mecha_parts/mecha_equipment/tool/jetpack,/obj/item/mecha_parts/mecha_equipment/tool/passenger,/obj/item/mecha_parts/mecha_equipment/weapon/ballistic/cannon,/turf/simulated/floor/plating/external,/area/space)
"Mx" = (/obj/structure/closet/walllocker_double/kitchen/north{dir = 8; name = "Ration Cabinet"; pixel_x = -32; pixel_y = 0},/obj/item/weapon/storage/mre/random,/obj/item/weapon/storage/mre/random,/obj/item/weapon/storage/mre/random,/obj/item/weapon/storage/mre/random,/obj/item/weapon/storage/mre/random,/obj/item/device/radio{pixel_x = -5; pixel_y = 5},/obj/item/device/radio{pixel_x = 5; pixel_y = 5},/turf/simulated/floor/tiled/steel_dirty,/area/space)
"MA" = (/obj/machinery/atmospherics/pipe/manifold/hidden{dir = 1},/obj/random/junk,/turf/simulated/floor/tiled/steel_dirty,/area/space)
"MB" = (/obj/structure/closet/crate,/obj/fiftyspawner/wood,/obj/fiftyspawner/wood,/obj/fiftyspawner/wood/sif,/obj/fiftyspawner/wood/sif,/obj/fiftyspawner/turcarpet,/obj/fiftyspawner/tealcarpet,/obj/fiftyspawner/sblucarpet,/obj/fiftyspawner/purcarpet,/obj/fiftyspawner/oracarpet,/obj/fiftyspawner/blucarpet,/obj/fiftyspawner/marble,/obj/item/weapon/storage/briefcase/inflatable,/obj/item/weapon/storage/briefcase/inflatable,/obj/item/weapon/storage/briefcase/inflatable,/obj/fiftyspawner/cardboard,/obj/fiftyspawner/cardboard,/obj/structure/cable/green{d1 = 2; d2 = 8; icon_state = "2-8"},/turf/simulated/floor/plating,/area/space)
"NH" = (/obj/mecha/combat/fighter/gunpod{dir = 8},/turf/template_noop,/area/space)
"Oc" = (/obj/structure/window/reinforced/survival_pod{dir = 4},/obj/machinery/atmospherics/binary/circulator{anchored = 1},/turf/simulated/floor/tiled/techfloor/grid,/area/space)
"Of" = (/obj/structure/salvageable/console_os{dir = 4},/turf/simulated/floor/tiled/asteroid_steel,/area/space)
"Os" = (/obj/machinery/vending/engivend{emagged = 1},/turf/simulated/floor/tiled/asteroid_steel,/area/space)
"OF" = (/obj/mecha/combat/fighter/gunpod/recon{dir = 8},/turf/template_noop,/area/space)
"Pt" = (/obj/machinery/atmospherics/pipe/simple/hidden,/turf/simulated/floor/tiled/asteroid_steel,/area/space)
"Qo" = (/obj/machinery/atmospherics/pipe/simple/hidden{dir = 4},/turf/simulated/floor/tiled/asteroid_steel,/area/space)
"RS" = (/obj/machinery/atmospherics/pipe/simple/hidden{dir = 6},/obj/item/weapon/tank/emergency/oxygen/double,/obj/item/weapon/tank/emergency/oxygen/double,/obj/item/weapon/tank/emergency/oxygen/double,/obj/item/weapon/tank/emergency/oxygen/double,/obj/item/weapon/tank/emergency/oxygen/double{pixel_y = 6},/obj/item/weapon/tank/emergency/oxygen/double{pixel_y = 6},/obj/item/weapon/tank/emergency/oxygen/double{pixel_y = 6},/obj/item/weapon/tank/emergency/oxygen/double{pixel_y = 6},/obj/item/weapon/tank/emergency/oxygen/double{pixel_y = 6},/obj/structure/table/rack/shelf/steel,/turf/simulated/floor/tiled/steel_dirty,/area/space)
"Sw" = (/obj/machinery/door/window/survival_pod{dir = 8},/turf/simulated/floor/tiled/techfloor,/area/space)
"Sz" = (/obj/vehicle/boat/dragon/sifwood{dir = 8},/obj/structure/lattice,/turf/template_noop,/area/space)
"SM" = (/obj/structure/table/reinforced,/obj/machinery/alarm/alarms_hidden{pixel_y = 22},/obj/machinery/cell_charger,/turf/simulated/floor/tiled/steel_dirty,/area/space)
"TK" = (/turf/simulated/floor/tiled/steel_dirty,/area/space)
"Ut" = (/obj/structure/closet/secure_closet/engineering_welding{req_access = null},/obj/random/maintenance,/turf/simulated/floor/tiled/steel_dirty,/area/space)
"Vb" = (/obj/machinery/atmospherics/pipe/tank/air,/turf/simulated/floor/plating/external,/area/space)
"Vu" = (/obj/machinery/power/shield_generator/charged,/turf/simulated/floor/tiled/asteroid_steel,/area/space)
"Vx" = (/obj/structure/table/steel_reinforced,/obj/item/weapon/storage/briefcase/inflatable{pixel_y = 3},/obj/item/weapon/storage/toolbox/electrical,/turf/simulated/floor/tiled/asteroid_steel,/area/space)
"VT" = (/obj/machinery/atmospherics/unary/vent_pump/on{dir = 1},/turf/simulated/floor/tiled/asteroid_steel,/area/space)
"We" = (/obj/random/maintenance/engineering,/turf/simulated/floor/tiled/techfloor/grid,/area/space)
"Wo" = (/obj/machinery/atmospherics/pipe/simple/hidden{dir = 10},/turf/simulated/floor/tiled/asteroid_steel,/area/space)
"Xr" = (/obj/mecha/combat/fighter/gunpod/loaded{dir = 8},/turf/template_noop,/area/space)
"XH" = (/obj/machinery/atmospherics/pipe/simple/hidden{dir = 4},/obj/machinery/door/airlock/maintenance/rnd{req_one_access = null},/turf/simulated/floor/plating/external,/area/space)
"XX" = (/obj/machinery/atmospherics/pipe/simple/hidden,/obj/machinery/door/airlock/maintenance/engi{req_one_access = null},/turf/simulated/floor/plating/external,/area/space)
"Yd" = (/obj/machinery/portable_atmospherics/canister/phoron,/turf/simulated/floor/plating/external,/area/space)
"Yl" = (/obj/machinery/mech_recharger,/obj/effect/floor_decal/industrial/outline/yellow,/obj/structure/loot_pile/mecha/phazon,/turf/simulated/floor/tiled/techmaint,/area/space)
"YB" = (/obj/machinery/atmospherics/pipe/simple/hidden{dir = 5},/obj/structure/table/steel_reinforced,/obj/item/weapon/storage/briefcase/inflatable{pixel_y = 3},/obj/item/weapon/storage/toolbox/mechanical,/obj/item/pizzavoucher,/turf/simulated/floor/tiled/steel_dirty,/area/space)
"YI" = (/obj/structure/salvageable/console_os{dir = 4},/turf/simulated/floor/tiled/steel_dirty,/area/space)
"Zj" = (/obj/structure/window/reinforced/survival_pod{dir = 1},/obj/machinery/field_generator{anchored = 1; state = 1},/turf/simulated/floor/tiled/techfloor,/area/space)
"ZA" = (/obj/random/maintenance/security,/obj/structure/table/reinforced,/turf/simulated/floor/tiled/steel_dirty,/area/space)
"ZG" = (/obj/machinery/fitness/heavy/lifter,/turf/simulated/floor/tiled/asteroid_steel,/area/space)

(1,1,1) = {"
dGdGdGdGdGdGdGdGdGdGdGdGyFdGyFdGtwtwtwdGdGdGdGdGdGdGtwtwdGdGdGdG
yFyFdGdGyFyFyFyFyFyFyFdGdGdGdGdGtwtwtwdGdGdGyFtwtwtwyFyFyFyFyFyF
dGAoAoAoAoAoAoAoAoAoAoAoAoAodGdGtwdGdGdGyFdGdGtwtwtwdGtwtwtwdGdG
dGsKtwtwtwtwtwtwtwnhGIMllkAoAotKAoAoAotKtKtKAoAoAoAoAoAoAoAodGyF
dGdGdGdGdGdGdGdGtwtwtwtwtwAoJTtwYltwAoYdaIBCVbAoUtpAakZjAhAotwyF
dGdGdGdGdGdGjqdGtwAoAoAoAoAoEEtwEYtwAoYdtwGaIbAoJhpASwusOcAotwyF
dGdGdGyFyFyFyFyFtwAobEkdbEAoAutwvGlAAogTJEJotoAoMxpAfqcSlXAodGyF
dGdGdGdGdGdGdGdGtwohbEbEWeohTKTKqfLsAoXXADADADAonJsktwTKTKAoyFyF
dGdGdGdGdGdGXrdGtwAoAoADAoAoVxmBYBdfDrnHQodfMAXHKETKTKycdAAotwyF
dGdGdGyFyFyFyFyFtwAoavjuzbAoAoADADAoAoAoAoAoPtAoAoADAoAoAoAotwyF
dGdGdGdGdGdGdGdGtwtKeapATKADKNoWrpSMLpqEJVAoISAoHEpApAbQtlAotwdG
dGdGdGdGdGdGNHdGtwtKOflcskrMpAtwlAbQLsGXQoinIbADnzTKakZjCNAoyFdG
dGdGdGyFyFyFyFyFtwtKwUTKpAADtwpwpwpwpwTKpAAoPtAoMatwSwusOcAoyFdG
dGdGdGdGdGdGdGdGtwtKYIdHKtAoezAoqpAoezAoINAotHXHsdpwfqcSlXAodGyF
dGdGdGdGdGdGjqdGtwtKZALspAAodtAoncAodtAodtAoPtAoDfpApApAgGAotwyF
dGdGdGyFyFyFyFyFtwAohrTKKeAoAoAoAoAoAoAoAoAolyAoAoADAoAoAoAotwyF
dGdGdGdGdGdGdGdGtwAoAoADAoAoOsnsRSqYiHdfqYdfnZXHWopAZGHEZGAotwyF
dGdGdGdGdGdGOFdGtwohbEbEbEohTKTKVTpAAoADADADyHAorjwgpArptwAodGyF
dGdGdGyFyFyFyFyFtwAobEqbbEAoqatwAutwAoijMBLhtwAotWpAakZjCNAotwyF
dGdGdGdGdGdGJRyFtwAoAoAoAoAoEYlAvGtwAohKrlIXArAoVutwSwusOcAotwyF
dGdGSzyFyFyFyFyFtwtVaxtOcaAoYltwIEtwAohoqyGobaAouJTKfqcSlXAotwdG
dGdGtwtwtwtwtwtwtwtwtwtwtwAoAotKAoAoAotKtKtKAoAoAoAoAoAoAoAotwdG
dGAoAoAoAoAoAoAoAoAoAoAoAoAotwtwtwtwtwtwtwtwyFtwtwtwtwdGtwtwdGdG
yFyFyFyFdGdGyFyFyFdGdGyFdGdGtwdGtwtwtwdGtwtwyFtwtwtwtwyFtwtwyFyF
"}
