//MAP CONVERTED BY dmm2tgm.py THIS HEADER COMMENT PREVENTS RECONVERSION, DO NOT REMOVE
"aa" = (
/obj/structure/table/woodentable,
/obj/item/cell/hyper,
/obj/random/coin,
/obj/random/cash/huge,
/turf/simulated/floor/wood,
/area/survivalpod/superpose/OldHotel)
"ab" = (
/obj/structure/closet/crate,
/obj/random/cash,
/obj/random/cigarettes,
/turf/simulated/floor/wood,
/area/survivalpod/superpose/OldHotel)
"ai" = (
/obj/random/trash,
/turf/simulated/floor/carpet/purcarpet,
/area/survivalpod/superpose/OldHotel)
"aJ" = (
/obj/item/towel/random,
/obj/item/towel/random,
/obj/structure/table/standard,
/obj/item/storage/firstaid,
/turf/simulated/floor/tiled/asteroid_steel,
/area/survivalpod/superpose/OldHotel)
"bb" = (
/obj/machinery/light/small{
	dir = 4
	},
/obj/item/multitool,
/turf/simulated/floor/wood,
/area/survivalpod/superpose/OldHotel)
"bQ" = (
/obj/effect/decal/cleanable/dirt,
/obj/effect/decal/cleanable/dirt,
/turf/simulated/floor/tiled/asteroid_steel,
/area/survivalpod/superpose/OldHotel)
"bW" = (
/obj/item/material/shard,
/turf/template_noop,
/area/survivalpod/superpose/OldHotel)
"cA" = (
/obj/structure/sink/kitchen,
/turf/simulated/wall/wood,
/area/survivalpod/superpose/OldHotel)
"cZ" = (
/obj/effect/decal/cleanable/dirt,
/obj/random/junk,
/turf/simulated/floor/carpet/oracarpet,
/area/survivalpod/superpose/OldHotel)
"da" = (
/obj/structure/bed/chair/oldsofa/right,
/turf/simulated/floor/carpet/blue,
/area/survivalpod/superpose/OldHotel)
"dc" = (
/obj/effect/decal/cleanable/dirt,
/turf/simulated/floor/carpet/oracarpet,
/area/survivalpod/superpose/OldHotel)
"dn" = (
/obj/structure/table/woodentable,
/obj/item/flame/candle/everburn,
/turf/simulated/floor/wood,
/area/survivalpod/superpose/OldHotel)
"dr" = (
/obj/item/stack/material/plastic{
	amount = 50
	},
/obj/item/stack/material/plastic{
	amount = 50
	},
/obj/item/stack/material/plastic{
	amount = 50
	},
/obj/item/stack/material/plastic{
	amount = 50
	},
/obj/item/stack/material/steel{
	amount = 50
	},
/obj/item/stack/material/steel{
	amount = 50
	},
/obj/item/stack/material/steel{
	amount = 50
	},
/obj/item/stack/material/steel{
	amount = 50
	},
/obj/item/stack/material/glass{
	amount = 50
	},
/obj/item/stack/material/glass{
	amount = 50
	},
/obj/item/stack/material/glass{
	amount = 50
	},
/obj/item/stack/material/glass{
	amount = 50
	},
/obj/item/stack/rods{
	amount = 50
	},
/obj/item/stack/rods{
	amount = 50
	},
/obj/item/stack/rods{
	amount = 50
	},
/obj/item/stack/rods{
	amount = 50
	},
/obj/item/stack/cable_coil{
	pixel_x = 3;
	pixel_y = 3
	},
/obj/item/stack/cable_coil{
	pixel_x = 3;
	pixel_y = 3
	},
/obj/item/stack/cable_coil/green,
/obj/item/stack/cable_coil/blue,
/obj/item/storage/briefcase/inflatable,
/obj/item/storage/briefcase/inflatable,
/obj/item/storage/briefcase/inflatable,
/obj/item/storage/briefcase/inflatable,
/obj/structure/table/rack/shelf,
/turf/simulated/floor/tiled/asteroid_steel,
/area/survivalpod/superpose/OldHotel)
"dz" = (
/obj/structure/sink{
	dir = 8;
	pixel_x = -12;
	pixel_y = 2
	},
/obj/structure/mirror{
	dir = 4;
	pixel_x = -28
	},
/obj/effect/decal/cleanable/dirt,
/turf/simulated/floor/tiled/asteroid_steel,
/area/survivalpod/superpose/OldHotel)
"dL" = (
/obj/structure/window/reinforced/full,
/obj/structure/grille/rustic,
/turf/simulated/floor/tiled/asteroid_steel,
/area/survivalpod/superpose/OldHotel)
"eK" = (
/obj/structure/grille,
/obj/structure/bonfire/sifwood,
/turf/simulated/floor/outdoors/dirt,
/area/survivalpod/superpose/OldHotel)
"go" = (
/obj/structure/simple_door/iron,
/turf/simulated/floor/wood,
/area/survivalpod/superpose/OldHotel)
"gA" = (
/turf/template_noop,
/area/template_noop)
"gM" = (
/obj/machinery/appliance/cooker/oven,
/turf/simulated/floor/tiled/asteroid_steel,
/area/survivalpod/superpose/OldHotel)
"hc" = (
/obj/random/trash,
/turf/simulated/floor/wood,
/area/survivalpod/superpose/OldHotel)
"hp" = (
/obj/random/junk,
/turf/simulated/floor/carpet/sblucarpet,
/area/survivalpod/superpose/OldHotel)
"hO" = (
/obj/item/stock_parts/capacitor,
/obj/item/stock_parts/capacitor,
/obj/item/stock_parts/capacitor,
/turf/simulated/floor/wood,
/area/survivalpod/superpose/OldHotel)
"hQ" = (
/turf/simulated/wall/wood,
/area/survivalpod/superpose/OldHotel)
"if" = (
/obj/structure/bed/chair/oldsofa/left{
	dir = 8
	},
/turf/simulated/floor/carpet/blue,
/area/survivalpod/superpose/OldHotel)
"iU" = (
/obj/structure/table/woodentable,
/obj/item/trash/tray,
/turf/simulated/floor/wood,
/area/survivalpod/superpose/OldHotel)
"ja" = (
/obj/effect/decal/cleanable/dirt,
/obj/random/junk,
/turf/simulated/floor/carpet/purcarpet,
/area/survivalpod/superpose/OldHotel)
"jO" = (
/obj/structure/bed/chair/oldsofa,
/turf/simulated/floor/carpet/blue,
/area/survivalpod/superpose/OldHotel)
"kh" = (
/turf/simulated/floor/carpet/blue,
/area/survivalpod/superpose/OldHotel)
"kw" = (
/obj/structure/lightpost,
/turf/template_noop,
/area/survivalpod/superpose/OldHotel)
"kI" = (
/turf/simulated/floor/carpet/sblucarpet,
/area/survivalpod/superpose/OldHotel)
"kW" = (
/obj/structure/table/woodentable,
/obj/item/reagent_containers/food/condiment/small/saltshaker,
/obj/item/reagent_containers/food/condiment/small/peppermill{
	pixel_x = 3
	},
/turf/simulated/floor/wood,
/area/survivalpod/superpose/OldHotel)
"lj" = (
/obj/structure/table/wooden_reinforced,
/obj/item/material/kitchen/rollingpin,
/turf/simulated/floor/tiled/asteroid_steel,
/area/survivalpod/superpose/OldHotel)
"ly" = (
/obj/structure/bed/double/padded,
/obj/item/bedsheet/piratedouble,
/turf/simulated/floor/wood,
/area/survivalpod/superpose/OldHotel)
"lZ" = (
/obj/structure/table/woodentable,
/obj/item/trash/tray,
/turf/simulated/floor/carpet/blue,
/area/survivalpod/superpose/OldHotel)
"mR" = (
/obj/effect/decal/cleanable/dirt,
/turf/simulated/floor/outdoors/dirt,
/area/survivalpod/superpose/OldHotel)
"nD" = (
/turf/simulated/floor,
/area/survivalpod/superpose/OldHotel)
"nG" = (
/obj/item/material/shard,
/turf/simulated/floor/outdoors/dirt,
/area/survivalpod/superpose/OldHotel)
"op" = (
/obj/structure/table/woodentable,
/obj/random/cigarettes,
/turf/simulated/floor/carpet/blue,
/area/survivalpod/superpose/OldHotel)
"pn" = (
/obj/item/material/shard,
/obj/item/material/shard{
	pixel_x = 7
	},
/turf/template_noop,
/area/survivalpod/superpose/OldHotel)
"qg" = (
/turf/simulated/floor/wood,
/area/survivalpod/superpose/OldHotel)
"qY" = (
/obj/effect/decal/cleanable/dirt,
/obj/random/junk,
/turf/simulated/floor/wood,
/area/survivalpod/superpose/OldHotel)
"rb" = (
/obj/item/module/power_control,
/turf/simulated/floor/tiled/asteroid_steel,
/area/survivalpod/superpose/OldHotel)
"rK" = (
/obj/structure/table/woodentable,
/obj/item/trash/candle,
/turf/simulated/floor/wood,
/area/survivalpod/superpose/OldHotel)
"sd" = (
/obj/structure/toilet,
/turf/simulated/floor/tiled/asteroid_steel,
/area/survivalpod/superpose/OldHotel)
"sV" = (
/obj/structure/table/woodentable,
/obj/random/contraband,
/turf/simulated/floor/wood,
/area/survivalpod/superpose/OldHotel)
"tn" = (
/obj/structure/simple_door/wood,
/turf/simulated/floor/wood,
/area/survivalpod/superpose/OldHotel)
"tz" = (
/obj/structure/bed/double/padded,
/obj/item/bedsheet/rddouble,
/turf/simulated/floor/wood,
/area/survivalpod/superpose/OldHotel)
"tE" = (
/obj/structure/table/woodentable,
/obj/random/coin,
/obj/item/reagent_containers/glass/rag,
/turf/simulated/floor/carpet/blue,
/area/survivalpod/superpose/OldHotel)
"tV" = (
/obj/structure/bed/chair/wood{
	dir = 1
	},
/obj/item/material/shard,
/turf/simulated/floor/wood,
/area/survivalpod/superpose/OldHotel)
"uU" = (
/obj/structure/closet/cabinet,
/obj/random/maintenance/medical,
/obj/random/carp_plushie,
/obj/random/cigarettes,
/obj/random/drinkbottle,
/obj/random/junk,
/obj/random/junk,
/obj/random/junk,
/obj/random/maintenance,
/turf/simulated/floor/wood,
/area/survivalpod/superpose/OldHotel)
"vh" = (
/obj/structure/bed/chair/oldsofa/corner,
/turf/simulated/floor/carpet/blue,
/area/survivalpod/superpose/OldHotel)
"vA" = (
/obj/structure/table/woodentable,
/obj/item/telecube/randomized{
	name = "Odd artifact"
	},
/turf/simulated/floor/wood,
/area/survivalpod/superpose/OldHotel)
"vM" = (
/obj/item/material/shard,
/obj/item/material/shard{
	pixel_y = -6
	},
/obj/item/material/shard{
	pixel_x = 9
	},
/obj/structure/grille/broken,
/turf/simulated/floor/tiled/asteroid_steel,
/area/survivalpod/superpose/OldHotel)
"vR" = (
/obj/structure/table/woodentable,
/obj/item/flame/candle/candelabra,
/turf/simulated/floor/carpet/blue,
/area/survivalpod/superpose/OldHotel)
"wm" = (
/obj/random/trash,
/obj/effect/decal/cleanable/dirt,
/turf/simulated/floor/outdoors/dirt,
/area/survivalpod/superpose/OldHotel)
"wK" = (
/obj/item/material/shard,
/obj/item/material/shard,
/turf/simulated/floor/tiled/asteroid_steel,
/area/survivalpod/superpose/OldHotel)
"wV" = (
/obj/structure/table/wooden_reinforced,
/obj/item/reagent_containers/glass/beaker,
/obj/item/reagent_containers/food/condiment/enzyme,
/turf/simulated/floor/tiled/asteroid_steel,
/area/survivalpod/superpose/OldHotel)
"wX" = (
/obj/item/stack/material/cardboard{
	amount = 50
	},
/obj/item/stack/material/cardboard{
	amount = 50
	},
/obj/item/stack/material/cardboard{
	amount = 50
	},
/obj/item/stack/material/cardboard{
	amount = 50
	},
/obj/fiftyspawner/blucarpet,
/obj/fiftyspawner/oracarpet,
/obj/fiftyspawner/purcarpet,
/obj/fiftyspawner/sblucarpet,
/obj/fiftyspawner/tealcarpet,
/obj/fiftyspawner/turcarpet,
/obj/item/stack/material/wood{
	amount = 50;
	color = "#824B28"
	},
/obj/item/stack/material/wood{
	amount = 50;
	color = "#824B28"
	},
/obj/item/stack/material/wood/hard{
	amount = 50
	},
/obj/item/stack/material/wood/hard{
	amount = 50
	},
/obj/item/stack/material/wood/sif{
	amount = 50
	},
/obj/item/stack/material/wood/sif{
	amount = 50
	},
/obj/item/stack/material/marble{
	amount = 50
	},
/obj/item/stack/material/marble{
	amount = 50
	},
/obj/item/stack/material/marble{
	amount = 50
	},
/obj/item/stack/material/cloth{
	amount = 50
	},
/obj/item/stack/material/cloth{
	amount = 50
	},
/obj/item/stack/material/algae{
	amount = 50
	},
/obj/item/stack/material/sandstone,
/obj/item/stack/material/sandstone,
/obj/item/stack/material/sandstone,
/obj/item/stack/material/lead{
	amount = 30
	},
/obj/item/stack/material/plasteel{
	amount = 30;
	pixel_y = 5
	},
/obj/item/stack/material/resin{
	amount = 50
	},
/obj/item/stack/material/smolebricks{
	amount = 50
	},
/obj/item/stack/material/smolebricks{
	amount = 50
	},
/obj/structure/table/rack/shelf,
/turf/simulated/floor/tiled/asteroid_steel,
/area/survivalpod/superpose/OldHotel)
"yj" = (
/obj/random/mob/sif/peaceful,
/turf/simulated/floor/outdoors/dirt,
/area/survivalpod/superpose/OldHotel)
"yM" = (
/obj/item/stack/cable_coil,
/turf/simulated/floor/carpet/purcarpet,
/area/survivalpod/superpose/OldHotel)
"zs" = (
/obj/effect/decal/cleanable/dirt,
/obj/random/junk,
/turf/simulated/floor/outdoors/dirt,
/area/survivalpod/superpose/OldHotel)
"zt" = (
/obj/structure/noticeboard,
/turf/simulated/wall/wood,
/area/survivalpod/superpose/OldHotel)
"zE" = (
/obj/structure/closet/cabinet,
/obj/random/maintenance/medical,
/obj/random/cash,
/obj/random/cigarettes,
/obj/random/firstaid,
/obj/random/junk,
/obj/random/junk,
/obj/random/junk,
/obj/random/maintenance,
/turf/simulated/floor/wood,
/area/survivalpod/superpose/OldHotel)
"zP" = (
/obj/random/plushie,
/turf/simulated/floor/wood,
/area/survivalpod/superpose/OldHotel)
"Ac" = (
/obj/structure/table/wooden_reinforced,
/obj/item/material/knife/butch,
/turf/simulated/floor/tiled/asteroid_steel,
/area/survivalpod/superpose/OldHotel)
"Ag" = (
/obj/structure/closet/crate/solar,
/turf/simulated/floor/wood,
/area/survivalpod/superpose/OldHotel)
"AO" = (
/obj/structure/railing,
/turf/simulated/floor/outdoors/dirt,
/area/survivalpod/superpose/OldHotel)
"AU" = (
/obj/structure/table/woodentable,
/obj/item/tape,
/obj/item/circuitboard/batteryrack,
/turf/simulated/floor/wood,
/area/survivalpod/superpose/OldHotel)
"Bt" = (
/obj/structure/closet/cabinet,
/obj/random/ammo_all,
/obj/random/cargopod,
/obj/random/cargopod,
/obj/random/cargopod,
/obj/item/clothing/gloves/yellow,
/turf/simulated/floor/wood,
/area/survivalpod/superpose/OldHotel)
"Cx" = (
/turf/simulated/floor/outdoors/dirt,
/area/survivalpod/superpose/OldHotel)
"CS" = (
/obj/item/storage/toolbox/mechanical,
/turf/simulated/floor/wood,
/area/survivalpod/superpose/OldHotel)
"Di" = (
/obj/structure/table/wooden_reinforced,
/obj/machinery/microwave,
/turf/simulated/floor/tiled/asteroid_steel,
/area/survivalpod/superpose/OldHotel)
"Dx" = (
/obj/structure/table/wooden_reinforced,
/obj/random/medical,
/obj/random/medical,
/turf/simulated/floor/tiled/asteroid_steel,
/area/survivalpod/superpose/OldHotel)
"DN" = (
/obj/structure/bed/chair/wood,
/turf/simulated/floor/wood,
/area/survivalpod/superpose/OldHotel)
"Es" = (
/obj/random/junk,
/turf/simulated/floor/outdoors/dirt,
/area/survivalpod/superpose/OldHotel)
"ES" = (
/obj/random/trash,
/turf/simulated/floor/carpet/oracarpet,
/area/survivalpod/superpose/OldHotel)
"Gk" = (
/obj/structure/bed/chair/wood{
	dir = 1
	},
/turf/simulated/floor/wood,
/area/survivalpod/superpose/OldHotel)
"Gr" = (
/obj/item/frame/apc,
/turf/simulated/floor/wood,
/area/survivalpod/superpose/OldHotel)
"Gz" = (
/obj/structure/window/reinforced/tinted{
	dir = 8
	},
/obj/machinery/shower{
	dir = 1
	},
/obj/structure/curtain/open/shower/medical,
/turf/simulated/floor/tiled/asteroid_steel,
/area/survivalpod/superpose/OldHotel)
"GC" = (
/obj/random/trash,
/obj/random/trash,
/turf/simulated/floor/outdoors/dirt,
/area/survivalpod/superpose/OldHotel)
"GN" = (
/obj/structure/flora/tree/sif,
/turf/template_noop,
/area/survivalpod/superpose/OldHotel)
"GV" = (
/obj/structure/table/woodentable,
/obj/item/storage/fancy/candle_box,
/obj/item/storage/fancy/candle_box,
/obj/item/storage/fancy/candle_box,
/obj/item/flame/lighter/random,
/obj/item/flame/lighter/random,
/obj/item/melee/umbrella/random,
/turf/simulated/floor/wood,
/area/survivalpod/superpose/OldHotel)
"Ha" = (
/obj/structure/table/woodentable,
/obj/item/trash/candle,
/obj/item/paper{
	info = "This is a stupid tresure hunt task, that thing is not taking us anywhere. Go on and have fun finding a waste of time.";
	name = "Wrinkled sheet of paper"
	},
/turf/simulated/floor/wood,
/area/survivalpod/superpose/OldHotel)
"Ik" = (
/obj/item/material/shard,
/turf/simulated/floor/tiled/asteroid_steel,
/area/survivalpod/superpose/OldHotel)
"Il" = (
/obj/structure/closet/secure_closet/freezer/kitchen{
	locked = 0
	},
/turf/simulated/floor/tiled/asteroid_steel,
/area/survivalpod/superpose/OldHotel)
"IQ" = (
/obj/structure/railing,
/obj/structure/closet/crate/bin,
/turf/simulated/floor/tiled/asteroid_steel,
/area/survivalpod/superpose/OldHotel)
"Jq" = (
/turf/simulated/floor/tiled/asteroid_steel,
/area/survivalpod/superpose/OldHotel)
"JT" = (
/obj/random/junk,
/turf/simulated/floor/wood,
/area/survivalpod/superpose/OldHotel)
"JV" = (
/obj/structure/table/bench/sifwooden,
/turf/simulated/floor/outdoors/dirt,
/area/survivalpod/superpose/OldHotel)
"Mk" = (
/obj/item/gps,
/obj/item/sticky_pad/random,
/obj/item/starcaster_news,
/obj/item/pen/blue,
/obj/item/pda,
/obj/item/card/id/external,
/obj/item/storage/mre/random,
/obj/item/storage/mre/random,
/obj/item/reagent_containers/food/drinks/cans/waterbottle,
/obj/item/reagent_containers/food/drinks/cans/waterbottle,
/obj/item/reagent_containers/food/snacks/sosjerky,
/obj/item/reagent_containers/food/snacks/sosjerky,
/obj/item/gun/energy/locked/phasegun/pistol,
/obj/item/material/knife/tacknife/survival,
/obj/item/clothing/accessory/permit/gun,
/obj/item/camera,
/obj/item/binoculars,
/obj/item/threadneedle,
/obj/random/soap,
/obj/item/towel/random,
/obj/item/bodybag/cryobag,
/obj/item/flashlight/flare,
/obj/item/flashlight/flare,
/obj/item/flashlight/color/yellow,
/obj/item/radio,
/obj/item/radio,
/obj/item/flame/lighter/random,
/obj/item/cell/device/hyper,
/obj/item/cell/device/hyper,
/obj/item/extinguisher/mini,
/obj/item/reagent_containers/glass/beaker/vial/tricordrazine,
/obj/item/reagent_containers/glass/beaker/vial/tricordrazine,
/obj/item/reagent_containers/pill/spaceacillin,
/obj/item/reagent_containers/pill/spaceacillin,
/obj/item/fbp_backup_cell,
/obj/item/fbp_backup_cell,
/obj/item/suit_cooling_unit/emergency,
/obj/item/stack/nanopaste,
/obj/item/reagent_containers/hypospray/autoinjector/biginjector/clotting,
/obj/item/storage/backpack/messenger,
/obj/item/clothing/accessory/storage/black_drop_pouches,
/obj/item/clothing/accessory/poncho/thermal,
/obj/item/storage/box/survival/comp,
/obj/item/storage/toolbox/brass,
/obj/item/storage/box/khcrystal,
/obj/structure/closet/crate,
/turf/simulated/floor/wood/broken,
/area/survivalpod/superpose/OldHotel)
"Mo" = (
/obj/structure/railing,
/turf/template_noop,
/area/survivalpod/superpose/OldHotel)
"Mq" = (
/obj/structure/closet/crate,
/obj/random/firstaid,
/turf/simulated/floor/wood,
/area/survivalpod/superpose/OldHotel)
"MD" = (
/obj/effect/decal/cleanable/dirt,
/obj/structure/simple_door/wood,
/turf/simulated/floor/wood,
/area/survivalpod/superpose/OldHotel)
"MU" = (
/turf/template_noop,
/area/survivalpod/superpose/OldHotel)
"Nu" = (
/obj/random/soap,
/turf/simulated/floor/tiled/asteroid_steel,
/area/survivalpod/superpose/OldHotel)
"Pd" = (
/obj/effect/decal/cleanable/dirt,
/turf/simulated/floor/carpet/sblucarpet,
/area/survivalpod/superpose/OldHotel)
"PO" = (
/obj/machinery/space_heater,
/turf/simulated/floor/wood/broken,
/area/survivalpod/superpose/OldHotel)
"Qh" = (
/obj/item/stock_parts/matter_bin,
/turf/simulated/floor/wood,
/area/survivalpod/superpose/OldHotel)
"Qv" = (
/obj/structure/table/woodentable,
/obj/item/paper_bin,
/obj/item/pen,
/obj/item/pen,
/obj/item/pen,
/turf/simulated/floor/wood,
/area/survivalpod/superpose/OldHotel)
"Qw" = (
/obj/item/stool,
/obj/random/projectile/scrapped_shotgun,
/obj/random/cash,
/obj/machinery/light/small,
/turf/simulated/floor/wood,
/area/survivalpod/superpose/OldHotel)
"QG" = (
/obj/structure/bed/chair/oldsofa{
	dir = 8
	},
/turf/simulated/floor/carpet/blue,
/area/survivalpod/superpose/OldHotel)
"RM" = (
/obj/machinery/space_heater,
/turf/simulated/floor/wood,
/area/survivalpod/superpose/OldHotel)
"RQ" = (
/obj/effect/decal/cleanable/dirt,
/turf/simulated/floor/wood/broken,
/area/survivalpod/superpose/OldHotel)
"Se" = (
/obj/structure/closet/cabinet,
/obj/item/binoculars/spyglass,
/obj/random/contraband,
/obj/random/contraband,
/obj/random/maintenance/medical,
/obj/random/cash,
/obj/random/drinkbottle,
/obj/random/junk,
/obj/random/junk,
/obj/random/maintenance,
/obj/random/maintenance,
/turf/simulated/floor/wood,
/area/survivalpod/superpose/OldHotel)
"Sf" = (
/obj/structure/bed/double/padded,
/obj/item/bedsheet/yellowdouble,
/turf/simulated/floor/wood,
/area/survivalpod/superpose/OldHotel)
"Sy" = (
/obj/effect/decal/cleanable/dirt,
/turf/simulated/floor/tiled/asteroid_steel,
/area/survivalpod/superpose/OldHotel)
"SG" = (
/turf/simulated/floor/carpet/purcarpet,
/area/survivalpod/superpose/OldHotel)
"SL" = (
/obj/item/material/shard,
/obj/item/material/shard,
/obj/item/material/shard{
	pixel_x = 9
	},
/turf/simulated/floor,
/area/survivalpod/superpose/OldHotel)
"SZ" = (
/obj/effect/decal/cleanable/dirt,
/turf/simulated/floor/wood,
/area/survivalpod/superpose/OldHotel)
"TU" = (
/turf/simulated/floor/wood/broken,
/area/survivalpod/superpose/OldHotel)
"Ut" = (
/obj/structure/kitchenspike,
/turf/simulated/floor/outdoors/dirt,
/area/survivalpod/superpose/OldHotel)
"Uw" = (
/obj/structure/table/wooden_reinforced,
/obj/item/book/manual/chef_recipes,
/turf/simulated/floor/tiled/asteroid_steel,
/area/survivalpod/superpose/OldHotel)
"UU" = (
/obj/structure/table/woodentable,
/obj/item/flame/lighter/zippo/royal,
/obj/item/lipstick/random,
/turf/simulated/floor/wood,
/area/survivalpod/superpose/OldHotel)
"Vf" = (
/obj/structure/window/reinforced/tinted{
	dir = 4
	},
/obj/machinery/shower{
	dir = 1
	},
/obj/structure/curtain/open/shower/medical,
/obj/random/soap,
/turf/simulated/floor/tiled/asteroid_steel,
/area/survivalpod/superpose/OldHotel)
"Vj" = (
/turf/simulated/floor/carpet/oracarpet,
/area/survivalpod/superpose/OldHotel)
"Wy" = (
/obj/effect/decal/cleanable/dirt,
/obj/effect/decal/cleanable/dirt,
/turf/simulated/floor/wood,
/area/survivalpod/superpose/OldHotel)
"WD" = (
/obj/structure/closet/secure_closet/freezer/fridge{
	locked = 0
	},
/obj/random/meat,
/obj/random/meat,
/obj/random/meat,
/obj/random/meat,
/obj/random/meat,
/obj/random/meat,
/obj/random/meat,
/obj/machinery/light/small{
	dir = 8
	},
/turf/simulated/floor/tiled/asteroid_steel,
/area/survivalpod/superpose/OldHotel)
"WH" = (
/obj/item/flashlight{
	pixel_x = 2;
	pixel_y = 2
	},
/turf/simulated/floor/wood,
/area/survivalpod/superpose/OldHotel)
"YI" = (
/obj/structure/coatrack,
/turf/simulated/floor/wood,
/area/survivalpod/superpose/OldHotel)
"YQ" = (
/obj/item/material/shard,
/obj/structure/grille/broken/rustic,
/turf/simulated/floor/tiled/asteroid_steel,
/area/survivalpod/superpose/OldHotel)
"ZG" = (
/obj/structure/girder,
/turf/simulated/floor,
/area/survivalpod/superpose/OldHotel)

(1,1,1) = {"
gA
gA
gA
gA
gA
gA
gA
gA
gA
gA
gA
gA
gA
gA
gA
gA
gA
gA
gA
gA
gA
gA
gA
gA
gA
"}
(2,1,1) = {"
gA
MU
MU
MU
MU
MU
MU
MU
MU
MU
MU
MU
MU
MU
MU
MU
MU
MU
MU
MU
MU
MU
MU
MU
gA
"}
(3,1,1) = {"
gA
MU
kw
hQ
hQ
ZG
ZG
hQ
MU
MU
MU
MU
MU
MU
MU
bW
MU
MU
MU
MU
MU
MU
MU
MU
gA
"}
(4,1,1) = {"
gA
MU
hQ
hQ
Bt
YI
GV
hQ
hQ
MU
nG
hQ
nD
hQ
Cx
pn
nD
hQ
hQ
Cx
Cx
hQ
hQ
MU
gA
"}
(5,1,1) = {"
gA
mR
mR
go
TU
TU
WH
hQ
hQ
dL
YQ
hQ
ZG
hQ
Ik
YQ
ZG
ZG
hQ
dL
dL
hQ
hQ
MU
gA
"}
(6,1,1) = {"
gA
MU
hQ
zt
SZ
Qv
SZ
hQ
DN
sV
tV
Mq
nD
DN
iU
Gk
ab
hQ
Mk
DN
vA
Gk
nD
MU
gA
"}
(7,1,1) = {"
gA
MU
nG
vM
qg
rK
Qw
hQ
TU
ES
Vj
SZ
hQ
RM
ai
ja
qg
hQ
PO
Pd
hp
qg
ZG
MU
gA
"}
(8,1,1) = {"
gA
MU
MU
dL
qY
UU
Gr
ZG
RM
dc
cZ
SZ
hQ
TU
SG
yM
Wy
ZG
TU
kI
Pd
qg
hQ
MU
gA
"}
(9,1,1) = {"
gA
MU
bW
wK
JT
AU
hO
nD
rK
tz
uU
qg
hQ
rK
Sf
zE
SZ
hQ
qg
Se
ly
Ha
hQ
MU
gA
"}
(10,1,1) = {"
gA
MU
ZG
hQ
zP
TU
Qh
hQ
hQ
hQ
hQ
tn
hQ
hQ
ZG
hQ
tn
hQ
tn
hQ
nD
hQ
hQ
MU
gA
"}
(11,1,1) = {"
gA
MU
nD
hQ
Ag
qg
SZ
qg
SZ
JT
tn
qg
hc
SZ
qg
SZ
RQ
SZ
SZ
SZ
CS
dL
MU
MU
gA
"}
(12,1,1) = {"
gA
MU
MU
dL
qg
da
op
lZ
kh
SZ
tn
SZ
DN
dn
kW
Gk
bb
DN
kW
dn
Gk
dL
MU
MU
gA
"}
(13,1,1) = {"
gA
MU
nG
YQ
JT
jO
vR
tE
kh
qg
hQ
ZG
hQ
nD
ZG
hQ
hQ
hQ
hQ
hQ
hQ
ZG
nD
MU
gA
"}
(14,1,1) = {"
gA
MU
MU
dL
qg
vh
QG
QG
if
SZ
go
bQ
rb
lj
Ac
Uw
WD
wV
Dx
Di
gM
Il
IQ
MU
gA
"}
(15,1,1) = {"
gA
MU
hQ
hQ
aa
TU
hc
SZ
qg
TU
go
bQ
Cx
Jq
Cx
Jq
Sy
Jq
mR
Sy
Cx
Jq
Cx
MU
gA
"}
(16,1,1) = {"
gA
MU
ZG
hQ
ZG
hQ
MD
hQ
hQ
hQ
cA
Sy
mR
Es
mR
Cx
wm
Cx
mR
zs
GC
Cx
AO
MU
gA
"}
(17,1,1) = {"
gA
MU
hQ
hQ
aJ
dz
Sy
Vf
nD
dr
Jq
Jq
Es
Cx
yj
Cx
Cx
Cx
Es
Cx
yj
Cx
AO
MU
gA
"}
(18,1,1) = {"
gA
MU
MU
hQ
sd
Sy
Nu
Gz
hQ
wX
Jq
bQ
Cx
Cx
MU
JV
eK
JV
MU
Cx
MU
MU
MU
MU
gA
"}
(19,1,1) = {"
gA
MU
MU
ZG
hQ
ZG
SL
hQ
hQ
ZG
hQ
Ut
Jq
Cx
MU
MU
Cx
MU
MU
MU
MU
MU
Mo
MU
gA
"}
(20,1,1) = {"
gA
MU
MU
MU
MU
MU
bW
MU
MU
MU
Cx
Cx
Cx
MU
Cx
MU
Cx
MU
MU
MU
MU
MU
MU
MU
gA
"}
(21,1,1) = {"
gA
MU
MU
MU
MU
MU
MU
MU
MU
Cx
MU
MU
MU
MU
MU
MU
MU
MU
MU
MU
MU
MU
GN
MU
gA
"}
(22,1,1) = {"
gA
MU
GN
MU
MU
MU
MU
MU
MU
MU
MU
MU
Cx
Cx
MU
MU
Cx
MU
MU
MU
MU
MU
MU
MU
gA
"}
(23,1,1) = {"
gA
MU
MU
MU
MU
MU
MU
MU
MU
MU
MU
MU
MU
MU
MU
MU
MU
MU
MU
MU
MU
MU
MU
MU
gA
"}
(24,1,1) = {"
gA
MU
MU
MU
MU
MU
MU
MU
MU
MU
MU
MU
MU
GN
MU
MU
MU
MU
MU
MU
MU
MU
MU
MU
gA
"}
(25,1,1) = {"
gA
gA
gA
gA
gA
gA
gA
gA
gA
gA
gA
gA
gA
gA
gA
gA
gA
gA
gA
gA
gA
gA
gA
gA
gA
"}
