//MAP CONVERTED BY dmm2tgm.py THIS HEADER COMMENT PREVENTS RECONVERSION, DO NOT REMOVE
"a" = (
/turf/simulated/wall/shull,
/area/survivalpod/superpose/SmallCombatShip)
"d" = (
/obj/machinery/disperser/front{
	dir = 1
	},
/turf/template_noop,
/area/template_noop)
"f" = (
/turf/simulated/floor/tiled/techmaint,
/area/survivalpod/superpose/SmallCombatShip)
"g" = (
/turf/simulated/floor/tiled/techfloor,
/area/survivalpod/superpose/SmallCombatShip)
"h" = (
/obj/effect/catwalk_plated/dark,
/turf/template_noop,
/area/survivalpod/superpose/SmallCombatShip)
"l" = (
/obj/structure/bed/chair/bay/comfy/red{
	dir = 4
	},
/turf/simulated/floor/tiled/techfloor,
/area/survivalpod/superpose/SmallCombatShip)
"m" = (
/turf/simulated/wall/rshull,
/area/survivalpod/superpose/SmallCombatShip)
"o" = (
/obj/structure/salvageable/machine,
/turf/simulated/floor/tiled/techmaint,
/area/survivalpod/superpose/SmallCombatShip)
"q" = (
/obj/effect/floor_decal/techfloor{
	dir = 8
	},
/obj/machinery/power/apc/hyper{
	pixel_y = -24
	},
/turf/simulated/shuttle/floor/voidcraft,
/area/survivalpod/superpose/SmallCombatShip)
"s" = (
/obj/structure/closet/walllocker_double/medical/west,
/obj/item/storage/firstaid,
/obj/item/storage/firstaid/fire,
/obj/item/storage/firstaid/toxin,
/obj/item/storage/firstaid/o2,
/obj/item/roller,
/obj/effect/floor_decal/techfloor{
	dir = 4
	},
/obj/structure/window/reinforced/survival_pod,
/turf/simulated/shuttle/floor/voidcraft,
/area/survivalpod/superpose/SmallCombatShip)
"t" = (
/obj/effect/catwalk_plated/dark,
/obj/effect/catwalk_plated/dark,
/turf/template_noop,
/area/survivalpod/superpose/SmallCombatShip)
"u" = (
/obj/machinery/porta_turret/stationary/syndie{
	faction = "neutral"
	},
/turf/simulated/floor/plating/external,
/area/survivalpod/superpose/SmallCombatShip)
"w" = (
/obj/item/gps,
/obj/item/sticky_pad/random,
/obj/item/starcaster_news,
/obj/item/pen/blue,
/obj/item/pda,
/obj/item/card/id/external,
/obj/item/storage/mre/random,
/obj/item/storage/mre/random,
/obj/item/reagent_containers/food/drinks/cans/waterbottle,
/obj/item/reagent_containers/food/drinks/cans/waterbottle,
/obj/item/reagent_containers/food/snacks/sosjerky,
/obj/item/reagent_containers/food/snacks/sosjerky,
/obj/item/gun/energy/locked/phasegun/pistol,
/obj/item/material/knife/tacknife/survival,
/obj/item/clothing/accessory/permit/gun,
/obj/item/camera,
/obj/item/binoculars,
/obj/item/threadneedle,
/obj/random/soap,
/obj/item/towel/random,
/obj/item/bodybag/cryobag,
/obj/item/flashlight/flare,
/obj/item/flashlight/flare,
/obj/item/flashlight/color/yellow,
/obj/item/radio,
/obj/item/radio,
/obj/item/flame/lighter/random,
/obj/item/cell/device/hyper,
/obj/item/cell/device/hyper,
/obj/item/extinguisher/mini,
/obj/item/reagent_containers/glass/beaker/vial/tricordrazine,
/obj/item/reagent_containers/glass/beaker/vial/tricordrazine,
/obj/item/reagent_containers/pill/spaceacillin,
/obj/item/reagent_containers/pill/spaceacillin,
/obj/item/fbp_backup_cell,
/obj/item/fbp_backup_cell,
/obj/item/suit_cooling_unit/emergency,
/obj/item/stack/nanopaste,
/obj/item/reagent_containers/hypospray/autoinjector/biginjector/clotting,
/obj/item/storage/backpack/messenger,
/obj/item/clothing/accessory/storage/black_drop_pouches,
/obj/item/clothing/accessory/poncho/thermal,
/obj/item/storage/box/survival/comp,
/obj/item/storage/toolbox/brass,
/obj/item/storage/box/khcrystal,
/obj/structure/closet/walllocker_double/east,
/turf/simulated/floor/tiled/techfloor,
/area/survivalpod/superpose/SmallCombatShip)
"z" = (
/obj/structure/salvageable/server,
/turf/simulated/shuttle/floor/voidcraft,
/area/survivalpod/superpose/SmallCombatShip)
"A" = (
/obj/structure/shuttle/engine/heater,
/turf/simulated/wall/shull,
/area/survivalpod/superpose/SmallCombatShip)
"C" = (
/obj/structure/closet/walllocker_double/kitchen/east{
	name = "Ration Cabinet"
	},
/obj/item/storage/mre/random,
/obj/item/storage/mre/random,
/obj/item/storage/mre/random,
/obj/item/storage/mre/random,
/obj/item/storage/mre/random,
/obj/item/radio{
	pixel_x = -5;
	pixel_y = 5
	},
/obj/item/radio{
	pixel_x = -5;
	pixel_y = 5
	},
/obj/item/radio{
	pixel_x = 5;
	pixel_y = 5
	},
/obj/item/radio{
	pixel_x = 5;
	pixel_y = 5
	},
/obj/effect/floor_decal/techfloor{
	dir = 8
	},
/obj/structure/window/reinforced/survival_pod,
/turf/simulated/shuttle/floor/voidcraft,
/area/survivalpod/superpose/SmallCombatShip)
"D" = (
/obj/effect/floor_decal/techfloor{
	dir = 8
	},
/turf/simulated/shuttle/floor/voidcraft,
/area/survivalpod/superpose/SmallCombatShip)
"H" = (
/obj/machinery/portable_atmospherics/canister/phoron,
/obj/machinery/atmospherics/portables_connector{
	dir = 1
	},
/turf/simulated/floor/tiled/techfloor,
/area/survivalpod/superpose/SmallCombatShip)
"I" = (
/obj/machinery/disperser/middle{
	dir = 1
	},
/turf/template_noop,
/area/template_noop)
"J" = (
/obj/structure/salvageable/computer,
/turf/simulated/shuttle/floor/voidcraft,
/area/survivalpod/superpose/SmallCombatShip)
"L" = (
/obj/structure/window/reinforced/survival_pod{
	dir = 1
	},
/obj/structure/shuttle/engine/heater,
/turf/simulated/floor/plating/external,
/area/survivalpod/superpose/SmallCombatShip)
"M" = (
/obj/structure/bed/chair/bay/comfy/red{
	dir = 8
	},
/turf/simulated/floor/tiled/techfloor,
/area/survivalpod/superpose/SmallCombatShip)
"N" = (
/turf/template_noop,
/area/template_noop)
"O" = (
/obj/machinery/atmospherics/unary/engine{
	dir = 1
	},
/turf/template_noop,
/area/survivalpod/superpose/SmallCombatShip)
"Q" = (
/obj/machinery/disperser/back{
	dir = 1
	},
/obj/structure/ship_munition/disperser_charge/explosive,
/turf/simulated/wall/rshull,
/area/survivalpod/superpose/SmallCombatShip)
"U" = (
/obj/structure/bed/chair/bay/comfy/red{
	dir = 1
	},
/obj/machinery/door/window/survival_pod{
	dir = 2
	},
/turf/simulated/floor/tiled/techmaint,
/area/survivalpod/superpose/SmallCombatShip)
"W" = (
/obj/structure/window/plastitanium/full,
/obj/structure/window/reinforced/survival_pod{
	dir = 4
	},
/obj/structure/window/reinforced/survival_pod{
	dir = 8
	},
/obj/structure/window/reinforced/survival_pod{
	dir = 1
	},
/obj/structure/window/reinforced/survival_pod,
/obj/structure/grille/rustic{
	health = 25;
	name = "reinforced grille"
	},
/obj/machinery/door/blast/regular/open{
	dir = 4;
	id = "stargazer_blast";
	name = "window blast shield"
	},
/turf/simulated/shuttle/plating,
/area/survivalpod/superpose/SmallCombatShip)
"X" = (
/obj/structure/fans/hardlight/colorable{
	color = "red"
	},
/obj/machinery/door/airlock/hatch{
	req_one_access = null
	},
/turf/simulated/floor/plating/external,
/area/survivalpod/superpose/SmallCombatShip)
"Y" = (
/obj/effect/floor_decal/techfloor{
	dir = 4
	},
/turf/simulated/shuttle/floor/voidcraft,
/area/survivalpod/superpose/SmallCombatShip)
"Z" = (
/obj/fiftyspawner/glass,
/obj/fiftyspawner/glass,
/obj/fiftyspawner/glass,
/obj/fiftyspawner/glass,
/obj/fiftyspawner/glass,
/obj/fiftyspawner/steel,
/obj/fiftyspawner/steel,
/obj/fiftyspawner/steel,
/obj/fiftyspawner/steel,
/obj/fiftyspawner/steel,
/obj/fiftyspawner/plastic,
/obj/fiftyspawner/plastic,
/obj/fiftyspawner/plastic,
/obj/fiftyspawner/plastic,
/obj/fiftyspawner/plastic,
/obj/structure/table/rack/shelf/steel,
/turf/simulated/floor/tiled/techmaint,
/area/survivalpod/superpose/SmallCombatShip)

(1,1,1) = {"
N
N
m
m
m
N
u
N
a
a
a
"}
(2,1,1) = {"
N
d
I
Q
m
W
a
a
a
A
O
"}
(3,1,1) = {"
N
m
W
m
l
g
w
H
L
O
N
"}
(4,1,1) = {"
m
m
J
s
Y
Y
a
a
a
h
N
"}
(5,1,1) = {"
N
W
o
U
f
Z
a
h
h
t
N
"}
(6,1,1) = {"
m
m
z
C
D
q
a
X
a
h
N
"}
(7,1,1) = {"
N
m
W
m
M
g
g
g
L
O
N
"}
(8,1,1) = {"
N
d
I
Q
m
W
a
a
a
A
O
"}
(9,1,1) = {"
N
N
m
m
m
N
u
N
a
a
a
"}
