"as" = (/obj/machinery/atmospherics/pipe/simple/hidden{dir = 4},/turf/simulated/floor/tiled/steel_dirty,/area/survivalpod)
"at" = (/obj/structure/table/reinforced,/obj/machinery/cell_charger,/turf/simulated/floor/tiled/asteroid_steel,/area/survivalpod)
"ay" = (/obj/structure/cable/green{d1 = 1; d2 = 2; icon_state = "1-2"},/turf/simulated/floor/plating/external,/area/survivalpod)
"aJ" = (/obj/structure/reagent_dispensers/fueltank/high,/turf/simulated/floor/plating/external,/area/survivalpod)
"aR" = (/obj/machinery/exonet_node/map,/turf/simulated/floor/tiled/asteroid_steel,/area/survivalpod)
"bg" = (/obj/structure/table/rack/shelf/steel,/obj/item/mecha_parts/mecha_equipment/combat_shield,/obj/item/mecha_parts/mecha_equipment/repair_droid,/obj/item/mecha_parts/mecha_equipment/tool/sleeper,/obj/item/mecha_parts/mecha_equipment/weapon/ballistic/mortar,/obj/item/mecha_parts/mecha_equipment/weapon/energy/flamer/rigged,/turf/simulated/floor/plating/external,/area/space)
"bv" = (/obj/mecha/working/hoverpod/shuttlecraft{dir = 8},/turf/space,/area/space)
"bK" = (/obj/item/weapon/reagent_containers/food/snacks/syndicake,/turf/simulated/floor/plating/external,/area/space)
"db" = (/obj/machinery/atmospherics/pipe/manifold/hidden,/turf/simulated/floor/tiled/asteroid_steel,/area/survivalpod)
"di" = (/obj/machinery/fusion_fuel_compressor,/turf/simulated/floor/tiled/asteroid_steel,/area/survivalpod)
"dn" = (/obj/machinery/atmospherics/unary/vent_pump/on{dir = 1},/turf/simulated/floor/tiled/techfloor/grid,/area/survivalpod)
"eh" = (/obj/machinery/atmospherics/pipe/simple/hidden{dir = 5},/obj/random/maintenance/engineering,/turf/simulated/floor/plating/external,/area/survivalpod)
"eS" = (/obj/machinery/feeder,/turf/simulated/floor/tiled/asteroid_steel,/area/survivalpod)
"eT" = (/obj/structure/table/rack/shelf/steel,/obj/item/mecha_parts/mecha_equipment/cloak,/obj/item/mecha_parts/mecha_equipment/tool/jetpack,/obj/item/mecha_parts/mecha_equipment/tool/passenger,/turf/simulated/floor/plating/external,/area/space)
"fB" = (/turf/simulated/wall/skipjack,/area/space)
"fO" = (/obj/machinery/atmospherics/pipe/simple/hidden{dir = 9},/turf/simulated/floor/tiled/asteroid_steel,/area/survivalpod)
"fR" = (/obj/machinery/atmospherics/unary/vent_pump/on,/turf/simulated/floor/tiled/steel_dirty,/area/survivalpod)
"ht" = (/obj/mecha/working/hoverpod/combatpod{dir = 8},/turf/space,/area/space)
"hz" = (/obj/machinery/atmospherics/unary/vent_pump/on,/turf/simulated/floor/tiled/asteroid_steel,/area/survivalpod)
"hK" = (/obj/structure/table/steel_reinforced,/obj/item/weapon/storage/briefcase/inflatable{pixel_y = 3},/obj/item/weapon/storage/toolbox/electrical,/turf/simulated/floor/tiled/asteroid_steel,/area/survivalpod)
"hQ" = (/obj/structure/salvageable/console_os{dir = 4},/turf/simulated/floor/tiled/asteroid_steel,/area/survivalpod)
"hR" = (/turf/space,/area/space)
"hW" = (/obj/machinery/atmospherics/binary/passive_gate{dir = 8; regulate_mode = 0; unlocked = 1},/turf/simulated/floor/plating/external,/area/survivalpod)
"ic" = (/obj/structure/closet/walllocker_double/kitchen/north{dir = 8; name = "Ration Cabinet"; pixel_x = -32; pixel_y = 0},/obj/item/weapon/storage/mre/random,/obj/item/weapon/storage/mre/random,/obj/item/weapon/storage/mre/random,/obj/item/weapon/storage/mre/random,/obj/item/weapon/storage/mre/random,/obj/item/device/radio{pixel_x = -5; pixel_y = 5},/obj/item/device/radio{pixel_x = 5; pixel_y = 5},/obj/machinery/atmospherics/pipe/simple/hidden,/turf/simulated/floor/tiled/steel_dirty,/area/survivalpod)
"in" = (/obj/machinery/atmospherics/pipe/simple/hidden{dir = 6},/obj/item/weapon/tank/emergency/oxygen/double,/obj/item/weapon/tank/emergency/oxygen/double,/obj/item/weapon/tank/emergency/oxygen/double,/obj/item/weapon/tank/emergency/oxygen/double,/obj/item/weapon/tank/emergency/oxygen/double{pixel_y = 6},/obj/item/weapon/tank/emergency/oxygen/double{pixel_y = 6},/obj/item/weapon/tank/emergency/oxygen/double{pixel_y = 6},/obj/item/weapon/tank/emergency/oxygen/double{pixel_y = 6},/obj/item/weapon/tank/emergency/oxygen/double{pixel_y = 6},/obj/structure/table/rack/shelf/steel,/turf/simulated/floor/tiled/steel_dirty,/area/survivalpod)
"iP" = (/obj/machinery/artifact_scanpad,/obj/effect/simple_portal/linked,/obj/effect/map_effect/interval/effect_emitter/sparks,/turf/simulated/floor/tiled/techfloor,/area/survivalpod)
"iV" = (/obj/machinery/atmospherics/pipe/simple/hidden{dir = 4},/turf/simulated/floor/tiled/asteroid_steel,/area/survivalpod)
"iW" = (/obj/machinery/atmospherics/pipe/manifold/hidden{dir = 8},/turf/simulated/floor/tiled/steel_dirty,/area/survivalpod)
"iZ" = (/obj/machinery/vending/tool{emagged = 1},/turf/simulated/floor/tiled/steel_dirty,/area/survivalpod)
"jy" = (/obj/structure/table/rack/shelf/steel,/obj/item/mecha_parts/component/hull/lightweight,/obj/item/mecha_parts/mecha_equipment/weapon/ballistic/scattershot,/obj/item/mecha_parts/mecha_equipment/weapon/phoron_bore,/obj/item/mecha_parts/mecha_equipment/weapon/energy/taser/rigged,/turf/simulated/floor/plating/external,/area/space)
"jJ" = (/obj/machinery/atmospherics/pipe/simple/hidden{dir = 4},/obj/machinery/door/airlock/maintenance/rnd{req_one_access = null},/turf/simulated/floor/plating/external,/area/survivalpod)
"jP" = (/obj/machinery/atmospherics/pipe/simple/hidden{dir = 4},/obj/machinery/alarm/alarms_hidden{dir = 1; pixel_y = -22},/turf/simulated/floor/plating/external,/area/survivalpod)
"kc" = (/obj/structure/window/reinforced/survival_pod{dir = 4},/obj/machinery/atmospherics/binary/circulator{anchored = 1},/turf/simulated/floor/tiled/techfloor/grid,/area/survivalpod)
"ke" = (/obj/machinery/atmospherics/valve{dir = 8},/obj/structure/dispenser{phorontanks = 0},/turf/simulated/floor/plating/external,/area/survivalpod)
"kv" = (/obj/mecha/combat/fighter/pinnace{dir = 8},/turf/space,/area/space)
"kP" = (/obj/machinery/fitness/heavy/lifter,/turf/simulated/floor/tiled/asteroid_steel,/area/survivalpod)
"kU" = (/obj/machinery/atmospherics/pipe/simple/hidden,/turf/simulated/floor/plating/external,/area/survivalpod)
"kV" = (/obj/item/weapon/bedsheet/piratedouble,/obj/structure/curtain/black{icon_state = "open"; layer = 2; name = "privacy curtain"; opacity = 0},/turf/simulated/floor/wood/sif,/area/survivalpod)
"ll" = (/turf/simulated/floor/tiled/techfloor/grid,/area/survivalpod)
"lp" = (/obj/machinery/atmospherics/pipe/simple/hidden{dir = 4},/obj/machinery/alarm/alarms_hidden{pixel_y = 22},/obj/random/maintenance,/turf/simulated/floor/tiled/asteroid_steel,/area/survivalpod)
"lw" = (/obj/structure/cable/green{d1 = 1; d2 = 4; icon_state = "1-4"},/turf/simulated/floor/plating/external,/area/survivalpod)
"lR" = (/obj/machinery/atmospherics/unary/vent_pump/on{dir = 1},/turf/simulated/floor/tiled/asteroid_steel,/area/survivalpod)
"mc" = (/obj/structure/closet/crate/large,/obj/fiftyspawner/steel,/obj/item/stack/material/plasteel{amount = 30},/obj/item/stack/material/phoron{amount = 25},/obj/item/stack/material/glass/phoronrglass{amount = 20},/obj/fiftyspawner/steel,/turf/simulated/floor/tiled/asteroid_steel,/area/survivalpod)
"mX" = (/obj/machinery/atmospherics/pipe/simple/hidden{dir = 6},/turf/simulated/floor/plating/external,/area/survivalpod)
"og" = (/turf/simulated/wall/skipjack,/area/survivalpod)
"oq" = (/obj/random/maintenance/engineering,/turf/simulated/floor/tiled/techfloor/grid,/area/survivalpod)
"oS" = (/obj/machinery/atmospherics/pipe/manifold/hidden{dir = 1},/obj/random/junk,/turf/simulated/floor/tiled/steel_dirty,/area/survivalpod)
"pO" = (/obj/structure/window/reinforced/survival_pod,/obj/structure/window/reinforced/survival_pod{dir = 4},/obj/machinery/ion_engine,/turf/simulated/floor/tiled/techfloor/grid,/area/survivalpod)
"pT" = (/obj/machinery/atmospherics/pipe/simple/hidden{dir = 9},/obj/machinery/gear_dispenser/suit_old,/turf/simulated/floor/plating/external,/area/survivalpod)
"pY" = (/obj/machinery/mech_recharger,/obj/effect/floor_decal/industrial/outline/yellow,/obj/mecha/combat/gygax/old,/turf/simulated/floor/tiled/techmaint,/area/survivalpod)
"qW" = (/obj/machinery/door/airlock/maintenance/int,/obj/structure/fans/hardlight,/turf/simulated/floor/plating/external,/area/survivalpod)
"ra" = (/obj/machinery/door/window/survival_pod{dir = 8},/turf/simulated/floor/tiled/techfloor,/area/survivalpod)
"rV" = (/obj/random/junk,/obj/random/maintenance,/turf/simulated/floor/tiled/asteroid_steel,/area/survivalpod)
"tl" = (/obj/machinery/robotic_fabricator,/turf/simulated/floor/tiled/asteroid_steel,/area/survivalpod)
"tH" = (/obj/machinery/power/port_gen/pacman,/obj/structure/cable,/turf/simulated/floor/plating/external,/area/survivalpod)
"us" = (/obj/machinery/atmospherics/pipe/manifold/hidden,/obj/random/junk,/turf/simulated/floor/plating/external,/area/survivalpod)
"uK" = (/obj/machinery/icecream_vat,/turf/simulated/floor/tiled/asteroid_steel,/area/survivalpod)
"vf" = (/obj/structure/cryofeed{dir = 1},/obj/structure/window/reinforced/survival_pod{dir = 1},/obj/structure/window/reinforced/survival_pod{dir = 4},/turf/simulated/floor/tiled/techfloor/grid,/area/survivalpod)
"vl" = (/obj/machinery/power/smes/buildable/hybrid,/obj/structure/cable/green{d2 = 8; icon_state = "0-8"},/turf/simulated/floor/plating/external,/area/survivalpod)
"vZ" = (/obj/machinery/atmospherics/unary/vent_pump/on,/obj/machinery/alarm/alarms_hidden{dir = 4; pixel_x = -22},/turf/simulated/floor/tiled/asteroid_steel,/area/survivalpod)
"wn" = (/obj/structure/salvageable/console_os{dir = 4},/turf/simulated/floor/tiled/steel_dirty,/area/survivalpod)
"wy" = (/obj/structure/window/reinforced/survival_pod{dir = 1},/obj/structure/window/reinforced/survival_pod{dir = 4},/obj/structure/cryofeed{dir = 1},/turf/simulated/floor/tiled/techfloor/grid,/area/survivalpod)
"xh" = (/obj/machinery/atmospherics/pipe/simple/hidden{dir = 9},/obj/random/maintenance,/turf/simulated/floor/tiled/asteroid_steel,/area/survivalpod)
"xn" = (/obj/structure/table/rack/shelf/steel,/obj/item/mecha_parts/mecha_equipment/anticcw_armor_booster,/obj/item/mecha_parts/mecha_equipment/repair_droid,/obj/item/mecha_parts/mecha_equipment/tool/passenger,/obj/item/mecha_parts/mecha_equipment/weapon/ballistic/missile_rack/grenade/clusterbang,/turf/simulated/floor/plating/external,/area/space)
"xq" = (/obj/random/maintenance/engineering,/turf/simulated/floor/tiled/asteroid_steel,/area/survivalpod)
"xt" = (/obj/structure/salvageable/bliss,/turf/simulated/floor/tiled/asteroid_steel,/area/survivalpod)
"yo" = (/obj/machinery/atmospherics/pipe/simple/hidden{dir = 5},/obj/structure/table/steel_reinforced,/obj/item/weapon/storage/briefcase/inflatable{pixel_y = 3},/obj/item/weapon/storage/toolbox/mechanical,/obj/item/pizzavoucher,/turf/simulated/floor/tiled/steel_dirty,/area/survivalpod)
"yr" = (/obj/structure/table/reinforced,/turf/simulated/floor/tiled/asteroid_steel,/area/survivalpod)
"yG" = (/obj/structure/table/rack/shelf/steel,/obj/item/mecha_parts/component/gas/reinforced,/obj/item/mecha_parts/mecha_equipment/hardpoint_actuator,/obj/item/mecha_parts/mecha_equipment/tesla_energy_relay,/obj/item/mecha_parts/mecha_equipment/weapon/ballistic/cannon,/obj/item/mecha_parts/mecha_equipment/weapon/ballistic/missile_rack/grenade/rigged,/obj/item/mecha_parts/mecha_equipment/wormhole_generator,/turf/simulated/floor/plating/external,/area/space)
"yV" = (/obj/random/junk,/turf/simulated/floor/plating/external,/area/survivalpod)
"zk" = (/obj/machinery/mech_recharger,/obj/effect/floor_decal/industrial/outline/yellow,/obj/mecha/combat/marauder/seraph,/turf/simulated/floor/tiled/techmaint,/area/survivalpod)
"zv" = (/obj/structure/curtain/black{icon_state = "open"; layer = 2; name = "privacy curtain"; opacity = 0},/turf/simulated/floor/wood/sif,/area/survivalpod)
"zA" = (/obj/random/maintenance,/turf/simulated/floor/tiled/steel_dirty,/area/survivalpod)
"Ap" = (/obj/machinery/atmospherics/pipe/simple/hidden,/turf/simulated/floor/tiled/steel_dirty,/area/survivalpod)
"Aq" = (/obj/mecha/combat/fighter/allure{dir = 8},/turf/space,/area/space)
"At" = (/obj/structure/closet/secure_closet/engineering_electrical{req_access = null},/obj/random/maintenance,/obj/random/maintenance,/turf/simulated/floor/plating/external,/area/survivalpod)
"Aw" = (/obj/machinery/portable_atmospherics/canister/phoron,/turf/simulated/floor/plating/external,/area/survivalpod)
"AF" = (/obj/machinery/atmospherics/pipe/manifold/hidden{dir = 4},/turf/simulated/floor/plating/external,/area/survivalpod)
"AU" = (/obj/vehicle/boat/dragon/sifwood{dir = 8},/obj/structure/lattice,/turf/space,/area/space)
"Bh" = (/obj/machinery/mech_recharger,/obj/effect/floor_decal/industrial/outline/yellow,/obj/structure/loot_pile/mecha/gygax/dark/adv,/turf/simulated/floor/tiled/techmaint,/area/survivalpod)
"BF" = (/obj/random/maintenance/engineering,/turf/simulated/floor/plating/external,/area/survivalpod)
"Cd" = (/obj/structure/table/reinforced,/turf/simulated/floor/tiled/steel_dirty,/area/survivalpod)
"CC" = (/obj/structure/cable{d1 = 2; d2 = 8; icon_state = "2-8"},/turf/simulated/floor/plating/external,/area/survivalpod)
"CI" = (/obj/machinery/atmospherics/pipe/simple/hidden,/turf/simulated/floor/tiled/asteroid_steel,/area/survivalpod)
"Dg" = (/obj/structure/closet/secure_closet/engineering_welding{req_access = null},/obj/random/maintenance,/turf/simulated/floor/tiled/steel_dirty,/area/survivalpod)
"DD" = (/obj/machinery/atmospherics/unary/vent_pump/on,/turf/simulated/floor/tiled/techfloor/grid,/area/survivalpod)
"DN" = (/obj/machinery/floorlayer,/turf/simulated/floor/tiled/asteroid_steel,/area/survivalpod)
"Ef" = (/obj/machinery/power/terminal,/obj/structure/cable{d2 = 4; icon_state = "0-4"},/turf/simulated/floor/plating/external,/area/survivalpod)
"Eu" = (/obj/random/maintenance,/obj/random/maintenance/engineering,/turf/simulated/floor/tiled/steel_dirty,/area/survivalpod)
"Ew" = (/obj/machinery/atmospherics/pipe/simple/hidden{dir = 4},/turf/simulated/floor/plating/external,/area/survivalpod)
"Gj" = (/obj/machinery/mech_recharger,/obj/effect/floor_decal/industrial/outline/yellow,/obj/structure/loot_pile/mecha/odysseus/murdysseus,/turf/simulated/floor/tiled/techmaint,/area/survivalpod)
"Hb" = (/obj/structure/table/rack/shelf/steel,/obj/item/mecha_parts/mecha_equipment/generator/nuclear,/obj/item/mecha_parts/mecha_equipment/weapon/ballistic/missile_rack/explosive/rigged,/obj/item/mecha_parts/mecha_equipment/weapon/energy/ion/rigged,/turf/simulated/floor/plating/external,/area/space)
"HR" = (/obj/structure/window/reinforced/survival_pod{dir = 1},/obj/machinery/field_generator{anchored = 1; state = 1},/turf/simulated/floor/tiled/techfloor,/area/survivalpod)
"Ii" = (/obj/effect/floor_decal/industrial/outline/blue,/obj/structure/closet/jcloset,/obj/item/weapon/mop,/obj/structure/mopbucket,/obj/item/weapon/reagent_containers/glass/bucket,/obj/item/weapon/reagent_containers/spray/cleaner,/obj/item/weapon/reagent_containers/spray/cleaner,/turf/simulated/floor/tiled/steel_dirty,/area/survivalpod)
"IK" = (/obj/effect/wingrille_spawn/reinforced,/turf/simulated/floor/plating/external,/area/survivalpod)
"Jn" = (/obj/machinery/sleeper{dir = 4},/turf/simulated/floor/tiled/asteroid_steel,/area/survivalpod)
"JC" = (/obj/structure/window/reinforced/survival_pod,/obj/structure/window/reinforced/survival_pod{dir = 8},/turf/simulated/floor/tiled/techfloor,/area/survivalpod)
"JD" = (/obj/machinery/vending/engivend{emagged = 1},/turf/simulated/floor/tiled/asteroid_steel,/area/survivalpod)
"JX" = (/obj/structure/closet/walllocker_double/kitchen/north{dir = 8; name = "Ration Cabinet"; pixel_x = -32; pixel_y = 0},/obj/item/weapon/storage/mre/random,/obj/item/weapon/storage/mre/random,/obj/item/weapon/storage/mre/random,/obj/item/weapon/storage/mre/random,/obj/item/weapon/storage/mre/random,/obj/item/device/radio{pixel_x = -5; pixel_y = 5},/obj/item/device/radio{pixel_x = 5; pixel_y = 5},/turf/simulated/floor/tiled/steel_dirty,/area/survivalpod)
"KB" = (/obj/structure/table/rack/shelf/steel,/obj/item/mecha_parts/component/armor/alien,/obj/item/mecha_parts/mecha_equipment/crisis_drone/rad,/obj/item/mecha_parts/mecha_equipment/tool/passenger,/obj/item/mecha_parts/mecha_equipment/weapon/ballistic/lmg/rigged,/obj/item/mecha_parts/mecha_equipment/weapon/energy/laser/heavy/rigged,/obj/item/mecha_parts/mecha_equipment/weapon/energy/medigun,/turf/simulated/floor/plating/external,/area/space)
"KD" = (/turf/simulated/floor/plating/external,/area/survivalpod)
"KS" = (/obj/machinery/sleep_console{dir = 4},/turf/simulated/floor/tiled/asteroid_steel,/area/survivalpod)
"Le" = (/obj/structure/reagent_dispensers/watertank/high,/turf/simulated/floor/plating/external,/area/survivalpod)
"Lf" = (/obj/random/maintenance/engineering,/obj/structure/bed/chair{dir = 8},/turf/simulated/floor/tiled/asteroid_steel,/area/survivalpod)
"Lu" = (/obj/machinery/power/shield_generator/charged,/turf/simulated/floor/tiled/asteroid_steel,/area/survivalpod)
"LY" = (/obj/machinery/atmospherics/pipe/simple/hidden,/obj/machinery/door/airlock/maintenance/engi{req_one_access = null},/turf/simulated/floor/plating/external,/area/survivalpod)
"Nf" = (/obj/structure/table/rack/shelf/steel,/obj/item/mecha_parts/component/armor/military,/obj/item/mecha_parts/component/gas/reinforced,/obj/item/mecha_parts/mecha_equipment/omni_shield,/obj/item/mecha_parts/mecha_equipment/tool/jetpack,/obj/item/mecha_parts/mecha_equipment/tool/passenger,/obj/item/mecha_parts/mecha_equipment/weapon/ballistic/cannon,/turf/simulated/floor/plating/external,/area/space)
"Ni" = (/obj/structure/salvageable/server,/turf/simulated/floor/plating/external,/area/survivalpod)
"NA" = (/obj/machinery/alarm/alarms_hidden{dir = 4; pixel_x = -22},/obj/item/pizzavoucher,/turf/simulated/floor/tiled/asteroid_steel,/area/survivalpod)
"NT" = (/obj/machinery/door/airlock/maintenance/common,/turf/simulated/floor/plating/external,/area/survivalpod)
"NX" = (/obj/structure/bed/double/padded,/obj/item/weapon/bedsheet/rainbowdouble,/obj/machinery/partyalarm{pixel_y = -18},/turf/simulated/floor/wood/sif,/area/survivalpod)
"ON" = (/obj/machinery/alarm/alarms_hidden{dir = 8; pixel_x = 22},/obj/machinery/holoplant,/turf/simulated/floor/tiled/asteroid_steel,/area/survivalpod)
"Pc" = (/obj/machinery/door/airlock/maintenance/engi{req_one_access = null},/turf/simulated/floor/plating/external,/area/survivalpod)
"PV" = (/obj/mecha/combat/fighter/baron{dir = 8},/turf/space,/area/space)
"Qh" = (/obj/machinery/portable_atmospherics/canister/air,/turf/simulated/floor/plating/external,/area/survivalpod)
"Qn" = (/obj/machinery/telecomms/allinone,/turf/simulated/floor/tiled/asteroid_steel,/area/survivalpod)
"QC" = (/obj/machinery/mech_recharger,/obj/effect/floor_decal/industrial/outline/yellow,/obj/structure/loot_pile/mecha/phazon,/turf/simulated/floor/tiled/techmaint,/area/survivalpod)
"QF" = (/obj/structure/window/reinforced/survival_pod{dir = 1},/obj/structure/window/reinforced/survival_pod{dir = 8},/turf/simulated/floor/tiled/techfloor,/area/survivalpod)
"QV" = (/obj/random/junk,/turf/simulated/floor/tiled/asteroid_steel,/area/survivalpod)
"Rh" = (/turf/simulated/floor/tiled/steel_dirty,/area/survivalpod)
"Rp" = (/obj/machinery/atmospherics/unary/vent_pump/on{dir = 1},/obj/machinery/alarm/alarms_hidden{dir = 4; pixel_x = -22},/turf/simulated/floor/tiled/asteroid_steel,/area/survivalpod)
"Rt" = (/obj/structure/cable/green{d2 = 4; icon_state = "0-4"},/obj/machinery/power/apc/alarms_hidden{dir = 8; pixel_x = -24},/turf/simulated/floor/plating/external,/area/survivalpod)
"Rv" = (/obj/mecha/combat/fighter/gunpod{dir = 8},/turf/space,/area/space)
"RP" = (/obj/random/maintenance,/turf/simulated/floor/tiled/asteroid_steel,/area/survivalpod)
"Sb" = (/obj/structure/curtain/black{icon_state = "open"; layer = 2; name = "privacy curtain"; opacity = 0},/turf/simulated/floor/wood/sif/broken,/area/survivalpod)
"So" = (/obj/machinery/atmospherics/pipe/simple/hidden{dir = 4},/obj/machinery/door/airlock/maintenance/common,/turf/simulated/floor/plating/external,/area/survivalpod)
"SF" = (/obj/effect/wingrille_spawn/reinforced,/obj/structure/fans/hardlight,/turf/simulated/floor/plating/external,/area/survivalpod)
"SU" = (/obj/machinery/portable_atmospherics/canister/air,/obj/machinery/atmospherics/portables_connector,/turf/simulated/floor/plating/external,/area/survivalpod)
"Uc" = (/turf/simulated/floor/plating/external,/area/space)
"Um" = (/obj/structure/window/reinforced/survival_pod,/obj/machinery/field_generator{anchored = 1; state = 1},/turf/simulated/floor/tiled/techfloor,/area/survivalpod)
"Us" = (/obj/random/cash/huge,/turf/simulated/floor/plating/external,/area/space)
"UR" = (/obj/machinery/mech_recharger,/obj/effect/floor_decal/industrial/outline/yellow,/obj/structure/loot_pile/mecha/durand,/turf/simulated/floor/tiled/techmaint,/area/survivalpod)
"UY" = (/obj/machinery/atmospherics/unary/vent_pump/on{dir = 4},/obj/random/maintenance,/turf/simulated/floor/tiled/steel_dirty,/area/survivalpod)
"Vj" = (/obj/vehicle/boat{dir = 8},/obj/structure/lattice,/turf/space,/area/space)
"VB" = (/obj/structure/closet/walllocker_double/kitchen/north{dir = 8; name = "Ration Cabinet"; pixel_x = -32; pixel_y = 0},/obj/item/weapon/storage/mre/random,/obj/item/weapon/storage/mre/random,/obj/item/weapon/storage/mre/random,/obj/item/weapon/storage/mre/random,/obj/item/weapon/storage/mre/random,/obj/item/device/radio{pixel_x = -5; pixel_y = 5},/obj/item/device/radio{pixel_x = 5; pixel_y = 5},/turf/simulated/floor/plating/external,/area/survivalpod)
"VI" = (/obj/machinery/mech_recharger,/obj/effect/floor_decal/industrial/outline/yellow,/obj/structure/loot_pile/mecha/marauder/mauler,/turf/simulated/floor/tiled/techmaint,/area/survivalpod)
"VS" = (/obj/machinery/autolathe{hacked = 1; name = "hacked autolathe"},/turf/simulated/floor/tiled/asteroid_steel,/area/survivalpod)
"Xl" = (/obj/structure/lattice,/turf/space,/area/space)
"Xq" = (/obj/structure/bed/double/padded,/turf/simulated/floor/wood/sif/broken,/area/survivalpod)
"Xv" = (/obj/machinery/atmospherics/pipe/simple/hidden{dir = 10},/turf/simulated/floor/tiled/asteroid_steel,/area/survivalpod)
"XC" = (/obj/structure/table/steel_reinforced,/obj/item/weapon/storage/briefcase/inflatable{pixel_y = 3},/obj/item/weapon/storage/toolbox/syndicate/powertools,/turf/simulated/floor/tiled/asteroid_steel,/area/survivalpod)
"XD" = (/obj/machinery/atmospherics/pipe/tank/air,/turf/simulated/floor/plating/external,/area/survivalpod)
"XH" = (/obj/machinery/mech_recharger,/obj/effect/floor_decal/industrial/outline/yellow,/obj/mecha/combat/durand/old,/turf/simulated/floor/tiled/techmaint,/area/survivalpod)
"XT" = (/obj/structure/cable/green{d1 = 2; d2 = 8; icon_state = "2-8"},/turf/simulated/floor/plating/external,/area/survivalpod)
"Yt" = (/turf/simulated/floor/tiled/asteroid_steel,/area/survivalpod)
"Zd" = (/obj/random/maintenance/security,/obj/structure/table/reinforced,/turf/simulated/floor/tiled/steel_dirty,/area/survivalpod)
"Zt" = (/obj/structure/table/reinforced,/obj/machinery/alarm/alarms_hidden{pixel_y = 22},/obj/machinery/cell_charger,/turf/simulated/floor/tiled/steel_dirty,/area/survivalpod)

(1,1,1) = {"
hRhRhRhRhRhRhRhRhRhRhRhRhRhRhRhRhRhRhRhRhRhRhRhRhRhRhRhRhRhRhRhRhRhRhRhRhRhRhR
hRhRhRhRhRhRhRhRhRhRhRhRhRhRhRhRhRhRhRhRXlhRhRhRhRhRhRhRhRhRhRhRhRhRhRhRhRhRhR
hRhRhRhRhRhRhRhRhRhRhRhRhRhRhRhRhRhRhRhRXlhRhRhRhRhRhRhRhRhRhRhRhRhRhRhRhRhRhR
hRhRhRhRhRhRhRhRhRhRhRhRhRhRhRhRhRhRhRhRhRhRhRhRhRhRhRhRhRhRhRhRhRhRhRhRhRhRhR
hRhRhRhRhRhRhRhRhRhRhRhRhRhRhRhRhRhRhRhRXlhRhRhRhRhRhRhRhRhRhRhRhRhRhRhRhRhRhR
hRhRhRhRhRhRhRhRhRhRhRhRhRhRhRhRhRhRhRXlXlXlXlhRhRhRhRhRhRhRXlhRhRhRhRhRhRhRhR
hRhRhRhRhRhRhRhRhRhRhRhRhRhRhRhRhRhRhRhRXlhRhRhRhRhRhRhRhRhRhRhRhRhRhRhRhRhRhR
hRhRhRhRhRhRhRhRhRhRhRhRhRhRhRhRhRhRhRhRXlhRhRhRhRhRhRhRhRhRXlhRhRhRhRhRhRhRhR
hRhRhRhRhRhRhRhRhRhRhRhRhRhRhRhRhRhRhRhRXlhRhRhRhRhRhRhRhRhRXlhRhRhRhRhRhRhRhR
hRhRhRhRhRhRhRhRhRhRhRhRhRhRhRhRhRhRhRhRXlhRhRhRhRhRhRhRhRhRXlhRhRhRhRhRhRhRhR
hRhRhRhRhRhRhRhRhRhRhRhRhRhRhRhRhRhRhRXlXlXlXlXlXlXlhRhRhRhRXlXlhRhRhRhRhRhRhR
hRhRhRhRhRhRhRhRhRhRhRhRhRhRhRhRhRhRhRXlUcUcUcUcUchRUcUcUcUcUcUchRhRhRhRhRhRhR
hRhRhRhRhRhRhRhRhRhRhRhRhRhRhRhRhRhRhRXlUchRUcUcUchRUcUcUchRhRUchRhRUchRhRhRhR
hRhRhRhRhRhRhRhRhRhRhRhRhRhRhRhRhRhRhRXlUchRhRUcUshRUcUcbKUcUcUchRUcUchRhRhRhR
hRhRhRhRhRhRhRhRhRhRhRXlXlXlhRXlXlXlXlXlUchRhRUcUcXlhRhRXlhRhRhRhRhRhRhRhRhRhR
hRhRhRhRhRhRhRhRhRhRhRhRhRhRhRhRhRhRhRXlUchRhRhRUcXlUcUcXlhRUcUchRhRhRhRhRhRhR
hRhRhRhRhRhRhRhRhRhRhRhRhRhRhRhRhRhRhRhRUcUchRhRUcXlUcUcXlhRUcUchRhRhRhRhRhRhR
hRhRhRhRXlhRhRhRhRhRhRhRhRhRhRhRhRhRhRXlUcUcUcUcUcXlUcUcXlhRUchRhRUcUchRhRhRhR
hRhRhRhRXlhRhRhRhRhRhRhRhRhRhRhRhRhRhRXlhRXlhRUcUcUchRhRhRhRhRhRhRUcUchRhRhRhR
hRhRhRXlXlXlXlXlXlhRhRXlXlXlXlXlXlXlhRhRhRhRhRUcUcUchRhRhRXlUcUcUcXlXlXlXlXlXl
hRhRhRhRhRhRhRhRfBfBfBfBfBfBfBfBfBfBfBfBfBhRhRUchRhRhRXlhRhRUcUcUchRUcUcUchRhR
hRhRhRhRhRhRhRhRVjUcUcUcUcUcUcUcKBbgNfjyogogSFogogogSFSFSFogogogogogogogoghRXl
hRhRhRhRhRhRhRhRhRhRhRhRhRhRhRUcUcUcUcUcogURKDQCKDogAwQhSUXDogDgYtQFHRwyogUcXl
hRhRhRhRhRhRhRhRhRhRhRhRhRbvhRUcogogogogogpYKDXHKDogAwKDehAFogAtYtraiPkcogUcXl
hRhRhRhRhRhRhRhRhRhRXlXlXlXlXlUcogllDDllogBhKDGjBFogmXhWkepTogJXYtJCUmpOoghRXl
hRhRhRhRhRhRhRhRhRhRhRhRhRhRhRUcqWlllloqqWRhRhhzxqogLYIKIKIKogvZyVKDRhRhogXlXl
hRhRhRhRhRhRhRhRhRhRhRhRhRkvhRUcogogIKogoghKXCyoaslpusiVasoSjJxhRhRheSuKogUcXl
hRhRhRhRhRhRhRhRhRhRXlXlXlXlXlUcogaRxtQnogogIKIKogogogogogCIogogIKogogogogUcXl
hRhRhRhRhRhRhRhRhRhRhRhRhRhRhRUcSFCdYtRhIKKSJnzAZtatVSmcogkUogYtYtYtRPDNogUchR
hRhRhRhRhRhRhRhRhRhRhRhRhRRvhRUcSFhQLfyVNTYtKDBFRPxqUYiVSoAFIKfRRhQFHRvfogXlhR
hRhRhRhRhRhRhRhRhRhRXlXlXlXlXlUcSFNiRhYtIKKDQVQVQVQVRhYtogCIogicKDraiPkcogXlhR
hRhRhRhRhRhRhRhRhRhRhRhRhRhRhRUcSFwnEuONogzvogSbogzvogkVogiWjJfOQVJCUmpOoghRXl
hRhRhRhRhRhRhRhRhRhRhRhRhRPVhRUcSFZdxqYtogXqogNXogXqogXqogCIogNAYtYtYtdiogUcXl
hRhRhRhRhRhRhRhRhRhRXlXlXlXlXlUcogyrRhtlogogogogogogogogogApogogIKogogogogUcXl
hRhRhRhRhRhRhRhRhRhRhRhRhRhRhRUcogogIKogogJDiZinEwjPasEwasdbjJXvYtkPYtkPogUcXl
hRhRhRhRhRhRhRhRhRhRhRhRhRAqhRUcqWllllllqWRhRhlRYtogIKIKIKPcogRprVYtzAKDoghRXl
hRhRhRhRhRhRhRhRhRhRXlXlXlXlXlUcoglldnllogVIKDBhKDogRtXTKDKDogVBYtQFHRvfogUcXl
hRhRhRhRhRhRhRhRhRhRhRhRhRhtXlUcogogogogogXHBFGjKDogLeayEfCCogLuKDraiPkcogUcXl
hRhRhRhRhRhRhRhRhRAUXlXlXlXlXlUcyGeTHbxnogQCKDzkKDogaJlwvltHogIiRhJCUmpOogUchR
hRhRhRhRhRhRhRhRhRUcUcUcUcUcUcUcUcUcUcUcogogSFogogogSFSFSFogogogogogogogogUchR
hRhRhRhRhRhRhRhRfBfBfBfBfBfBfBfBfBfBfBfBfBUcUcUcUcUcUcUcUcXlUcUcUcUchRUcUchRhR
hRXlXlXlXlXlXlXlXlXlXlhRhRXlXlXlhRhRXlhRhRUchRUcUcUchRUcUcXlUcUcUcUcXlUcUcXlXl
hRhRhRhRXlhRhRhRhRhRhRhRhRhRhRhRhRhRhRhRXlUchRhRUcUchRUcUcXlbKUcUcUcXlUcUcXlhR
hRhRhRhRXlhRhRhRhRhRhRhRhRhRhRhRhRhRhRXlhRUcUcUcUcUchRUcUcXlUcUcUcUcXlUcUcXlhR
hRhRhRhRhRhRhRhRhRhRhRhRhRhRhRhRhRhRhRXlXlUcUcbKUchRUcUcUchRUcUcUcUcUcUchRXlhR
hRhRhRhRhRhRhRhRhRhRhRhRhRhRhRhRhRhRhRXlXlhRhRhRUcUcUcUcUcXlhRhRUchRhRUcXlhRhR
hRhRhRhRhRhRhRhRhRhRhRhRhRhRhRhRhRhRhRXlXlhRhRhRUcUcUcUcUcXlhRhRUcUcUcUcXlhRhR
hRhRhRhRhRhRhRhRhRhRhRhRhRhRhRhRXlXlXlXlhRhRhRhRUcUcUcUcUcXlhRUcUcUcXlhRXlhRhR
hRhRhRhRhRhRhRhRhRhRhRhRhRhRhRhRhRhRhRXlhRhRUcUchRXlXlXlXlXlUcUcUcUcUchRXlhRhR
hRhRhRhRhRhRhRhRhRhRhRhRhRhRhRhRhRhRhRXlhRhRUcUchRhRhRhRhRhRUcUcUcUcUchRhRhRhR
hRhRhRhRhRhRhRhRhRhRhRhRhRhRhRhRhRhRhRXlXlXlXlXlXlhRhRXlXlhRXlhRhRXlhRXlXlhRhR
hRhRhRhRhRhRhRhRhRhRhRhRhRhRhRhRhRhRhRXlhRhRhRXlhRhRhRhRhRhRhRhRhRXlhRhRhRhRhR
hRhRhRhRhRhRhRhRhRhRhRhRhRhRhRhRhRhRhRXlhRhRhRXlhRhRhRhRhRhRhRhRhRXlhRhRhRhRhR
hRhRhRhRhRhRhRhRhRhRhRhRhRhRhRXlXlXlXlXlhRhRhRhRhRhRhRhRhRhRhRhRhRXlXlXlhRhRhR
hRhRhRhRhRhRhRhRhRhRhRhRhRhRhRhRhRhRhRXlXlXlhRXlhRhRhRhRhRhRhRhRhRXlhRhRhRhRhR
hRhRhRhRhRhRhRhRhRhRhRhRhRhRhRhRhRhRhRXlhRhRhRXlhRhRhRhRhRhRXlXlXlXlhRhRhRhRhR
hRhRhRhRhRhRhRhRhRhRhRhRhRhRhRhRhRhRhRhRhRhRhRhRhRhRhRhRhRhRhRhRhRhRhRhRhRhRhR
hRhRhRhRhRhRhRhRhRhRhRhRhRhRhRhRhRhRhRXlhRhRhRhRhRhRhRhRhRhRhRhRhRhRhRhRhRhRhR
hRhRhRhRhRhRhRhRhRhRhRhRhRhRhRhRhRhRhRhRhRhRhRhRhRhRhRhRhRhRhRhRhRhRhRhRhRhRhR
hRhRhRhRhRhRhRhRhRhRhRhRhRhRhRhRhRhRhRhRhRhRhRhRhRhRhRhRhRhRhRhRhRhRhRhRhRhRhR
"}
