"aB" = (/obj/structure/table/fancyblack,/obj/effect/floor_decal/spline/fancy/wood{dir = 4},/obj/item/device/starcaster_news,/turf/simulated/floor/carpet/bcarpet,/area/survivalpod/superpose/SurvivalLuxuryBar)
"bg" = (/obj/machinery/chemical_dispenser/bar_soft/full{pixel_y = 22},/obj/structure/table/marble,/obj/item/weapon/book/manual/barman_recipes,/obj/item/weapon/reagent_containers/food/drinks/shaker,/obj/item/weapon/reagent_containers/glass/rag,/turf/simulated/shuttle/floor/voidcraft/light,/area/survivalpod/superpose/SurvivalLuxuryBar)
"ce" = (/obj/structure/sign/mining/survival{dir = 4},/turf/simulated/shuttle/wall/voidcraft/green,/area/survivalpod/superpose/SurvivalLuxuryBar)
"cy" = (/obj/machinery/door/window/survival_pod{dir = 2; req_one_access = null},/obj/effect/floor_decal/spline/fancy/wood,/turf/simulated/shuttle/floor/voidcraft/light,/area/survivalpod/superpose/SurvivalLuxuryBar)
"cC" = (/turf/simulated/shuttle/wall/voidcraft/green,/area/survivalpod/superpose/SurvivalLuxuryBar)
"cS" = (/obj/effect/floor_decal/techfloor{dir = 8},/obj/effect/floor_decal/industrial/warning{dir = 8},/turf/simulated/shuttle/plating/skipjack,/area/survivalpod/superpose/SurvivalLuxuryBar)
"dl" = (/obj/machinery/newscaster{pixel_x = 30},/turf/simulated/shuttle/plating/skipjack,/area/survivalpod/superpose/SurvivalLuxuryBar)
"eI" = (/obj/item/weapon/stool/baystool/padded,/obj/effect/floor_decal/spline/fancy/wood,/turf/simulated/floor/carpet/bcarpet,/area/survivalpod/superpose/SurvivalLuxuryBar)
"ff" = (/turf/simulated/floor/carpet/bcarpet,/area/survivalpod/superpose/SurvivalLuxuryBar)
"gm" = (/obj/structure/sign/mining/survival{dir = 1},/turf/simulated/shuttle/wall/voidcraft/green,/area/survivalpod/superpose/SurvivalLuxuryBar)
"if" = (/obj/structure/disposalpipe/junction{dir = 4},/turf/simulated/shuttle/floor/voidcraft/dark,/area/survivalpod/superpose/SurvivalLuxuryBar)
"is" = (/obj/structure/bed/chair/sofa/black,/obj/machinery/light/small{dir = 1},/turf/simulated/floor/wood,/area/survivalpod/superpose/SurvivalLuxuryBar)
"jv" = (/obj/structure/fans/tiny,/obj/effect/floor_decal/industrial/danger/full,/obj/machinery/door/airlock/voidcraft/vertical,/turf/simulated/floor/tiled/techmaint,/area/survivalpod/superpose/SurvivalLuxuryBar)
"jC" = (/obj/machinery/vending/foodfast,/turf/simulated/shuttle/wall/voidcraft/survival/hard_corner,/area/survivalpod/superpose/SurvivalLuxuryBar)
"kZ" = (/obj/structure/urinal{dir = 4; pixel_x = -31},/obj/machinery/light,/turf/simulated/floor/tiled/freezer,/area/survivalpod/superpose/SurvivalLuxuryBar)
"lj" = (/obj/structure/bed/chair/comfy/black,/obj/effect/floor_decal/spline/fancy/wood{dir = 5},/turf/simulated/floor/carpet/bcarpet,/area/survivalpod/superpose/SurvivalLuxuryBar)
"lp" = (/obj/structure/fans,/obj/machinery/computer/security/telescreen/entertainment{pixel_y = 28},/turf/simulated/shuttle/floor/voidcraft/light,/area/survivalpod/superpose/SurvivalLuxuryBar)
"lE" = (/obj/structure/table/bench/glass,/obj/structure/closet/walllocker_double/survival/west,/obj/item/clothing/under/swimsuit/stripper/stripper_pink,/obj/item/clothing/mask/muzzle/ballgag/ringgag,/turf/simulated/floor/wood,/area/survivalpod/superpose/SurvivalLuxuryBar)
"ne" = (/obj/structure/disposalpipe/segment{dir = 8; icon_state = "pipe-c"},/turf/simulated/floor/tiled/freezer,/area/survivalpod/superpose/SurvivalLuxuryBar)
"ni" = (/turf/simulated/shuttle/plating/skipjack,/area/survivalpod/superpose/SurvivalLuxuryBar)
"no" = (/obj/structure/disposalpipe/segment,/turf/simulated/shuttle/wall/voidcraft/survival,/area/survivalpod/superpose/SurvivalLuxuryBar)
"np" = (/obj/machinery/door/airlock/maintenance/common{name = "Pole Dance Room"},/obj/structure/disposalpipe/segment,/turf/simulated/floor/tiled/techmaint,/area/survivalpod/superpose/SurvivalLuxuryBar)
"pc" = (/obj/machinery/chemical_dispenser/bar_alc/full{pixel_y = 22},/obj/structure/table/marble,/obj/item/weapon/clipboard,/obj/item/toy/figure/bartender,/obj/item/weapon/storage/fancy/cigar/havana,/obj/item/weapon/storage/fancy/cigar/cohiba,/turf/simulated/shuttle/floor/voidcraft/light,/area/survivalpod/superpose/SurvivalLuxuryBar)
"pj" = (/obj/structure/table/reinforced,/obj/machinery/cash_register/civilian{dir = 1},/obj/effect/floor_decal/spline/fancy/wood,/turf/simulated/shuttle/floor/voidcraft/light,/area/survivalpod/superpose/SurvivalLuxuryBar)
"pw" = (/obj/machinery/vending/cigarette,/turf/simulated/shuttle/wall/voidcraft/survival/hard_corner,/area/survivalpod/superpose/SurvivalLuxuryBar)
"rc" = (/obj/structure/table/reinforced,/obj/item/weapon/paper_bin,/obj/item/weapon/pen,/obj/item/weapon/pen,/obj/item/weapon/packageWrap,/obj/machinery/light{dir = 4},/obj/structure/disposalpipe/segment{dir = 4},/turf/simulated/shuttle/floor/voidcraft/dark,/area/survivalpod/superpose/SurvivalLuxuryBar)
"tA" = (/obj/machinery/door/airlock/maintenance/common{name = "Unisex Bathroom"},/turf/simulated/floor/tiled/techmaint,/area/survivalpod/superpose/SurvivalLuxuryBar)
"tZ" = (/obj/machinery/power/apc/alarms_hidden{pixel_y = -20},/turf/simulated/floor/tiled/freezer,/area/survivalpod/superpose/SurvivalLuxuryBar)
"vH" = (/obj/structure/window/reinforced/survival_pod{dir = 8},/obj/structure/window/reinforced/survival_pod{dir = 4},/obj/structure/window/reinforced/survival_pod{dir = 1},/obj/structure/window/reinforced/survival_pod,/obj/structure/grille,/obj/structure/curtain/black,/obj/structure/disposalpipe/segment,/turf/simulated/floor/plating,/area/survivalpod/superpose/SurvivalLuxuryBar)
"xR" = (/obj/structure/disposalpipe/segment,/turf/simulated/shuttle/wall/voidcraft/survival/hard_corner,/area/survivalpod/superpose/SurvivalLuxuryBar)
"zq" = (/obj/structure/window/reinforced/survival_pod{dir = 8},/obj/structure/window/reinforced/survival_pod{dir = 4},/obj/structure/window/reinforced/survival_pod{dir = 1},/obj/structure/window/reinforced/survival_pod,/obj/structure/grille,/obj/structure/curtain/black,/turf/simulated/floor/plating,/area/survivalpod/superpose/SurvivalLuxuryBar)
"zW" = (/obj/effect/floor_decal/spline/fancy/wood{dir = 1},/turf/simulated/floor/carpet/bcarpet,/area/survivalpod/superpose/SurvivalLuxuryBar)
"As" = (/obj/machinery/disposal/wall{dir = 8; pixel_x = 35},/obj/structure/disposalpipe/trunk{dir = 1},/turf/simulated/shuttle/plating/skipjack,/area/survivalpod/superpose/SurvivalLuxuryBar)
"BC" = (/obj/structure/bed/chair/comfy/black,/obj/effect/floor_decal/spline/fancy/wood{dir = 1},/turf/simulated/floor/carpet/bcarpet,/area/survivalpod/superpose/SurvivalLuxuryBar)
"Cg" = (/obj/structure/bed/chair/comfy/black{dir = 1},/obj/effect/floor_decal/spline/fancy/wood{dir = 4},/turf/simulated/floor/carpet/bcarpet,/area/survivalpod/superpose/SurvivalLuxuryBar)
"Di" = (/turf/simulated/floor/wood,/area/survivalpod/superpose/SurvivalLuxuryBar)
"Dy" = (/obj/structure/bed/chair/sofa/left/black,/turf/simulated/floor/wood,/area/survivalpod/superpose/SurvivalLuxuryBar)
"DK" = (/obj/structure/table/reinforced,/obj/structure/reagent_dispensers/beerkeg,/obj/machinery/light{dir = 4},/obj/effect/floor_decal/spline/fancy/wood,/turf/simulated/shuttle/floor/voidcraft/light,/area/survivalpod/superpose/SurvivalLuxuryBar)
"DN" = (/obj/structure/bed/chair/comfy/black{dir = 1},/obj/machinery/light,/turf/simulated/floor/carpet/bcarpet,/area/survivalpod/superpose/SurvivalLuxuryBar)
"DX" = (/obj/structure/bed/chair/sofa/right/black,/turf/simulated/floor/wood,/area/survivalpod/superpose/SurvivalLuxuryBar)
"ET" = (/obj/machinery/door/airlock/voidcraft/survival_pod,/obj/structure/fans/tiny,/obj/effect/floor_decal/industrial/danger/full,/obj/machinery/door/blast/regular{density = 0; dir = 4; icon_state = "pdoor0"; id = "shelterblast"; name = "Shelter Blast Doors"; opacity = 0},/turf/simulated/floor/tiled/techmaint,/area/survivalpod/superpose/SurvivalLuxuryBar)
"EY" = (/obj/structure/sink{pixel_y = 14},/obj/structure/mirror{pixel_y = 32},/obj/machinery/disposal/wall{dir = 4; pixel_x = -37},/obj/structure/disposalpipe/trunk{dir = 4},/turf/simulated/floor/tiled/freezer,/area/survivalpod/superpose/SurvivalLuxuryBar)
"Gg" = (/obj/effect/floor_decal/spline/fancy/wood,/turf/simulated/floor/carpet/bcarpet,/area/survivalpod/superpose/SurvivalLuxuryBar)
"GB" = (/obj/structure/table/bench/glass,/obj/item/weapon/handcuffs/legcuffs/fuzzy,/obj/item/weapon/handcuffs/fuzzy,/turf/simulated/floor/wood,/area/survivalpod/superpose/SurvivalLuxuryBar)
"GF" = (/turf/simulated/shuttle/wall/voidcraft/survival/hard_corner,/area/survivalpod/superpose/SurvivalLuxuryBar)
"GH" = (/obj/structure/table/hardwoodtable,/obj/structure/stripper_pole{pixel_y = 9},/obj/structure/mirror{dir = 1; pixel_y = -27},/obj/item/clothing/under/swimsuit/stripper/mankini{pixel_x = -6; pixel_y = 5},/turf/simulated/floor/wood,/area/survivalpod/superpose/SurvivalLuxuryBar)
"HE" = (/obj/structure/bed/chair/comfy/black{dir = 1},/obj/structure/closet/walllocker_double/survival/west,/turf/simulated/floor/carpet/bcarpet,/area/survivalpod/superpose/SurvivalLuxuryBar)
"HS" = (/obj/structure/table/fancyblack,/obj/item/device/paicard,/turf/simulated/floor/carpet/bcarpet,/area/survivalpod/superpose/SurvivalLuxuryBar)
"Ij" = (/obj/structure/table/hardwoodtable,/obj/structure/stripper_pole{pixel_y = 9},/obj/structure/mirror{dir = 1; pixel_y = -27},/obj/item/clothing/under/fluff/latexmaid{pixel_x = -8; pixel_y = 7},/turf/simulated/floor/wood,/area/survivalpod/superpose/SurvivalLuxuryBar)
"IN" = (/obj/structure/sign/mining/survival{dir = 8},/turf/simulated/shuttle/wall/voidcraft/green,/area/survivalpod/superpose/SurvivalLuxuryBar)
"IT" = (/obj/structure/sink/kitchen{dir = 8; pixel_x = -13},/turf/simulated/shuttle/floor/voidcraft/light,/area/survivalpod/superpose/SurvivalLuxuryBar)
"JT" = (/obj/structure/table/reinforced,/obj/item/weapon/flame/lighter/random{pixel_x = -4; pixel_y = 4},/obj/item/weapon/flame/lighter/random,/obj/machinery/light{dir = 8},/obj/effect/floor_decal/spline/fancy/wood,/turf/simulated/shuttle/floor/voidcraft/light,/area/survivalpod/superpose/SurvivalLuxuryBar)
"La" = (/obj/structure/table/reinforced,/obj/machinery/microwave{pixel_y = -9},/turf/simulated/shuttle/floor/voidcraft/light,/area/survivalpod/superpose/SurvivalLuxuryBar)
"Lb" = (/obj/structure/disposalpipe/segment,/turf/simulated/shuttle/plating/skipjack,/area/survivalpod/superpose/SurvivalLuxuryBar)
"Li" = (/obj/structure/disposalpipe/segment,/turf/simulated/shuttle/wall/voidcraft/green,/area/survivalpod/superpose/SurvivalLuxuryBar)
"Lt" = (/obj/item/weapon/stool/baystool/padded,/obj/effect/floor_decal/spline/fancy/wood,/obj/machinery/vending/wallmed1{dir = 4; pixel_x = -23},/turf/simulated/floor/carpet/bcarpet,/area/survivalpod/superpose/SurvivalLuxuryBar)
"LX" = (/obj/structure/table/reinforced,/obj/effect/floor_decal/spline/fancy/wood,/turf/simulated/shuttle/floor/voidcraft/light,/area/survivalpod/superpose/SurvivalLuxuryBar)
"MV" = (/obj/structure/sink{pixel_y = 14},/obj/structure/mirror{pixel_y = 32},/turf/simulated/floor/tiled/freezer,/area/survivalpod/superpose/SurvivalLuxuryBar)
"Nl" = (/turf/simulated/shuttle/wall/voidcraft/survival,/area/survivalpod/superpose/SurvivalLuxuryBar)
"Nv" = (/obj/structure/urinal{dir = 4; pixel_x = -31},/turf/simulated/floor/tiled/freezer,/area/survivalpod/superpose/SurvivalLuxuryBar)
"NJ" = (/obj/structure/table/fancyblack,/obj/item/weapon/reagent_containers/food/condiment/small/saltshaker{pixel_x = 4; pixel_y = 4},/obj/item/weapon/reagent_containers/food/condiment/small/peppermill{pixel_x = -4; pixel_y = 12},/obj/machinery/computer/security/telescreen/entertainment{pixel_x = -32},/turf/simulated/floor/carpet/bcarpet,/area/survivalpod/superpose/SurvivalLuxuryBar)
"Ol" = (/obj/structure/disposalpipe/segment{dir = 4},/turf/simulated/shuttle/floor/voidcraft/dark,/area/survivalpod/superpose/SurvivalLuxuryBar)
"OA" = (/obj/effect/floor_decal/techfloor,/obj/effect/floor_decal/industrial/warning,/turf/simulated/shuttle/plating/skipjack,/area/survivalpod/superpose/SurvivalLuxuryBar)
"Pr" = (/turf/simulated/shuttle/floor/voidcraft/light,/area/survivalpod/superpose/SurvivalLuxuryBar)
"Pv" = (/obj/structure/disposalpipe/segment,/obj/structure/sign/mining/survival{dir = 4},/turf/simulated/shuttle/wall/voidcraft/green,/area/survivalpod/superpose/SurvivalLuxuryBar)
"RE" = (/obj/structure/window/reinforced/survival_pod{dir = 8},/obj/structure/window/reinforced/survival_pod{dir = 4},/obj/structure/window/reinforced/survival_pod{dir = 1},/obj/structure/window/reinforced/survival_pod,/obj/structure/grille,/obj/structure/curtain/black,/obj/structure/disposalpipe/segment{dir = 8; icon_state = "pipe-c"},/turf/simulated/floor/plating,/area/survivalpod/superpose/SurvivalLuxuryBar)
"RR" = (/obj/structure/toilet{dir = 8},/obj/structure/window/reinforced/survival_pod{dir = 1},/obj/structure/curtain/bed{icon_state = "open"; name = "Bathroom curtain"; opacity = 0},/turf/simulated/floor/tiled/freezer,/area/survivalpod/superpose/SurvivalLuxuryBar)
"RS" = (/turf/simulated/floor/tiled/freezer,/area/survivalpod/superpose/SurvivalLuxuryBar)
"RV" = (/obj/structure/bed/chair/comfy/black,/obj/effect/floor_decal/spline/fancy/wood{dir = 1},/obj/structure/closet/walllocker_double/survival/west,/turf/simulated/floor/carpet/bcarpet,/area/survivalpod/superpose/SurvivalLuxuryBar)
"Ub" = (/obj/structure/table/fancyblack,/obj/item/toy/eight_ball,/turf/simulated/floor/carpet/bcarpet,/area/survivalpod/superpose/SurvivalLuxuryBar)
"Uu" = (/obj/structure/table/fancyblack,/obj/item/weapon/deck/cah{pixel_x = 2; pixel_y = 2},/obj/item/weapon/deck/cah/black{pixel_x = -2; pixel_y = -2},/turf/simulated/floor/carpet/bcarpet,/area/survivalpod/superpose/SurvivalLuxuryBar)
"Wq" = (/obj/structure/sign/mining/survival,/turf/simulated/shuttle/wall/voidcraft/green,/area/survivalpod/superpose/SurvivalLuxuryBar)
"WL" = (/obj/item/device/gps/computer,/turf/simulated/shuttle/floor/voidcraft/light,/area/survivalpod/superpose/SurvivalLuxuryBar)
"XG" = (/obj/machinery/smartfridge/survival_pod,/obj/item/weapon/tape_roll,/obj/item/sticky_pad/random,/obj/item/weapon/pen/blue,/obj/item/weapon/pen/blue,/obj/item/fulton_core,/obj/item/fulton_core,/obj/item/extraction_pack,/obj/item/extraction_pack,/obj/item/modular_computer/laptop/preset/custom_loadout/standard,/obj/item/weapon/pickaxe/hand,/obj/item/device/flashlight/color/yellow,/obj/item/device/flashlight/color/orange,/obj/item/device/threadneedle,/obj/item/device/radio,/obj/item/device/radio,/obj/item/device/radio,/obj/item/weapon/extinguisher/mini,/obj/item/weapon/extinguisher/mini,/obj/item/weapon/flame/lighter/zippo,/obj/item/weapon/flame/lighter/zippo,/obj/item/device/flashlight/lantern,/obj/random/soap,/obj/random/soap,/obj/item/weapon/towel/random,/obj/item/weapon/towel/random,/obj/item/bodybag/cryobag,/obj/item/bodybag/cryobag,/obj/item/weapon/storage/pill_bottle/spaceacillin,/obj/item/weapon/storage/pill_bottle/antitox,/obj/item/device/healthanalyzer,/obj/item/weapon/storage/firstaid/regular,/obj/item/weapon/storage/firstaid/o2,/obj/item/device/fbp_backup_cell,/obj/item/device/fbp_backup_cell,/obj/item/stack/nanopaste,/obj/item/device/suit_cooling_unit/emergency,/obj/item/device/suit_cooling_unit/emergency,/obj/item/weapon/reagent_containers/hypospray/autoinjector/biginjector/clotting,/obj/item/weapon/reagent_containers/hypospray/autoinjector/biginjector/clotting,/obj/item/weapon/storage/toolbox/brass,/obj/item/weapon/storage/box/survival/space,/obj/item/weapon/storage/box/survival/space,/obj/item/weapon/storage/box/survival/space,/obj/item/weapon/storage/pill_bottle/dice_nerd,/obj/item/weapon/storage/box/flare,/obj/item/weapon/storage/box/khcrystal,/obj/item/weapon/storage/box/khcrystal,/obj/item/weapon/storage/briefcase/inflatable,/obj/item/stack/marker_beacon/ten,/obj/item/device/starcaster_news,/obj/item/device/mapping_unit,/obj/item/weapon/storage/box/dosimeter,/obj/item/device/gps,/obj/item/device/gps,/obj/item/weapon/cell/device/hyper,/obj/item/weapon/cell/device/hyper,/obj/item/weapon/cell/device/hyper,/obj/item/device/pda,/obj/item/device/pda,/obj/item/weapon/card/id/external,/obj/item/weapon/card/id/external,/obj/item/weapon/storage/mre/random,/obj/item/weapon/storage/mre/random,/obj/item/weapon/storage/mre/random,/obj/item/weapon/storage/mre/random,/obj/item/weapon/storage/mre/random,/obj/item/weapon/storage/mre/random,/obj/item/weapon/reagent_containers/food/drinks/cans/waterbottle,/obj/item/weapon/reagent_containers/food/drinks/cans/waterbottle,/obj/item/weapon/reagent_containers/food/drinks/cans/waterbottle,/obj/item/weapon/reagent_containers/food/drinks/cans/waterbottle,/obj/item/weapon/gun/energy/locked/phasegun/pistol,/obj/item/weapon/gun/energy/locked/phasegun,/obj/item/weapon/cell/device/weapon{pixel_x = -2; pixel_y = -2},/obj/item/weapon/cell/device/weapon{pixel_x = -2; pixel_y = -2},/obj/item/clothing/accessory/permit/gun,/obj/item/clothing/accessory/permit/gun,/obj/item/weapon/material/knife/machete,/obj/item/weapon/material/fishing_net,/obj/item/weapon/storage/backpack/sport,/obj/item/weapon/storage/backpack/sport,/obj/item/clothing/accessory/storage/black_drop_pouches,/obj/item/clothing/accessory/storage/black_drop_pouches,/obj/item/weapon/storage/belt,/obj/item/clothing/accessory/poncho/thermal,/turf/simulated/shuttle/floor/voidcraft/light,/area/survivalpod/superpose/SurvivalLuxuryBar)
"Ym" = (/obj/structure/table/fancyblack,/obj/item/weapon/reagent_containers/food/condiment/small/saltshaker{pixel_x = 4; pixel_y = 4},/obj/item/weapon/reagent_containers/food/condiment/small/peppermill{pixel_x = -4; pixel_y = 12},/obj/effect/floor_decal/spline/fancy/wood{dir = 4},/turf/simulated/floor/carpet/bcarpet,/area/survivalpod/superpose/SurvivalLuxuryBar)
"ZS" = (/obj/structure/disposalpipe/segment{dir = 4; icon_state = "pipe-c"},/turf/simulated/shuttle/plating/skipjack,/area/survivalpod/superpose/SurvivalLuxuryBar)

(1,1,1) = {"
NlGFgmcCcCGFcCcCgmGFno
GFpcbglpXGWLGFDXisDyxR
zqITPrPrPrLaGFlEDiGBvH
INJTLXpjcyDKGFIjDiGHPv
cCLteIeIGgGgpwGFtAGFLi
jvcSnininiZSOlOlifrcRE
cCRVBCzWljLbjCGFnpGFcC
INHSUuffYmAsGFEYneMVce
cCNJUbffaBdlGFNvRSRRcC
GFHEDNffCgOAGFkZtZRRGF
NlcCWqzqGFETGFcCWqcCNl
"}
