//MAP CONVERTED BY dmm2tgm.py THIS HEADER COMMENT PREVENTS RECONVERSION, DO NOT REMOVE
"a" = (
/turf/simulated/floor/plating,
/area/survivalpod/superpose/SurvivalDIY_11x11)
"b" = (
/obj/machinery/vending/engivend{
	emagged = 1;
	req_access = null;
	req_log_access = null
	},
/turf/simulated/floor/plating,
/area/survivalpod/superpose/SurvivalDIY_11x11)
"e" = (
/obj/structure/inflatable,
/turf/simulated/floor/plating,
/area/survivalpod/superpose/SurvivalDIY_11x11)
"g" = (
/obj/structure/reagent_dispensers/fueltank,
/turf/simulated/floor/plating,
/area/survivalpod/superpose/SurvivalDIY_11x11)
"h" = (
/obj/structure/closet/crate,
/obj/fiftyspawner/wood,
/obj/fiftyspawner/wood,
/obj/fiftyspawner/wood/sif,
/obj/fiftyspawner/wood/sif,
/obj/fiftyspawner/turcarpet,
/obj/fiftyspawner/tealcarpet,
/obj/fiftyspawner/sblucarpet,
/obj/fiftyspawner/purcarpet,
/obj/fiftyspawner/oracarpet,
/obj/fiftyspawner/blucarpet,
/obj/fiftyspawner/marble,
/obj/item/weapon/storage/briefcase/inflatable,
/obj/item/weapon/storage/briefcase/inflatable,
/obj/item/weapon/storage/briefcase/inflatable,
/obj/fiftyspawner/cardboard,
/obj/fiftyspawner/cardboard,
/turf/simulated/floor/plating,
/area/survivalpod/superpose/SurvivalDIY_11x11)
"l" = (
/obj/structure/reagent_dispensers/fueltank/high,
/turf/simulated/floor/plating,
/area/survivalpod/superpose/SurvivalDIY_11x11)
"m" = (
/obj/structure/closet/crate,
/obj/fiftyspawner/glass,
/obj/fiftyspawner/glass,
/obj/fiftyspawner/glass,
/obj/fiftyspawner/glass,
/obj/fiftyspawner/glass,
/obj/fiftyspawner/steel,
/obj/fiftyspawner/steel,
/obj/fiftyspawner/steel,
/obj/fiftyspawner/steel,
/obj/fiftyspawner/steel,
/obj/fiftyspawner/plastic,
/obj/fiftyspawner/plastic,
/obj/fiftyspawner/plastic,
/obj/fiftyspawner/plastic,
/obj/fiftyspawner/plastic,
/turf/simulated/floor/plating,
/area/survivalpod/superpose/SurvivalDIY_11x11)
"n" = (
/obj/structure/inflatable/door,
/turf/simulated/floor/plating,
/area/survivalpod/superpose/SurvivalDIY_11x11)
"q" = (
/obj/structure/closet/secure_closet/engineering_welding{
	locked = 0
	},
/turf/simulated/floor/plating,
/area/survivalpod/superpose/SurvivalDIY_11x11)
"t" = (
/obj/vehicle/train/engine/quadbike/built{
	dir = 4
	},
/turf/simulated/floor/plating,
/area/survivalpod/superpose/SurvivalDIY_11x11)
"u" = (
/obj/item/weapon/storage/backpack/messenger,
/obj/item/weapon/reagent_containers/food/drinks/cans/waterbottle,
/obj/item/weapon/reagent_containers/food/drinks/cans/waterbottle,
/obj/item/weapon/material/knife/tacknife/survival,
/obj/item/weapon/reagent_containers/food/snacks/sosjerky,
/obj/item/weapon/cell/device/hyper,
/obj/item/weapon/reagent_containers/hypospray/autoinjector/trauma,
/obj/item/weapon/reagent_containers/hypospray/autoinjector/oxy,
/obj/item/weapon/flame/lighter/random,
/obj/item/weapon/storage/box/survival/space,
/obj/item/device/radio,
/obj/item/clothing/accessory/storage/black_drop_pouches,
/obj/item/weapon/reagent_containers/pill/dylovene,
/obj/item/weapon/reagent_containers/pill/dylovene,
/obj/item/device/flashlight/maglight,
/obj/item/device/flashlight/flare,
/obj/item/device/flashlight/flare,
/obj/random/soap,
/obj/item/weapon/gun/energy/locked/frontier/holdout/unlocked,
/obj/item/device/fbp_backup_cell,
/obj/item/device/pda,
/obj/item/weapon/storage/mre/menu11,
/obj/item/weapon/storage/mre/menu11,
/obj/item/device/starcaster_news,
/obj/effect/floor_decal/spline/fancy/wood{
	dir = 4
	},
/obj/item/device/suit_cooling_unit/emergency,
/obj/item/device/gps,
/obj/structure/closet{
	name = "Survival closet"
	},
/turf/simulated/floor/plating,
/area/survivalpod/superpose/SurvivalDIY_11x11)
"v" = (
/obj/machinery/autolathe,
/obj/item/weapon/rcd/advanced/loaded{
	pixel_x = -5;
	pixel_y = 9
	},
/obj/item/weapon/rcd_ammo/large,
/obj/item/weapon/rcd_ammo/large,
/turf/simulated/floor/plating,
/area/survivalpod/superpose/SurvivalDIY_11x11)
"w" = (
/obj/machinery/power/port_gen/pacman,
/obj/item/stack/material/phoron{
	amount = 25
	},
/turf/simulated/floor/plating,
/area/survivalpod/superpose/SurvivalDIY_11x11)
"y" = (
/obj/structure/closet/crate,
/obj/fiftyspawner/plasteel,
/obj/fiftyspawner/plasteel,
/obj/fiftyspawner/phoronrglass,
/obj/fiftyspawner/phoronrglass,
/obj/item/stack/material/lead{
	amount = 50
	},
/obj/item/stack/material/lead{
	amount = 50
	},
/obj/fiftyspawner/gold,
/obj/fiftyspawner/phoron,
/turf/simulated/floor/plating,
/area/survivalpod/superpose/SurvivalDIY_11x11)
"B" = (
/obj/machinery/floodlight,
/turf/simulated/floor/plating,
/area/survivalpod/superpose/SurvivalDIY_11x11)
"F" = (
/obj/machinery/portable_atmospherics/canister/oxygen,
/turf/simulated/floor/plating,
/area/survivalpod/superpose/SurvivalDIY_11x11)
"J" = (
/obj/machinery/space_heater,
/turf/simulated/floor/plating,
/area/survivalpod/superpose/SurvivalDIY_11x11)
"K" = (
/obj/vehicle/train/trolley{
	dir = 8
	},
/turf/simulated/floor/plating,
/area/survivalpod/superpose/SurvivalDIY_11x11)
"O" = (
/obj/structure/closet/secure_closet/engineering_electrical,
/turf/simulated/floor/plating,
/area/survivalpod/superpose/SurvivalDIY_11x11)
"P" = (
/obj/structure/closet/toolcloset,
/obj/item/weapon/storage/box/lights/mixed,
/obj/item/weapon/storage/box/lights/mixed,
/obj/item/device/flashlight,
/obj/item/weapon/storage/belt/utility/full/multitool,
/obj/item/weapon/cell/high,
/obj/item/weapon/cell/high,
/obj/item/weapon/module/power_control,
/obj/item/weapon/module/cell_power,
/obj/item/weapon/module/card_reader,
/obj/item/weapon/module/id_auth,
/obj/item/weapon/storage/firstaid/regular,
/turf/simulated/floor/plating,
/area/survivalpod/superpose/SurvivalDIY_11x11)
"S" = (
/obj/vehicle/train/engine,
/turf/simulated/floor/plating,
/area/survivalpod/superpose/SurvivalDIY_11x11)
"X" = (
/obj/machinery/vending/tool{
	emagged = 1;
	req_log_access = null
	},
/turf/simulated/floor/plating,
/area/survivalpod/superpose/SurvivalDIY_11x11)
"Z" = (
/obj/structure/reagent_dispensers/watertank/high,
/turf/simulated/floor/plating,
/area/survivalpod/superpose/SurvivalDIY_11x11)

(1,1,1) = {"
e
e
e
e
e
e
e
e
e
e
e
"}
(2,1,1) = {"
e
K
a
a
P
X
a
a
w
a
e
"}
(3,1,1) = {"
e
K
a
a
P
b
a
a
v
a
e
"}
(4,1,1) = {"
e
K
a
a
q
O
a
a
a
a
e
"}
(5,1,1) = {"
e
S
t
a
a
a
a
a
a
a
e
"}
(6,1,1) = {"
e
a
a
a
a
m
y
g
B
F
e
"}
(7,1,1) = {"
e
n
n
e
a
m
u
l
B
F
e
"}
(8,1,1) = {"
e
a
a
e
a
m
u
Z
B
J
e
"}
(9,1,1) = {"
e
a
a
e
a
h
h
Z
B
J
e
"}
(10,1,1) = {"
e
a
a
e
a
a
a
a
a
a
e
"}
(11,1,1) = {"
e
n
n
e
e
e
e
e
e
e
e
"}
