//MAP CONVERTED BY dmm2tgm.py THIS HEADER COMMENT PREVENTS RECONVERSION, DO NOT REMOVE
"a" = (
/obj/machinery/light{
	dir = 4
	},
/turf/simulated/floor/boxing{
	name = "yoga mat"
	},
/area/survivalpod/superpose/SurvivalLeisure)
"b" = (
/obj/structure/bed/chair/oldsofa{
	dir = 5
	},
/turf/simulated/floor/carpet,
/area/survivalpod/superpose/SurvivalLeisure)
"c" = (
/obj/effect/floor_decal/spline/plain{
	dir = 8
	},
/obj/structure/fans{
	pixel_y = 16
	},
/obj/machinery/smartfridge/survival_pod{
	icon = 'icons/obj/vending.dmi';
	icon_base = "smartfridge";
	icon_contents = "boxes";
	icon_state = "smartfridge";
	name = "Advanced storage";
	pixel_y = -14
	},
/obj/structure/table/reinforced,
/obj/item/tool/wrench,
/obj/item/reagent_containers/food/drinks/cans/waterbottle{
	pixel_x = -4;
	pixel_y = 6
	},
/obj/item/reagent_containers/food/drinks/cans/waterbottle{
	pixel_x = -4;
	pixel_y = 6
	},
/obj/item/reagent_containers/food/drinks/cans/waterbottle{
	pixel_x = -4;
	pixel_y = 6
	},
/obj/item/reagent_containers/food/drinks/cans/waterbottle{
	pixel_x = -4;
	pixel_y = 6
	},
/obj/item/towel/random{
	pixel_y = 8
	},
/obj/item/towel/random{
	pixel_y = 8
	},
/obj/item/towel/random{
	pixel_y = 8
	},
/obj/item/towel/random{
	pixel_y = 8
	},
/obj/item/towel/random{
	pixel_y = 8
	},
/obj/item/towel/random{
	pixel_y = 8
	},
/obj/item/clothing/shoes/footwraps,
/obj/item/clothing/shoes/footwraps,
/obj/item/clothing/shoes/footwraps,
/obj/item/clothing/shoes/footwraps,
/obj/item/clothing/shoes/sandal,
/obj/item/clothing/shoes/sandal,
/obj/item/clothing/shoes/sandal,
/obj/item/clothing/shoes/sandal,
/obj/item/clothing/gloves/boxing,
/obj/item/clothing/gloves/boxing/blue,
/obj/item/material/twohanded/baseballbat/foam,
/obj/item/material/sword/foam,
/obj/item/material/twohanded/fireaxe/foam,
/obj/item/material/twohanded/spear/foam,
/obj/item/paint_palette{
	pixel_x = 6;
	pixel_y = 6
	},
/obj/item/paint_palette{
	pixel_x = 6;
	pixel_y = 6
	},
/obj/item/paint_brush{
	pixel_x = -8;
	pixel_y = 4
	},
/obj/item/paint_brush{
	pixel_x = -8;
	pixel_y = 4
	},
/obj/item/camera_film,
/obj/item/camera_film,
/obj/item/camera_film,
/obj/item/camera_film,
/obj/item/camera,
/obj/item/camera,
/obj/item/storage/photo_album,
/obj/item/storage/fancy/crayons{
	pixel_x = 11;
	pixel_y = -3
	},
/obj/item/storage/fancy/crayons{
	pixel_x = 11;
	pixel_y = -3
	},
/obj/item/storage/fancy/markers{
	pixel_x = 11;
	pixel_y = 6
	},
/obj/item/tape_roll,
/obj/item/tape_roll,
/obj/item/hand_labeler,
/obj/item/cell/device,
/obj/item/cell/device,
/turf/simulated/shuttle/floor/voidcraft/dark,
/area/survivalpod/superpose/SurvivalLeisure)
"d" = (
/obj/structure/easel,
/obj/item/canvas/twentythree_nineteen,
/turf/simulated/floor/wood,
/area/survivalpod/superpose/SurvivalLeisure)
"e" = (
/obj/structure/sign/mining/survival{
	dir = 4
	},
/turf/simulated/shuttle/wall/voidcraft/green,
/area/survivalpod/superpose/SurvivalLeisure)
"f" = (
/obj/effect/floor_decal/spline/plain,
/obj/effect/floor_decal/spline/plain{
	dir = 4
	},
/turf/simulated/floor/wood,
/area/survivalpod/superpose/SurvivalLeisure)
"g" = (
/turf/simulated/shuttle/wall/voidcraft/green,
/area/survivalpod/superpose/SurvivalLeisure)
"h" = (
/obj/effect/floor_decal/techfloor{
	dir = 1
	},
/obj/effect/floor_decal/industrial/warning{
	dir = 1
	},
/turf/simulated/shuttle/plating,
/area/survivalpod/superpose/SurvivalLeisure)
"i" = (
/obj/machinery/newscaster{
	pixel_x = 30
	},
/turf/simulated/floor/boxing/gym,
/area/survivalpod/superpose/SurvivalLeisure)
"j" = (
/obj/item/dice,
/obj/structure/table/hardwoodtable,
/turf/simulated/floor/carpet,
/area/survivalpod/superpose/SurvivalLeisure)
"k" = (
/obj/effect/floor_decal/spline/plain,
/turf/simulated/floor/boxing{
	name = "yoga mat"
	},
/area/survivalpod/superpose/SurvivalLeisure)
"l" = (
/turf/simulated/floor/wood,
/area/survivalpod/superpose/SurvivalLeisure)
"m" = (
/obj/effect/floor_decal/spline/plain{
	dir = 4
	},
/turf/simulated/floor/wood,
/area/survivalpod/superpose/SurvivalLeisure)
"n" = (
/obj/item/gps/computer{
	pixel_y = -16
	},
/obj/structure/table/reinforced,
/turf/simulated/shuttle/floor/voidcraft/dark,
/area/survivalpod/superpose/SurvivalLeisure)
"o" = (
/obj/machinery/librarycomp,
/obj/structure/table/wooden_reinforced,
/turf/simulated/floor/wood,
/area/survivalpod/superpose/SurvivalLeisure)
"p" = (
/obj/machinery/smartfridge/survival_pod{
	pixel_y = 12
	},
/obj/item/storage/mre/random,
/obj/item/storage/mre/random,
/obj/item/storage/mre/random,
/obj/item/storage/mre/random,
/obj/item/storage/mre/random,
/obj/item/storage/mre/random,
/obj/item/storage/mre/menu9,
/obj/item/storage/mre/menu9,
/obj/item/storage/mre/menu10,
/obj/item/storage/mre/menu10,
/obj/item/storage/mre/menu11,
/obj/item/storage/mre/menu11,
/obj/item/fbp_backup_cell,
/obj/item/fbp_backup_cell,
/obj/item/fbp_backup_cell,
/obj/item/fbp_backup_cell,
/obj/item/fbp_backup_cell,
/obj/item/storage/pill_bottle/antitox,
/obj/item/storage/box/survival/space,
/obj/item/healthanalyzer,
/obj/item/storage/pill_bottle/dice_nerd,
/obj/item/storage/firstaid/regular,
/obj/item/extinguisher/mini,
/obj/item/extinguisher/mini,
/obj/item/storage/box/survival/space,
/obj/item/storage/box/survival/space,
/obj/item/radio,
/obj/item/radio,
/obj/item/radio,
/obj/item/starcaster_news,
/obj/item/starcaster_news,
/obj/item/threadneedle,
/obj/item/flashlight,
/obj/item/flashlight,
/obj/item/storage/toolbox/emergency,
/obj/item/storage/pill_bottle/spaceacillin,
/obj/random/soap,
/obj/item/material/knife/machete/hatchet,
/obj/item/storage/box/flare,
/obj/structure/table/reinforced,
/turf/simulated/shuttle/floor/voidcraft/dark,
/area/survivalpod/superpose/SurvivalLeisure)
"q" = (
/obj/effect/floor_decal/spline/plain,
/obj/structure/reagent_dispensers/water_cooler/full{
	dir = 8;
	pixel_x = 9
	},
/turf/simulated/floor/boxing{
	name = "yoga mat"
	},
/area/survivalpod/superpose/SurvivalLeisure)
"r" = (
/obj/structure/window/reinforced/survival_pod{
	dir = 8
	},
/obj/structure/window/reinforced/survival_pod{
	dir = 4
	},
/obj/structure/window/reinforced/survival_pod{
	dir = 1
	},
/obj/structure/window/reinforced/survival_pod,
/obj/structure/grille,
/obj/structure/curtain/black,
/turf/simulated/floor/plating,
/area/survivalpod/superpose/SurvivalLeisure)
"s" = (
/obj/effect/floor_decal/spline/plain{
	dir = 4
	},
/obj/item/starcaster_news,
/obj/structure/table/hardwoodtable,
/turf/simulated/floor/carpet,
/area/survivalpod/superpose/SurvivalLeisure)
"t" = (
/obj/effect/floor_decal/spline/plain,
/obj/effect/floor_decal/spline/plain{
	dir = 8
	},
/turf/simulated/floor/boxing{
	name = "yoga mat"
	},
/area/survivalpod/superpose/SurvivalLeisure)
"u" = (
/obj/machinery/scale,
/turf/simulated/floor/boxing/gym,
/area/survivalpod/superpose/SurvivalLeisure)
"v" = (
/obj/effect/floor_decal/spline/plain{
	dir = 4
	},
/obj/item/dice/d20,
/obj/structure/table/hardwoodtable,
/turf/simulated/floor/carpet,
/area/survivalpod/superpose/SurvivalLeisure)
"w" = (
/obj/machinery/power/apc/alarms_hidden{
	dir = 4;
	pixel_x = 20
	},
/turf/simulated/floor/boxing{
	name = "yoga mat"
	},
/area/survivalpod/superpose/SurvivalLeisure)
"x" = (
/obj/structure/sign/mining,
/turf/simulated/shuttle/wall/voidcraft/green,
/area/survivalpod/superpose/SurvivalLeisure)
"y" = (
/obj/structure/sign/mining/survival{
	dir = 1
	},
/turf/simulated/shuttle/wall/voidcraft/green,
/area/survivalpod/superpose/SurvivalLeisure)
"z" = (
/obj/structure/bookcase{
	name = "bookcase (Reference)"
	},
/obj/item/book/codex/lore/robutt,
/obj/item/book/bundle/custom_library/fiction/metalglen,
/obj/item/book/bundle/custom_library/fiction/silence,
/obj/item/book/bundle/custom_library/fiction/taleoftherainbowcat,
/obj/item/book/bundle/custom_library/religious/zoroastrianism,
/turf/simulated/floor/wood,
/area/survivalpod/superpose/SurvivalLeisure)
"A" = (
/obj/item/deck/cah{
	pixel_x = 2;
	pixel_y = 2
	},
/obj/item/deck/cah/black{
	pixel_x = -2;
	pixel_y = -2
	},
/obj/item/deck/cards{
	pixel_x = -4;
	pixel_y = 5
	},
/obj/structure/table/hardwoodtable,
/turf/simulated/floor/carpet,
/area/survivalpod/superpose/SurvivalLeisure)
"B" = (
/obj/structure/bed/chair/oldsofa/left{
	dir = 1
	},
/obj/effect/floor_decal/spline/plain{
	dir = 4
	},
/turf/simulated/floor/carpet,
/area/survivalpod/superpose/SurvivalLeisure)
"C" = (
/obj/effect/floor_decal/spline/plain{
	dir = 4
	},
/obj/structure/table/woodentable,
/obj/item/paint_palette{
	pixel_x = 6;
	pixel_y = 6
	},
/obj/item/paint_brush{
	pixel_x = -8;
	pixel_y = 4
	},
/turf/simulated/floor/wood,
/area/survivalpod/superpose/SurvivalLeisure)
"D" = (
/obj/structure/easel,
/obj/item/canvas/twentythree_twentythree,
/turf/simulated/floor/wood,
/area/survivalpod/superpose/SurvivalLeisure)
"E" = (
/obj/structure/fitness/weightlifter,
/obj/structure/window/reinforced/survival_pod{
	dir = 1
	},
/turf/simulated/floor/boxing/gym,
/area/survivalpod/superpose/SurvivalLeisure)
"F" = (
/obj/effect/floor_decal/spline/plain{
	dir = 8
	},
/obj/machinery/scale,
/turf/simulated/floor/boxing/gym,
/area/survivalpod/superpose/SurvivalLeisure)
"G" = (
/obj/effect/floor_decal/spline/plain{
	dir = 4
	},
/obj/structure/sign/painting/public,
/turf/simulated/wall/wood,
/area/survivalpod/superpose/SurvivalLeisure)
"H" = (
/obj/structure/bed/chair/oldsofa/left{
	dir = 4
	},
/turf/simulated/floor/carpet,
/area/survivalpod/superpose/SurvivalLeisure)
"I" = (
/turf/simulated/shuttle/wall/voidcraft/survival,
/area/survivalpod/superpose/SurvivalLeisure)
"J" = (
/obj/structure/sign/mining/survival{
	dir = 8
	},
/turf/simulated/shuttle/wall/voidcraft/green,
/area/survivalpod/superpose/SurvivalLeisure)
"K" = (
/obj/effect/floor_decal/techfloor,
/obj/effect/floor_decal/industrial/warning,
/turf/simulated/shuttle/plating,
/area/survivalpod/superpose/SurvivalLeisure)
"L" = (
/obj/effect/floor_decal/spline/plain{
	dir = 8
	},
/turf/simulated/floor/boxing{
	name = "yoga mat"
	},
/area/survivalpod/superpose/SurvivalLeisure)
"M" = (
/turf/simulated/shuttle/plating,
/area/survivalpod/superpose/SurvivalLeisure)
"N" = (
/obj/structure/fans/tiny,
/obj/effect/floor_decal/industrial/danger/full,
/obj/machinery/door/airlock/voidcraft/survival_pod,
/turf/simulated/floor/tiled/techmaint,
/area/survivalpod/superpose/SurvivalLeisure)
"O" = (
/turf/simulated/shuttle/wall/voidcraft/survival/hard_corner,
/area/survivalpod/superpose/SurvivalLeisure)
"P" = (
/turf/simulated/floor/boxing/gym,
/area/survivalpod/superpose/SurvivalLeisure)
"Q" = (
/obj/structure/bed/chair/oldsofa{
	dir = 4
	},
/turf/simulated/floor/carpet,
/area/survivalpod/superpose/SurvivalLeisure)
"R" = (
/obj/structure/window/reinforced/survival_pod{
	dir = 1
	},
/obj/machinery/fitness/heavy/lifter,
/turf/simulated/floor/boxing/gym,
/area/survivalpod/superpose/SurvivalLeisure)
"S" = (
/obj/effect/floor_decal/spline/plain{
	dir = 8
	},
/obj/structure/window/reinforced/survival_pod{
	dir = 1
	},
/obj/machinery/vending/fitness,
/turf/simulated/floor/boxing/gym,
/area/survivalpod/superpose/SurvivalLeisure)
"T" = (
/obj/structure/bed/chair/oldsofa{
	dir = 1
	},
/obj/machinery/light,
/turf/simulated/floor/carpet,
/area/survivalpod/superpose/SurvivalLeisure)
"U" = (
/obj/effect/floor_decal/spline/plain,
/turf/simulated/floor/wood,
/area/survivalpod/superpose/SurvivalLeisure)
"V" = (
/turf/simulated/floor/boxing{
	name = "yoga mat"
	},
/area/survivalpod/superpose/SurvivalLeisure)
"W" = (
/obj/machinery/light{
	dir = 8
	},
/turf/simulated/floor/wood,
/area/survivalpod/superpose/SurvivalLeisure)
"X" = (
/obj/structure/fitness/punchingbag,
/obj/machinery/light,
/turf/simulated/floor/boxing/gym,
/area/survivalpod/superpose/SurvivalLeisure)
"Y" = (
/obj/structure/sign/mining/survival,
/turf/simulated/shuttle/wall/voidcraft/green,
/area/survivalpod/superpose/SurvivalLeisure)
"Z" = (
/obj/effect/floor_decal/spline/plain{
	dir = 8
	},
/turf/simulated/floor/boxing/gym,
/area/survivalpod/superpose/SurvivalLeisure)

(1,1,1) = {"
I
O
J
g
r
g
J
O
I
"}
(2,1,1) = {"
O
d
W
z
U
H
Q
b
O
"}
(3,1,1) = {"
x
D
l
o
U
A
j
T
Y
"}
(4,1,1) = {"
g
C
m
G
f
v
s
B
g
"}
(5,1,1) = {"
N
h
M
M
M
M
M
K
N
"}
(6,1,1) = {"
g
c
L
L
t
S
Z
F
g
"}
(7,1,1) = {"
y
p
V
V
k
R
P
X
x
"}
(8,1,1) = {"
O
n
a
w
q
E
i
u
O
"}
(9,1,1) = {"
I
O
e
g
r
g
e
O
I
"}
