"ax" = (/turf/simulated/shuttle/wall/voidcraft/survival/hard_corner,/area/survivalpod/superpose/SurvivalScience)
"cv" = (/obj/structure/fans/tiny,/obj/effect/floor_decal/industrial/danger/full,/obj/machinery/door/airlock/voidcraft/survival_pod,/turf/simulated/floor/tiled/techmaint,/area/survivalpod/superpose/SurvivalScience)
"eI" = (/obj/structure/window/reinforced/survival_pod{dir = 1},/obj/machinery/atmospherics/unary/vent_pump{dir = 8; external_pressure_bound = 0; external_pressure_bound_default = 0; icon_state = "map_vent_in"; initialize_directions = 8; internal_pressure_bound = 4000; internal_pressure_bound_default = 4000; pressure_checks = 2; pressure_checks_default = 2; pump_direction = 0; use_power = 1},/turf/simulated/floor/bluegrid{name = "Server Base"; nitrogen = 500; oxygen = 0; temperature = 80},/area/survivalpod/superpose/SurvivalScience)
"eX" = (/obj/machinery/r_n_d/server/robotics,/obj/structure/window/reinforced/survival_pod{dir = 8},/obj/machinery/atmospherics/pipe/simple/hidden{dir = 5},/turf/simulated/floor/bluegrid{name = "Server Base"; nitrogen = 500; oxygen = 0; temperature = 80},/area/survivalpod/superpose/SurvivalScience)
"fo" = (/obj/structure/tubes,/obj/machinery/computer/rdservercontrol{dir = 8},/obj/structure/window/reinforced/survival_pod{opacity = 1},/turf/simulated/shuttle/floor/voidcraft/light,/area/survivalpod/superpose/SurvivalScience)
"fS" = (/turf/simulated/shuttle/wall/voidcraft/survival,/area/survivalpod/superpose/SurvivalScience)
"gC" = (/obj/structure/table/survival_pod,/obj/structure/window/reinforced/survival_pod{dir = 8; opacity = 1},/obj/machinery/cell_charger{pixel_x = 1; pixel_y = -2},/obj/machinery/recharger{pixel_x = -3; pixel_y = 9},/obj/structure/window/reinforced/survival_pod{opacity = 1},/obj/item/weapon/reagent_containers/food/drinks/jar{pixel_x = 10; pixel_y = 12},/turf/simulated/shuttle/floor/voidcraft/light,/area/survivalpod/superpose/SurvivalScience)
"gN" = (/obj/machinery/light{dir = 1},/turf/simulated/shuttle/plating/skipjack,/area/survivalpod/superpose/SurvivalScience)
"gW" = (/obj/machinery/r_n_d/destructive_analyzer,/turf/simulated/shuttle/floor/voidcraft/light,/area/survivalpod/superpose/SurvivalScience)
"gY" = (/obj/structure/fans/tiny,/obj/effect/floor_decal/industrial/danger/full,/obj/machinery/door/airlock/voidcraft/vertical,/turf/simulated/shuttle/floor/voidcraft/dark,/area/survivalpod/superpose/SurvivalScience)
"hp" = (/obj/machinery/computer/rdconsole/core{dir = 4},/obj/machinery/light{dir = 8; layer = 3},/turf/simulated/shuttle/floor/voidcraft/light,/area/survivalpod/superpose/SurvivalScience)
"hW" = (/obj/machinery/r_n_d/protolathe,/obj/structure/sign/periodic{pixel_y = 29},/turf/simulated/shuttle/floor/voidcraft/light,/area/survivalpod/superpose/SurvivalScience)
"ku" = (/obj/structure/sign/science,/turf/simulated/shuttle/wall/voidcraft/lightblue,/area/survivalpod/superpose/SurvivalScience)
"mB" = (/obj/structure/reagent_dispensers/fueltank/high,/obj/effect/floor_decal/industrial/outline/yellow,/turf/simulated/shuttle/floor/voidcraft/light,/area/survivalpod/superpose/SurvivalScience)
"mY" = (/obj/effect/floor_decal/techfloor{dir = 1},/obj/effect/floor_decal/industrial/warning{dir = 1},/turf/simulated/shuttle/plating/skipjack,/area/survivalpod/superpose/SurvivalScience)
"nQ" = (/obj/machinery/atmospherics/pipe/manifold/hidden{dir = 8},/obj/effect/floor_decal/industrial/outline/yellow,/obj/machinery/meter,/turf/simulated/shuttle/floor/voidcraft/dark,/area/survivalpod/superpose/SurvivalScience)
"oQ" = (/obj/machinery/autolathe,/obj/effect/floor_decal/industrial/outline/yellow,/obj/machinery/light,/turf/simulated/shuttle/floor/voidcraft/light,/area/survivalpod/superpose/SurvivalScience)
"ph" = (/turf/simulated/shuttle/floor/voidcraft/dark,/area/survivalpod/superpose/SurvivalScience)
"pw" = (/obj/effect/floor_decal/industrial/loading{dir = 1},/turf/simulated/shuttle/floor/voidcraft/light,/area/survivalpod/superpose/SurvivalScience)
"pK" = (/obj/machinery/door/window/survival_pod{dir = 2; req_one_access = null},/turf/simulated/shuttle/floor/voidcraft/light,/area/survivalpod/superpose/SurvivalScience)
"sk" = (/obj/effect/floor_decal/techfloor,/obj/effect/floor_decal/industrial/warning,/turf/simulated/shuttle/plating/skipjack,/area/survivalpod/superpose/SurvivalScience)
"uq" = (/obj/machinery/mecha_part_fabricator,/obj/structure/window/reinforced/survival_pod{dir = 1},/obj/effect/floor_decal/industrial/outline/yellow,/turf/simulated/shuttle/floor/voidcraft/light,/area/survivalpod/superpose/SurvivalScience)
"va" = (/obj/machinery/sleeper/survival_pod,/obj/structure/window/reinforced/survival_pod{dir = 8; opacity = 1},/turf/simulated/shuttle/floor/voidcraft/light,/area/survivalpod/superpose/SurvivalScience)
"vt" = (/obj/structure/sign/mining/survival{dir = 8},/turf/simulated/shuttle/wall/voidcraft/lightblue,/area/survivalpod/superpose/SurvivalScience)
"wq" = (/obj/machinery/smartfridge/survival_pod,/obj/item/weapon/storage/mre/random,/obj/item/weapon/storage/mre/random,/obj/item/weapon/storage/mre/random,/obj/item/weapon/storage/mre/random,/obj/item/weapon/storage/mre/random,/obj/item/weapon/storage/mre/random,/obj/item/weapon/storage/mre/menu9,/obj/item/weapon/storage/mre/menu9,/obj/item/weapon/storage/mre/menu10,/obj/item/weapon/storage/mre/menu10,/obj/item/weapon/storage/mre/menu11,/obj/item/weapon/storage/mre/menu11,/obj/item/device/fbp_backup_cell,/obj/item/device/fbp_backup_cell,/obj/item/device/fbp_backup_cell,/obj/item/device/fbp_backup_cell,/obj/item/device/fbp_backup_cell,/obj/item/weapon/storage/pill_bottle/antitox,/obj/item/weapon/storage/box/survival/space,/obj/item/device/healthanalyzer,/obj/item/weapon/storage/pill_bottle/dice_nerd,/obj/machinery/light{dir = 1},/obj/item/weapon/storage/firstaid/regular,/obj/item/weapon/extinguisher/mini,/obj/item/weapon/extinguisher/mini,/obj/item/weapon/storage/box/survival/space,/obj/item/weapon/storage/box/survival/space,/obj/item/device/radio,/obj/item/device/radio,/obj/item/device/radio,/obj/item/device/starcaster_news,/obj/item/device/starcaster_news,/obj/item/device/threadneedle,/obj/item/device/flashlight,/obj/item/device/flashlight,/obj/item/weapon/storage/toolbox/emergency,/obj/item/weapon/storage/pill_bottle/spaceacillin,/obj/random/soap,/obj/item/weapon/material/knife/machete/hatchet,/obj/item/weapon/storage/box/flare,/turf/simulated/shuttle/floor/voidcraft/light,/area/survivalpod/superpose/SurvivalScience)
"wY" = (/obj/effect/floor_decal/industrial/hatch/yellow,/obj/machinery/recharge_station,/turf/simulated/floor/tiled/techmaint,/area/survivalpod/superpose/SurvivalScience)
"xx" = (/obj/structure/window/reinforced/survival_pod{opacity = 1},/obj/machinery/r_n_d/circuit_imprinter,/obj/item/weapon/reagent_containers/glass/beaker{pixel_x = 9; pixel_y = 8},/turf/simulated/shuttle/floor/voidcraft/light,/area/survivalpod/superpose/SurvivalScience)
"zw" = (/obj/item/device/gps/computer,/turf/simulated/shuttle/floor/voidcraft/light,/area/survivalpod/superpose/SurvivalScience)
"zR" = (/obj/structure/sign/mining,/turf/simulated/shuttle/wall/voidcraft/lightblue,/area/survivalpod/superpose/SurvivalScience)
"AA" = (/obj/structure/bed/pod,/obj/item/weapon/bedsheet/purple,/turf/simulated/shuttle/floor/voidcraft/light,/area/survivalpod/superpose/SurvivalScience)
"AB" = (/obj/structure/bed/chair/office/dark{dir = 8},/turf/simulated/shuttle/floor/voidcraft/light,/area/survivalpod/superpose/SurvivalScience)
"AH" = (/obj/structure/window/reinforced/survival_pod{opacity = 1},/obj/machinery/smartfridge/survival_pod{icon = 'icons/obj/vending.dmi'; icon_base = "smartfridge"; icon_contents = "boxes"; icon_state = "smartfridge"; name = "Advanced storage"; pixel_y = -1},/obj/item/weapon/stock_parts/micro_laser,/obj/item/weapon/stock_parts/micro_laser,/obj/item/weapon/stock_parts/matter_bin,/obj/item/weapon/stock_parts/matter_bin,/obj/item/weapon/stock_parts/console_screen,/obj/item/weapon/stock_parts/console_screen,/obj/item/weapon/storage/toolbox/mechanical{pixel_x = -2; pixel_y = -1},/obj/item/weapon/storage/toolbox/mechanical{pixel_x = -2; pixel_y = -1},/obj/item/clothing/gloves/sterile/latex,/obj/item/clothing/gloves/sterile/latex,/obj/item/weapon/storage/belt/utility,/obj/item/weapon/storage/belt/utility,/obj/item/weapon/cell/high{charge = 100; maxcharge = 15000},/obj/item/weapon/cell/high{charge = 100; maxcharge = 15000},/obj/item/stack/material/copper{amount = 25},/obj/item/stack/material/steel{amount = 50},/obj/item/stack/material/glass{amount = 50; pixel_x = 3; pixel_y = 3},/obj/item/clothing/mask/gas,/obj/item/clothing/mask/gas,/obj/item/weapon/disk/design_disk,/obj/item/weapon/disk/design_disk,/obj/item/weapon/disk/tech_disk,/obj/item/weapon/disk/tech_disk,/turf/simulated/shuttle/floor/voidcraft/light,/area/survivalpod/superpose/SurvivalScience)
"Ct" = (/turf/simulated/shuttle/floor/voidcraft/light,/area/survivalpod/superpose/SurvivalScience)
"Cz" = (/turf/simulated/shuttle/plating/skipjack,/area/survivalpod/superpose/SurvivalScience)
"CX" = (/turf/simulated/shuttle/wall/voidcraft/lightblue,/area/survivalpod/superpose/SurvivalScience)
"EO" = (/obj/structure/sign/mining/survival,/turf/simulated/shuttle/wall/voidcraft/lightblue,/area/survivalpod/superpose/SurvivalScience)
"Gd" = (/obj/structure/window/reinforced/survival_pod{dir = 8},/obj/structure/window/reinforced/survival_pod{dir = 4},/obj/structure/window/reinforced/survival_pod{dir = 1},/obj/structure/window/reinforced/survival_pod,/obj/structure/grille,/obj/structure/curtain/black,/turf/simulated/floor/plating,/area/survivalpod/superpose/SurvivalScience)
"Gt" = (/obj/machinery/r_n_d/server/core,/obj/structure/window/reinforced/survival_pod{dir = 8},/obj/structure/window/reinforced/survival_pod{dir = 1},/obj/machinery/atmospherics/pipe/manifold/hidden{dir = 8},/turf/simulated/floor/bluegrid{name = "Server Base"; nitrogen = 500; oxygen = 0; temperature = 80},/area/survivalpod/superpose/SurvivalScience)
"Gx" = (/obj/structure/sign/mining/survival{dir = 4},/turf/simulated/shuttle/wall/voidcraft/lightblue,/area/survivalpod/superpose/SurvivalScience)
"HB" = (/obj/machinery/smartfridge/survival_pod{icon = 'icons/obj/vending.dmi'; icon_base = "smartfridge"; icon_contents = "boxes"; icon_state = "smartfridge"; name = "Advanced storage"; pixel_y = -1},/obj/item/weapon/storage/toolbox/mechanical{pixel_x = -2; pixel_y = -1},/obj/item/weapon/storage/toolbox/mechanical{pixel_x = -2; pixel_y = -1},/obj/item/weapon/storage/toolbox/electrical{pixel_x = 1; pixel_y = 6},/obj/item/weapon/storage/toolbox/electrical{pixel_x = 1; pixel_y = 6},/obj/item/weapon/storage/belt/utility,/obj/item/weapon/storage/belt/utility,/obj/item/device/multitool{pixel_x = 3},/obj/item/device/multitool{pixel_x = 3},/obj/item/weapon/tool/crowbar,/obj/item/weapon/tool/crowbar,/obj/item/weapon/tool/crowbar,/obj/structure/window/reinforced/survival_pod{dir = 1},/obj/item/device/mmi,/obj/item/device/mmi,/obj/item/device/mmi,/obj/item/clothing/head/welding{pixel_x = -3; pixel_y = 5},/obj/item/clothing/head/welding{pixel_x = -3; pixel_y = 5},/obj/item/clothing/head/welding/demon,/obj/item/clothing/glasses/welding,/obj/item/clothing/glasses/welding,/obj/item/stack/cable_coil,/obj/item/stack/cable_coil,/obj/item/stack/cable_coil,/obj/item/device/healthanalyzer,/obj/item/device/healthanalyzer,/obj/item/device/flash/synthetic,/obj/item/device/flash/synthetic,/obj/item/device/flash/synthetic,/obj/item/weapon/storage/firstaid/regular{empty = 1; name = "First-Aid (empty)"},/obj/item/weapon/storage/firstaid/regular{empty = 1; name = "First-Aid (empty)"},/obj/item/weapon/cell/high{charge = 100; maxcharge = 15000; pixel_x = 5; pixel_y = -5},/obj/item/weapon/cell/high{charge = 100; maxcharge = 15000; pixel_x = 5; pixel_y = -5},/obj/item/device/assembly/prox_sensor{pixel_x = -8; pixel_y = 4},/obj/item/device/assembly/prox_sensor{pixel_x = -8; pixel_y = 4},/obj/item/stack/material/copper{amount = 25},/obj/item/stack/material/plastic{max_amount = 25},/obj/item/stack/material/plastic{max_amount = 25},/obj/item/stack/material/plasteel{amount = 10},/obj/item/stack/material/plasteel{amount = 10},/obj/item/stack/material/glass{amount = 50; pixel_x = -2; pixel_y = 2},/obj/item/stack/material/glass{amount = 50; pixel_x = -2; pixel_y = 2},/obj/item/stack/material/glass{amount = 50; pixel_x = -2; pixel_y = 2},/obj/item/stack/material/glass{amount = 50; pixel_x = -2; pixel_y = 2},/obj/item/stack/material/steel{amount = 50},/obj/item/stack/material/steel{amount = 50},/obj/item/stack/material/steel{amount = 50},/obj/item/stack/material/steel{amount = 50},/obj/item/device/flash,/obj/item/device/flash,/obj/effect/floor_decal/industrial/outline/yellow,/obj/item/clothing/mask/gas,/obj/item/clothing/mask/gas,/obj/item/weapon/implanter,/obj/item/weapon/implanter,/obj/item/weapon/implanter,/obj/item/weapon/storage/backpack/dufflebag/sci,/turf/simulated/shuttle/floor/voidcraft/light,/area/survivalpod/superpose/SurvivalScience)
"IJ" = (/obj/structure/fans,/obj/structure/window/reinforced/survival_pod{dir = 8; opacity = 1},/turf/simulated/shuttle/floor/voidcraft/light,/area/survivalpod/superpose/SurvivalScience)
"Ko" = (/obj/structure/table/reinforced,/obj/item/modular_computer/laptop/preset/custom_loadout/advanced,/turf/simulated/shuttle/floor/voidcraft/light,/area/survivalpod/superpose/SurvivalScience)
"Mf" = (/obj/machinery/portable_atmospherics/canister/nitrogen,/obj/machinery/atmospherics/portables_connector{dir = 8},/obj/machinery/power/apc/alarms_hidden{dir = 4; pixel_x = 20},/turf/simulated/shuttle/floor/voidcraft/dark,/area/survivalpod/superpose/SurvivalScience)
"Nt" = (/obj/machinery/mech_recharger,/obj/machinery/newscaster{layer = 3.3; pixel_y = -27},/obj/mecha/medical/odysseus/old,/obj/effect/floor_decal/industrial/warning/full,/turf/simulated/floor/tiled/techmaint,/area/survivalpod/superpose/SurvivalScience)
"NV" = (/obj/structure/reagent_dispensers/acid{pixel_x = -30},/obj/structure/sink/kitchen{dir = 8; pixel_x = -13},/turf/simulated/shuttle/floor/voidcraft/light,/area/survivalpod/superpose/SurvivalScience)
"PD" = (/obj/machinery/atmospherics/pipe/simple/hidden{dir = 6},/turf/simulated/shuttle/floor/voidcraft/dark,/area/survivalpod/superpose/SurvivalScience)
"Qx" = (/obj/machinery/mecha_part_fabricator/pros,/obj/structure/window/reinforced/survival_pod{dir = 1},/obj/effect/floor_decal/industrial/outline/yellow,/turf/simulated/shuttle/floor/voidcraft/light,/area/survivalpod/superpose/SurvivalScience)
"TK" = (/obj/effect/floor_decal/techfloor{dir = 8},/obj/effect/floor_decal/industrial/warning{dir = 8},/turf/simulated/shuttle/plating/skipjack,/area/survivalpod/superpose/SurvivalScience)
"TY" = (/obj/structure/closet/secure_closet/guncabinet/phase{pixel_y = -32},/obj/item/weapon/gun/energy/locked/phasegun/pistol,/obj/item/weapon/gun/energy/locked/phasegun/pistol,/obj/item/clothing/accessory/permit/gun/planetside,/obj/item/clothing/accessory/permit/gun/planetside,/obj/item/clothing/accessory/holster/waist,/obj/item/clothing/accessory/holster/waist,/obj/effect/floor_decal/industrial/outline/yellow,/turf/simulated/shuttle/floor/voidcraft/dark,/area/survivalpod/superpose/SurvivalScience)
"Vp" = (/obj/structure/window/reinforced/survival_pod{opacity = 1},/obj/structure/table/reinforced,/obj/item/weapon/paper_bin{pixel_x = -3; pixel_y = 7},/obj/item/weapon/clipboard,/obj/item/weapon/folder/white,/obj/item/weapon/pen,/obj/item/weapon/reagent_containers/dropper{pixel_y = -4},/turf/simulated/shuttle/floor/voidcraft/light,/area/survivalpod/superpose/SurvivalScience)
"VG" = (/obj/machinery/atmospherics/unary/vent_pump{dir = 8; icon_state = "map_vent_out"; use_power = 1},/obj/machinery/light/small{dir = 4},/turf/simulated/floor/bluegrid{name = "Server Base"; nitrogen = 500; oxygen = 0; temperature = 80},/area/survivalpod/superpose/SurvivalScience)
"Yk" = (/obj/machinery/mech_recharger,/obj/effect/floor_decal/industrial/warning/full,/turf/simulated/floor/tiled/techmaint,/area/survivalpod/superpose/SurvivalScience)
"Zq" = (/obj/machinery/atmospherics/unary/freezer{dir = 8; icon_state = "freezer_1"; power_setting = 20; set_temperature = 73; use_power = 1},/obj/machinery/light{dir = 4},/turf/simulated/shuttle/floor/voidcraft/dark,/area/survivalpod/superpose/SurvivalScience)

(1,1,1) = {"
fSaxGdkucvCXzRaxfS
axhWKogWmYIJwqzwax
vthpABCtCzvapwAAGd
CXAHVpxxCzgCpKfoCX
gYTKCzgNCzphPDMfax
CXQxHBuqCzwYnQZqCX
vtNVCtCtCzYkGteIGx
axmBoQTYskNteXVGax
fSaxzRCXcvCXEOaxfS
"}
