//MAP CONVERTED BY dmm2tgm.py THIS HEADER COMMENT PREVENTS RECONVERSION, DO NOT REMOVE
"a" = (
/obj/item/flashlight/lamp/green,
/obj/structure/table/woodentable,
/turf/simulated/floor/wood,
/area/survivalpod/superpose/SurvivalHome)
"b" = (
/obj/machinery/door/window/survival_pod,
/turf/simulated/shuttle/floor/voidcraft/dark,
/area/survivalpod/superpose/SurvivalHome)
"c" = (
/obj/machinery/door/airlock/maintenance/common{
	name = "Dorm"
	},
/turf/simulated/floor/plating,
/area/survivalpod/superpose/SurvivalHome)
"d" = (
/turf/simulated/shuttle/floor/voidcraft/light,
/area/survivalpod/superpose/SurvivalHome)
"e" = (
/obj/structure/window/reinforced/survival_pod{
	dir = 4
	},
/obj/structure/sink/kitchen{
	dir = 4;
	pixel_x = 4;
	pixel_y = 2
	},
/turf/simulated/shuttle/floor/voidcraft/dark,
/area/survivalpod/superpose/SurvivalHome)
"g" = (
/obj/structure/sign/mining/survival{
	dir = 8
	},
/turf/simulated/shuttle/wall/voidcraft/green,
/area/survivalpod/superpose/SurvivalHome)
"h" = (
/obj/structure/table/steel_reinforced,
/obj/item/storage/pill_bottle/dice_nerd,
/obj/item/deck/cards,
/turf/simulated/floor/carpet,
/area/survivalpod/superpose/SurvivalHome)
"i" = (
/obj/structure/bed/chair/comfy/blue{
	dir = 8
	},
/turf/simulated/floor/carpet,
/area/survivalpod/superpose/SurvivalHome)
"k" = (
/obj/structure/table/steel_reinforced,
/obj/item/deck/cah{
	pixel_x = 2;
	pixel_y = 2
	},
/obj/item/deck/cah/black{
	pixel_x = -2;
	pixel_y = -2
	},
/obj/item/deck/tarot{
	pixel_x = -4;
	pixel_y = 5
	},
/obj/machinery/computer/security/telescreen/entertainment{
	pixel_y = 28
	},
/turf/simulated/floor/carpet,
/area/survivalpod/superpose/SurvivalHome)
"l" = (
/obj/structure/closet/walllocker_double/survival/south,
/turf/simulated/shuttle/plating,
/area/survivalpod/superpose/SurvivalHome)
"m" = (
/turf/simulated/shuttle/wall/voidcraft/survival,
/area/survivalpod/superpose/SurvivalHome)
"n" = (
/obj/structure/closet/cabinet,
/turf/simulated/floor/wood,
/area/survivalpod/superpose/SurvivalHome)
"o" = (
/obj/structure/sign/mining/survival{
	dir = 1
	},
/turf/simulated/shuttle/wall/voidcraft/green,
/area/survivalpod/superpose/SurvivalHome)
"p" = (
/obj/structure/bed/double,
/obj/item/bedsheet/hosdouble,
/turf/simulated/floor/wood,
/area/survivalpod/superpose/SurvivalHome)
"q" = (
/obj/structure/bed/chair/comfy/blue{
	dir = 8
	},
/obj/structure/closet/walllocker_double/survival/north,
/turf/simulated/floor/carpet,
/area/survivalpod/superpose/SurvivalHome)
"r" = (
/turf/simulated/floor/wood,
/area/survivalpod/superpose/SurvivalHome)
"t" = (
/obj/structure/window/reinforced/survival_pod{
	dir = 4
	},
/obj/machinery/microwave{
	pixel_x = -4;
	pixel_y = 17
	},
/obj/structure/table/steel{
	pixel_x = -4
	},
/obj/item/storage/box/donkpockets{
	pixel_x = -7;
	pixel_y = -3
	},
/obj/item/storage/box/donkpockets{
	pixel_x = 7;
	pixel_y = -3
	},
/turf/simulated/shuttle/floor/voidcraft/dark,
/area/survivalpod/superpose/SurvivalHome)
"v" = (
/obj/structure/fans/tiny,
/obj/effect/floor_decal/industrial/danger/full,
/obj/machinery/door/airlock/voidcraft/vertical,
/turf/simulated/floor/tiled/techmaint,
/area/survivalpod/superpose/SurvivalHome)
"x" = (
/obj/effect/floor_decal/techfloor{
	dir = 8
	},
/obj/effect/floor_decal/industrial/warning{
	dir = 8
	},
/turf/simulated/shuttle/plating,
/area/survivalpod/superpose/SurvivalHome)
"y" = (
/obj/item/gps,
/obj/item/sticky_pad/random,
/obj/item/starcaster_news,
/obj/item/pen/blue,
/obj/item/pda,
/obj/item/card/id/external,
/obj/item/storage/mre/random,
/obj/item/storage/mre/random,
/obj/item/reagent_containers/food/drinks/cans/waterbottle,
/obj/item/reagent_containers/food/drinks/cans/waterbottle,
/obj/item/reagent_containers/food/snacks/sosjerky,
/obj/item/reagent_containers/food/snacks/sosjerky,
/obj/item/gun/energy/locked/phasegun/pistol,
/obj/item/material/knife/tacknife/survival,
/obj/item/clothing/accessory/permit/gun,
/obj/item/camera,
/obj/item/binoculars,
/obj/item/threadneedle,
/obj/random/soap,
/obj/item/towel/random,
/obj/item/bodybag/cryobag,
/obj/item/flashlight/flare,
/obj/item/flashlight/flare,
/obj/item/flashlight/color/yellow,
/obj/item/radio,
/obj/item/radio,
/obj/item/flame/lighter/random,
/obj/item/cell/device/hyper,
/obj/item/cell/device/hyper,
/obj/item/extinguisher/mini,
/obj/item/reagent_containers/glass/beaker/vial/tricordrazine,
/obj/item/reagent_containers/glass/beaker/vial/tricordrazine,
/obj/item/reagent_containers/pill/spaceacillin,
/obj/item/reagent_containers/pill/spaceacillin,
/obj/item/fbp_backup_cell,
/obj/item/fbp_backup_cell,
/obj/item/suit_cooling_unit/emergency,
/obj/item/stack/nanopaste,
/obj/item/reagent_containers/hypospray/autoinjector/biginjector/clotting,
/obj/item/storage/backpack/messenger,
/obj/item/clothing/accessory/storage/black_drop_pouches,
/obj/item/clothing/accessory/poncho/thermal,
/obj/item/storage/box/survival/comp,
/obj/item/storage/toolbox/brass,
/obj/item/storage/box/khcrystal,
/obj/structure/closet/walllocker_double/survival/south,
/turf/simulated/floor/wood,
/area/survivalpod/superpose/SurvivalHome)
"z" = (
/obj/machinery/power/apc/alarms_hidden{
	pixel_y = -20
	},
/turf/simulated/shuttle/floor/voidcraft/light,
/area/survivalpod/superpose/SurvivalHome)
"A" = (
/obj/structure/bed/double,
/obj/item/bedsheet/cedouble,
/turf/simulated/floor/wood,
/area/survivalpod/superpose/SurvivalHome)
"B" = (
/obj/machinery/light{
	dir = 1
	},
/turf/simulated/shuttle/plating,
/area/survivalpod/superpose/SurvivalHome)
"E" = (
/turf/simulated/shuttle/plating,
/area/survivalpod/superpose/SurvivalHome)
"I" = (
/obj/structure/bed/chair/comfy/blue{
	dir = 4
	},
/turf/simulated/floor/carpet,
/area/survivalpod/superpose/SurvivalHome)
"J" = (
/turf/simulated/shuttle/floor/voidcraft/dark,
/area/survivalpod/superpose/SurvivalHome)
"K" = (
/turf/simulated/shuttle/wall/voidcraft/green,
/area/survivalpod/superpose/SurvivalHome)
"L" = (
/obj/machinery/smartfridge/survival_pod,
/obj/item/storage/mre/random,
/obj/item/storage/mre/random,
/obj/item/storage/mre/random,
/obj/item/storage/mre/random,
/obj/item/storage/mre/random,
/obj/item/storage/mre/random,
/obj/item/storage/mre/menu9,
/obj/item/storage/mre/menu9,
/obj/item/storage/mre/menu10,
/obj/item/storage/mre/menu10,
/obj/item/storage/mre/menu11,
/obj/item/storage/mre/menu11,
/obj/item/fbp_backup_cell,
/obj/item/fbp_backup_cell,
/obj/item/fbp_backup_cell,
/obj/item/fbp_backup_cell,
/obj/item/fbp_backup_cell,
/obj/item/storage/pill_bottle/antitox,
/obj/item/storage/box/survival/space,
/obj/item/healthanalyzer,
/obj/item/storage/pill_bottle/dice_nerd,
/obj/machinery/light{
	dir = 1
	},
/obj/item/storage/firstaid/regular,
/obj/item/extinguisher/mini,
/obj/item/extinguisher/mini,
/obj/item/storage/box/survival/space,
/obj/item/storage/box/survival/space,
/obj/item/radio,
/obj/item/radio,
/obj/item/radio,
/obj/item/starcaster_news,
/obj/item/starcaster_news,
/obj/item/threadneedle,
/obj/item/flashlight,
/obj/item/flashlight,
/obj/item/storage/toolbox/emergency,
/obj/item/storage/pill_bottle/spaceacillin,
/obj/random/soap,
/obj/item/material/knife/machete/hatchet,
/obj/item/storage/box/flare,
/turf/simulated/shuttle/floor/voidcraft/light,
/area/survivalpod/superpose/SurvivalHome)
"M" = (
/obj/structure/fans,
/turf/simulated/shuttle/floor/voidcraft/light,
/area/survivalpod/superpose/SurvivalHome)
"N" = (
/obj/structure/bed/chair/comfy/blue{
	dir = 4
	},
/obj/machinery/light{
	dir = 8
	},
/obj/structure/closet/walllocker_double/survival/north,
/turf/simulated/floor/carpet,
/area/survivalpod/superpose/SurvivalHome)
"P" = (
/obj/machinery/newscaster{
	pixel_y = -30
	},
/turf/simulated/shuttle/plating,
/area/survivalpod/superpose/SurvivalHome)
"Q" = (
/obj/item/gps/computer,
/turf/simulated/shuttle/floor/voidcraft/light,
/area/survivalpod/superpose/SurvivalHome)
"R" = (
/turf/simulated/shuttle/wall/voidcraft/survival/hard_corner,
/area/survivalpod/superpose/SurvivalHome)
"T" = (
/obj/machinery/vending/wallmed1{
	dir = 4;
	pixel_x = -23
	},
/turf/simulated/shuttle/floor/voidcraft/dark,
/area/survivalpod/superpose/SurvivalHome)
"U" = (
/obj/structure/window/reinforced/survival_pod{
	dir = 8
	},
/obj/structure/window/reinforced/survival_pod{
	dir = 4
	},
/obj/structure/window/reinforced/survival_pod{
	dir = 1
	},
/obj/structure/window/reinforced/survival_pod,
/obj/structure/grille,
/obj/structure/curtain/black,
/turf/simulated/floor/plating,
/area/survivalpod/superpose/SurvivalHome)
"X" = (
/obj/structure/sign/mining/survival{
	dir = 4
	},
/turf/simulated/shuttle/wall/voidcraft/green,
/area/survivalpod/superpose/SurvivalHome)
"Y" = (
/obj/structure/sign/mining/survival,
/turf/simulated/shuttle/wall/voidcraft/green,
/area/survivalpod/superpose/SurvivalHome)
"Z" = (
/obj/effect/floor_decal/techfloor{
	dir = 4
	},
/obj/effect/floor_decal/industrial/warning{
	dir = 4
	},
/turf/simulated/shuttle/plating,
/area/survivalpod/superpose/SurvivalHome)

(1,1,1) = {"
m
K
g
R
v
R
g
K
m
"}
(2,1,1) = {"
K
N
I
T
x
R
n
y
R
"}
(3,1,1) = {"
K
k
h
J
E
c
r
r
U
"}
(4,1,1) = {"
R
q
i
J
l
R
A
a
K
"}
(5,1,1) = {"
R
t
b
e
P
R
R
R
Y
"}
(6,1,1) = {"
R
M
d
R
B
R
n
y
K
"}
(7,1,1) = {"
o
L
d
R
E
c
r
r
U
"}
(8,1,1) = {"
K
Q
z
R
Z
R
p
a
R
"}
(9,1,1) = {"
m
K
X
R
v
R
X
K
m
"}
