//MAP CONVERTED BY dmm2tgm.py THIS HEADER COMMENT PREVENTS RECONVERSION, DO NOT REMOVE
"a" = (
/obj/item/device/flashlight/lamp/green,
/obj/structure/table/woodentable,
/turf/simulated/floor/wood,
/area/space)
"b" = (
/obj/machinery/door/window/survival_pod,
/turf/simulated/shuttle/floor/voidcraft/dark,
/area/space)
"c" = (
/obj/machinery/door/airlock/maintenance/common{
	name = "Dorm"
	},
/turf/simulated/floor/plating,
/area/space)
"d" = (
/turf/simulated/shuttle/floor/voidcraft/light,
/area/space)
"e" = (
/obj/structure/window/reinforced/survival_pod{
	dir = 4
	},
/obj/structure/sink/kitchen{
	dir = 4;
	pixel_x = 4;
	pixel_y = 2
	},
/turf/simulated/shuttle/floor/voidcraft/dark,
/area/space)
"h" = (
/obj/structure/table/steel_reinforced,
/obj/item/weapon/storage/pill_bottle/dice_nerd,
/obj/item/weapon/deck/cards,
/turf/simulated/floor/carpet,
/area/space)
"i" = (
/obj/structure/bed/chair/comfy/blue{
	dir = 8
	},
/turf/simulated/floor/carpet,
/area/space)
"k" = (
/obj/structure/table/steel_reinforced,
/obj/item/weapon/deck/cah{
	pixel_x = 2;
	pixel_y = 2
	},
/obj/item/weapon/deck/cah/black{
	pixel_x = -2;
	pixel_y = -2
	},
/obj/item/weapon/deck/tarot{
	pixel_x = -4;
	pixel_y = 5
	},
/obj/machinery/computer/security/telescreen/entertainment{
	pixel_y = 28
	},
/turf/simulated/floor/carpet,
/area/space)
"m" = (
/turf/simulated/shuttle/wall/voidcraft/survival,
/area/space)
"n" = (
/obj/structure/closet/cabinet,
/turf/simulated/floor/wood,
/area/space)
"p" = (
/obj/structure/bed/double,
/obj/item/weapon/bedsheet/hosdouble,
/turf/simulated/floor/wood,
/area/space)
"q" = (
/obj/structure/bed/chair/comfy/blue{
	dir = 8
	},
/obj/structure/closet/walllocker_double/survival/north,
/turf/simulated/floor/carpet,
/area/space)
"r" = (
/turf/simulated/floor/wood,
/area/space)
"t" = (
/obj/structure/window/reinforced/survival_pod{
	dir = 4
	},
/obj/machinery/microwave{
	pixel_x = -4;
	pixel_y = 17
	},
/obj/structure/table/steel{
	pixel_x = -4
	},
/obj/item/weapon/storage/box/donkpockets{
	pixel_y = -3;
	pixel_x = -7
	},
/obj/item/weapon/storage/box/donkpockets{
	pixel_y = -3;
	pixel_x = 7
	},
/turf/simulated/shuttle/floor/voidcraft/dark,
/area/space)
"v" = (
/obj/structure/fans/tiny,
/obj/effect/floor_decal/industrial/danger/full,
/obj/machinery/door/airlock/voidcraft/vertical,
/turf/simulated/floor/tiled/techmaint,
/area/space)
"x" = (
/obj/effect/floor_decal/techfloor{
	dir = 8
	},
/obj/effect/floor_decal/industrial/warning{
	dir = 8
	},
/turf/simulated/shuttle/plating/skipjack,
/area/space)
"y" = (
/obj/structure/closet/walllocker_double/survival/south,
/turf/simulated/floor/wood,
/area/space)
"z" = (
/obj/machinery/power/apc/alarms_hidden{
	pixel_y = -20
	},
/turf/simulated/shuttle/floor/voidcraft/light,
/area/space)
"A" = (
/obj/structure/bed/double,
/obj/item/weapon/bedsheet/cedouble,
/turf/simulated/floor/wood,
/area/space)
"B" = (
/obj/machinery/light{
	dir = 1
	},
/turf/simulated/shuttle/plating/skipjack,
/area/space)
"E" = (
/turf/simulated/shuttle/plating/skipjack,
/area/space)
"I" = (
/obj/structure/bed/chair/comfy/blue{
	dir = 4
	},
/turf/simulated/floor/carpet,
/area/space)
"J" = (
/turf/simulated/shuttle/floor/voidcraft/dark,
/area/space)
"L" = (
/obj/machinery/smartfridge/survival_pod,
/obj/item/weapon/storage/mre/random,
/obj/item/weapon/storage/mre/random,
/obj/item/weapon/storage/mre/random,
/obj/item/weapon/storage/mre/random,
/obj/item/weapon/storage/mre/random,
/obj/item/weapon/storage/mre/random,
/obj/item/weapon/storage/mre/menu9,
/obj/item/weapon/storage/mre/menu9,
/obj/item/weapon/storage/mre/menu10,
/obj/item/weapon/storage/mre/menu10,
/obj/item/weapon/storage/mre/menu11,
/obj/item/weapon/storage/mre/menu11,
/obj/item/device/fbp_backup_cell,
/obj/item/device/fbp_backup_cell,
/obj/item/device/fbp_backup_cell,
/obj/item/device/fbp_backup_cell,
/obj/item/device/fbp_backup_cell,
/obj/item/weapon/storage/pill_bottle/antitox,
/obj/item/weapon/storage/box/survival/space,
/obj/item/device/healthanalyzer,
/obj/item/weapon/storage/pill_bottle/dice_nerd,
/obj/machinery/light{
	dir = 1
	},
/obj/item/weapon/storage/firstaid/regular,
/obj/item/weapon/extinguisher/mini,
/obj/item/weapon/extinguisher/mini,
/obj/item/weapon/storage/box/survival/space,
/obj/item/weapon/storage/box/survival/space,
/obj/item/device/radio,
/obj/item/device/radio,
/obj/item/device/radio,
/obj/item/device/starcaster_news,
/obj/item/device/starcaster_news,
/obj/item/device/threadneedle,
/obj/item/device/flashlight,
/obj/item/device/flashlight,
/obj/item/weapon/storage/toolbox/emergency,
/obj/item/weapon/storage/pill_bottle/spaceacillin,
/obj/random/soap,
/obj/item/weapon/material/knife/machete/hatchet,
/obj/item/weapon/storage/box/flare,
/turf/simulated/shuttle/floor/voidcraft/light,
/area/space)
"M" = (
/obj/structure/fans,
/turf/simulated/shuttle/floor/voidcraft/light,
/area/space)
"N" = (
/obj/structure/bed/chair/comfy/blue{
	dir = 4
	},
/obj/machinery/light{
	dir = 8
	},
/obj/structure/closet/walllocker_double/survival/north,
/turf/simulated/floor/carpet,
/area/space)
"P" = (
/obj/machinery/newscaster{
	pixel_y = -30
	},
/turf/simulated/shuttle/plating/skipjack,
/area/space)
"Q" = (
/obj/item/device/gps/computer,
/turf/simulated/shuttle/floor/voidcraft/light,
/area/space)
"T" = (
/obj/machinery/vending/wallmed1{
	dir = 4;
	pixel_x = -23
	},
/turf/simulated/shuttle/floor/voidcraft/dark,
/area/space)
"U" = (
/obj/structure/window/reinforced/survival_pod{
	dir = 8
	},
/obj/structure/window/reinforced/survival_pod{
	dir = 4
	},
/obj/structure/window/reinforced/survival_pod{
	dir = 1
	},
/obj/structure/window/reinforced/survival_pod,
/obj/structure/grille,
/obj/structure/curtain/black,
/turf/simulated/floor/plating,
/area/space)
"Z" = (
/obj/effect/floor_decal/techfloor{
	dir = 4
	},
/obj/effect/floor_decal/industrial/warning{
	dir = 4
	},
/turf/simulated/shuttle/plating/skipjack,
/area/space)

(1,1,1) = {"
m
m
m
m
v
m
m
m
m
"}
(2,1,1) = {"
m
N
I
T
x
m
n
y
m
"}
(3,1,1) = {"
m
k
h
J
E
c
r
r
U
"}
(4,1,1) = {"
m
q
i
J
E
m
A
a
m
"}
(5,1,1) = {"
m
t
b
e
P
m
m
m
m
"}
(6,1,1) = {"
m
M
d
m
B
m
n
y
m
"}
(7,1,1) = {"
m
L
d
m
E
c
r
r
U
"}
(8,1,1) = {"
m
Q
z
m
Z
m
p
a
m
"}
(9,1,1) = {"
m
m
m
m
v
m
m
m
m
"}
