//MAP CONVERTED BY dmm2tgm.py THIS HEADER COMMENT PREVENTS RECONVERSION, DO NOT REMOVE
"a" = (
/obj/structure/sink{
	pixel_y = 16
	},
/turf/simulated/shuttle/floor/voidcraft/dark,
/area/survivalpod/superpose/SurvivalJanitor)
"b" = (
/obj/effect/floor_decal/industrial/outline/yellow,
/obj/structure/reagent_dispensers/watertank/high,
/turf/simulated/shuttle/floor/voidcraft/dark,
/area/survivalpod/superpose/SurvivalJanitor)
"c" = (
/obj/structure/fans/tiny,
/obj/effect/floor_decal/industrial/danger/full,
/obj/machinery/door/airlock/voidcraft/vertical,
/turf/simulated/shuttle/floor/voidcraft/dark,
/area/survivalpod/superpose/SurvivalJanitor)
"e" = (
/obj/machinery/door/window/survival_pod{
	dir = 8
	},
/obj/machinery/power/apc/alarms_hidden{
	pixel_y = -20
	},
/turf/simulated/shuttle/floor/voidcraft/light,
/area/survivalpod/superpose/SurvivalJanitor)
"f" = (
/obj/structure/closet/jcloset,
/obj/item/weapon/soap/nanotrasen,
/obj/item/weapon/shovel,
/obj/fiftyspawner/steel,
/obj/item/weapon/storage/briefcase/inflatable,
/obj/item/weapon/pickaxe/silver,
/obj/item/weapon/material/knife/machete/hatchet,
/turf/simulated/shuttle/floor/voidcraft/dark,
/area/survivalpod/superpose/SurvivalJanitor)
"g" = (
/obj/structure/fans,
/obj/structure/window/reinforced/survival_pod{
	dir = 1
	},
/obj/structure/window/reinforced/survival_pod{
	dir = 8
	},
/turf/simulated/shuttle/floor/voidcraft/light,
/area/survivalpod/superpose/SurvivalJanitor)
"h" = (
/obj/machinery/smartfridge/survival_pod,
/obj/item/weapon/storage/mre/random,
/obj/item/weapon/storage/mre/random,
/obj/item/weapon/storage/mre/random,
/obj/item/weapon/storage/mre/random,
/obj/item/weapon/storage/mre/random,
/obj/item/weapon/storage/mre/random,
/obj/item/weapon/storage/mre/menu9,
/obj/item/weapon/storage/mre/menu9,
/obj/item/weapon/storage/mre/menu10,
/obj/item/weapon/storage/mre/menu10,
/obj/item/weapon/storage/mre/menu11,
/obj/item/weapon/storage/mre/menu11,
/obj/item/device/fbp_backup_cell,
/obj/item/device/fbp_backup_cell,
/obj/item/device/fbp_backup_cell,
/obj/item/device/fbp_backup_cell,
/obj/item/device/fbp_backup_cell,
/obj/item/weapon/storage/pill_bottle/antitox,
/obj/item/weapon/storage/box/survival/space,
/obj/item/device/healthanalyzer,
/obj/item/weapon/storage/pill_bottle/dice_nerd,
/obj/item/weapon/storage/firstaid/regular,
/obj/item/weapon/extinguisher/mini,
/obj/item/weapon/extinguisher/mini,
/obj/item/weapon/storage/box/survival/space,
/obj/item/weapon/storage/box/survival/space,
/obj/item/device/radio,
/obj/item/device/radio,
/obj/item/device/radio,
/obj/item/device/starcaster_news,
/obj/item/device/starcaster_news,
/obj/item/device/threadneedle,
/obj/item/device/flashlight,
/obj/item/device/flashlight,
/obj/item/weapon/storage/toolbox/emergency,
/obj/item/weapon/storage/pill_bottle/spaceacillin,
/obj/random/soap,
/obj/item/weapon/material/knife/machete/hatchet,
/obj/item/weapon/storage/box/flare,
/obj/structure/window/reinforced/survival_pod{
	dir = 1
	},
/obj/item/weapon/tape_roll,
/obj/item/weapon/tape_roll,
/obj/item/weapon/packageWrap,
/obj/item/weapon/packageWrap,
/obj/item/weapon/storage/fancy/markers,
/obj/item/weapon/storage/fancy/markers,
/obj/item/weapon/hand_labeler,
/obj/item/weapon/hand_labeler,
/turf/simulated/shuttle/floor/voidcraft/light,
/area/survivalpod/superpose/SurvivalJanitor)
"j" = (
/obj/structure/janitorialcart,
/obj/effect/floor_decal/industrial/outline/yellow,
/turf/simulated/shuttle/floor/voidcraft/dark,
/area/survivalpod/superpose/SurvivalJanitor)
"k" = (
/obj/structure/bed/pod,
/obj/item/weapon/bedsheet/ian,
/turf/simulated/shuttle/floor/voidcraft/light,
/area/survivalpod/superpose/SurvivalJanitor)
"m" = (
/turf/simulated/shuttle/wall/voidcraft/green,
/area/survivalpod/superpose/SurvivalJanitor)
"n" = (
/turf/simulated/shuttle/floor/voidcraft/dark,
/area/survivalpod/superpose/SurvivalJanitor)
"o" = (
/obj/structure/sign/mining/survival{
	dir = 8
	},
/turf/simulated/shuttle/wall/voidcraft/green,
/area/survivalpod/superpose/SurvivalJanitor)
"p" = (
/turf/simulated/shuttle/wall/voidcraft/survival,
/area/survivalpod/superpose/SurvivalJanitor)
"q" = (
/obj/effect/floor_decal/techfloor{
	dir = 4
	},
/obj/effect/floor_decal/industrial/warning{
	dir = 4
	},
/turf/simulated/shuttle/plating,
/area/survivalpod/superpose/SurvivalJanitor)
"t" = (
/obj/structure/closet/jcloset,
/obj/item/weapon/soap/nanotrasen,
/obj/item/weapon/shovel,
/obj/fiftyspawner/steel,
/obj/item/weapon/storage/briefcase/inflatable,
/obj/item/weapon/pickaxe/silver,
/obj/item/weapon/material/knife/machete/hatchet,
/obj/structure/sign/mining,
/turf/simulated/shuttle/floor/voidcraft/dark,
/area/survivalpod/superpose/SurvivalJanitor)
"v" = (
/obj/structure/closet/l3closet/janitor,
/turf/simulated/shuttle/floor/voidcraft/dark,
/area/survivalpod/superpose/SurvivalJanitor)
"w" = (
/obj/machinery/newscaster{
	pixel_y = -30
	},
/turf/simulated/shuttle/floor/voidcraft/dark,
/area/survivalpod/superpose/SurvivalJanitor)
"z" = (
/obj/structure/table/steel,
/obj/item/weapon/reagent_containers/spray/cleaner{
	pixel_x = -8;
	pixel_y = 5
	},
/obj/item/weapon/reagent_containers/spray/cleaner{
	pixel_y = 5
	},
/obj/item/weapon/reagent_containers/spray/cleaner{
	pixel_x = 8;
	pixel_y = 5
	},
/turf/simulated/shuttle/floor/voidcraft/dark,
/area/survivalpod/superpose/SurvivalJanitor)
"A" = (
/obj/structure/window/reinforced/survival_pod{
	dir = 8
	},
/obj/structure/window/reinforced/survival_pod{
	dir = 4
	},
/obj/structure/window/reinforced/survival_pod{
	dir = 1
	},
/obj/structure/window/reinforced/survival_pod,
/obj/structure/grille,
/obj/structure/curtain/black,
/turf/simulated/floor/plating,
/area/survivalpod/superpose/SurvivalJanitor)
"D" = (
/obj/structure/sign/mining/survival,
/turf/simulated/shuttle/wall/voidcraft/survival/hard_corner,
/area/survivalpod/superpose/SurvivalJanitor)
"G" = (
/turf/simulated/shuttle/floor/voidcraft/light,
/area/survivalpod/superpose/SurvivalJanitor)
"H" = (
/turf/simulated/shuttle/wall/voidcraft/survival/hard_corner,
/area/survivalpod/superpose/SurvivalJanitor)
"J" = (
/obj/effect/floor_decal/techfloor{
	dir = 1
	},
/obj/effect/floor_decal/industrial/warning{
	dir = 1
	},
/turf/simulated/shuttle/plating,
/area/survivalpod/superpose/SurvivalJanitor)
"N" = (
/obj/item/device/gps/computer,
/obj/structure/window/reinforced/survival_pod{
	dir = 1
	},
/turf/simulated/shuttle/floor/voidcraft/light,
/area/survivalpod/superpose/SurvivalJanitor)
"O" = (
/obj/structure/sign/mining,
/turf/simulated/shuttle/wall/voidcraft/green,
/area/survivalpod/superpose/SurvivalJanitor)
"P" = (
/obj/structure/mopbucket,
/obj/item/weapon/mop,
/obj/item/weapon/reagent_containers/glass/bucket,
/obj/effect/floor_decal/industrial/outline/yellow,
/turf/simulated/shuttle/floor/voidcraft/dark,
/area/survivalpod/superpose/SurvivalJanitor)
"Q" = (
/obj/structure/table/steel,
/obj/machinery/light,
/obj/item/weapon/storage/box/lights/mixed{
	pixel_x = 8
	},
/obj/item/weapon/storage/box/lights/mixed{
	pixel_x = -8
	},
/obj/item/weapon/storage/box/lights/mixed{
	pixel_x = -8;
	pixel_y = 11
	},
/obj/item/weapon/storage/box/lights/mixed{
	pixel_x = 8;
	pixel_y = 11
	},
/turf/simulated/shuttle/floor/voidcraft/dark,
/area/survivalpod/superpose/SurvivalJanitor)
"R" = (
/obj/structure/sign/mining/survival{
	dir = 1
	},
/turf/simulated/shuttle/wall/voidcraft/green,
/area/survivalpod/superpose/SurvivalJanitor)
"S" = (
/turf/simulated/shuttle/plating,
/area/survivalpod/superpose/SurvivalJanitor)
"V" = (
/obj/structure/mopbucket,
/obj/item/weapon/mop,
/obj/item/weapon/reagent_containers/glass/bucket,
/obj/effect/floor_decal/industrial/outline/yellow,
/obj/machinery/light{
	dir = 1
	},
/turf/simulated/shuttle/floor/voidcraft/dark,
/area/survivalpod/superpose/SurvivalJanitor)
"W" = (
/obj/structure/fans/tiny,
/obj/effect/floor_decal/industrial/danger/full,
/obj/machinery/door/airlock/voidcraft/survival_pod,
/turf/simulated/floor/tiled/techmaint,
/area/survivalpod/superpose/SurvivalJanitor)
"Y" = (
/obj/structure/sign/mining/survival{
	dir = 4
	},
/turf/simulated/shuttle/wall/voidcraft/green,
/area/survivalpod/superpose/SurvivalJanitor)

(1,1,1) = {"
p
O
m
A
m
o
p
"}
(2,1,1) = {"
R
t
f
z
v
v
m
"}
(3,1,1) = {"
m
a
n
n
n
w
m
"}
(4,1,1) = {"
W
J
S
Q
g
e
D
"}
(5,1,1) = {"
p
V
S
j
h
G
A
"}
(6,1,1) = {"
R
P
q
b
N
k
m
"}
(7,1,1) = {"
p
Y
c
H
m
O
p
"}
