//MAP CONVERTED BY dmm2tgm.py THIS HEADER COMMENT PREVENTS RECONVERSION, DO NOT REMOVE
"a" = (
/obj/machinery/sleeper/survival_pod,
/turf/simulated/shuttle/floor/voidcraft/light,
/area/survivalpod/superpose/SurvivalMedical)
"b" = (
/obj/structure/window/reinforced/survival_pod{
	dir = 1
	},
/obj/structure/bed/chair/bay/comfy/blue{
	dir = 4
	},
/turf/simulated/shuttle/floor/voidcraft/dark,
/area/survivalpod/superpose/SurvivalMedical)
"c" = (
/obj/effect/floor_decal/techfloor{
	dir = 8
	},
/obj/effect/floor_decal/industrial/warning{
	dir = 8
	},
/turf/simulated/shuttle/plating,
/area/survivalpod/superpose/SurvivalMedical)
"d" = (
/obj/structure/sign/mining/survival{
	dir = 8
	},
/turf/simulated/shuttle/wall/voidcraft/survival/hard_corner,
/area/survivalpod/superpose/SurvivalMedical)
"e" = (
/obj/machinery/iv_drip,
/obj/effect/floor_decal/industrial/loading{
	dir = 1
	},
/turf/simulated/shuttle/floor/voidcraft/light,
/area/survivalpod/superpose/SurvivalMedical)
"f" = (
/obj/machinery/door/window/survival_pod{
	dir = 1
	},
/turf/simulated/shuttle/floor/voidcraft/dark,
/area/survivalpod/superpose/SurvivalMedical)
"g" = (
/obj/machinery/door/window/survival_pod{
	dir = 1
	},
/turf/simulated/shuttle/floor/voidcraft/light,
/area/survivalpod/superpose/SurvivalMedical)
"h" = (
/obj/structure/table/survival_pod,
/obj/item/storage/firstaid/surgery,
/obj/structure/sink/kitchen{
	dir = 8;
	pixel_x = -13
	},
/obj/machinery/recharger,
/turf/simulated/shuttle/floor/voidcraft/light,
/area/survivalpod/superpose/SurvivalMedical)
"i" = (
/obj/structure/window/reinforced/survival_pod{
	dir = 1
	},
/obj/machinery/vending/medical{
	req_access = null;
	req_log_access = null
	},
/turf/simulated/shuttle/floor/voidcraft/dark,
/area/survivalpod/superpose/SurvivalMedical)
"j" = (
/obj/machinery/smartfridge/survival_pod,
/obj/item/storage/box/bodybags,
/obj/item/clothing/suit/straight_jacket,
/obj/item/clothing/mask/muzzle,
/obj/item/clothing/suit/straight_jacket,
/obj/item/clothing/mask/muzzle,
/obj/item/sleevemate,
/obj/item/roller{
	pixel_y = 8
	},
/obj/item/roller{
	pixel_y = 8
	},
/obj/item/roller{
	pixel_y = 8
	},
/obj/item/reagent_containers/spray/cleaner{
	desc = "Someone has crossed out the Space from Space Cleaner and written in Surgery. 'Do not remove under punishment of death!!!' is scrawled on the back.";
	name = "Surgery Cleaner";
	pixel_x = 2;
	pixel_y = 2
	},
/obj/item/reagent_containers/spray/cleaner{
	desc = "Someone has crossed out the Space from Space Cleaner and written in Surgery. 'Do not remove under punishment of death!!!' is scrawled on the back.";
	name = "Surgery Cleaner";
	pixel_x = 2;
	pixel_y = 2
	},
/obj/item/storage/firstaid/surgery,
/obj/item/defib_kit/compact/loaded,
/obj/item/bodybag/cryobag,
/obj/item/bodybag/cryobag,
/obj/item/extinguisher/mini,
/obj/item/extinguisher/mini,
/obj/item/towel/random,
/obj/item/towel/random,
/obj/item/towel/random,
/obj/item/towel/random,
/obj/item/binoculars,
/obj/item/bluespaceradio,
/obj/item/storage/box/survival/space,
/obj/item/storage/box/survival/space,
/obj/item/storage/box/survival/space,
/obj/item/storage/box/survival/space,
/obj/item/storage/box/survival/comp,
/obj/item/storage/box/survival/comp,
/obj/item/storage/toolbox/mechanical,
/obj/item/radio/emergency,
/obj/item/radio/emergency,
/obj/item/radio/emergency,
/obj/item/radio/emergency,
/obj/item/radio/emergency,
/obj/item/radio/emergency,
/obj/item/storage/backpack/dufflebag/emt,
/turf/simulated/shuttle/floor/voidcraft/light,
/area/survivalpod/superpose/SurvivalMedical)
"k" = (
/obj/machinery/smartfridge/survival_pod,
/obj/item/storage/mre/menu10,
/obj/item/storage/mre/menu10,
/obj/item/storage/mre/menu10,
/obj/item/storage/mre/menu10,
/obj/item/storage/mre/menu11,
/obj/item/storage/mre/menu11,
/obj/item/storage/mre/menu11,
/obj/item/storage/mre/menu11,
/obj/item/fbp_backup_cell,
/obj/item/fbp_backup_cell,
/obj/item/fbp_backup_cell,
/obj/item/fbp_backup_cell,
/obj/item/reagent_containers/glass/beaker/large,
/obj/item/reagent_containers/glass/beaker/large,
/obj/item/reagent_containers/food/drinks/drinkingglass/fitnessflask/glucose,
/obj/item/reagent_containers/food/drinks/drinkingglass/fitnessflask/glucose,
/obj/item/storage/box/freezer,
/obj/item/storage/box/freezer,
/obj/item/reagent_containers/dropper,
/obj/item/reagent_containers/dropper,
/obj/item/reagent_containers/glass/beaker,
/obj/item/reagent_containers/glass/beaker,
/obj/machinery/light{
	dir = 1
	},
/obj/item/defib_kit/loaded,
/obj/item/defib_kit/loaded,
/obj/item/reagent_containers/blood/OMinus,
/obj/item/reagent_containers/blood/OMinus,
/obj/item/reagent_containers/blood/OMinus,
/obj/item/reagent_containers/blood/OMinus,
/obj/item/storage/box/survival/space,
/obj/item/storage/box/survival/space,
/obj/item/radio,
/obj/item/radio,
/obj/item/radio,
/obj/item/starcaster_news,
/obj/item/starcaster_news,
/obj/item/threadneedle,
/obj/item/flashlight,
/obj/item/flashlight,
/obj/item/storage/toolbox/emergency,
/obj/item/storage/pill_bottle/spaceacillin,
/obj/random/soap,
/obj/item/material/knife/machete/hatchet,
/obj/item/storage/box/flare,
/turf/simulated/shuttle/floor/voidcraft/light,
/area/survivalpod/superpose/SurvivalMedical)
"l" = (
/obj/structure/window/reinforced/survival_pod{
	dir = 1
	},
/obj/structure/bed/chair/bay/comfy/blue{
	dir = 8
	},
/turf/simulated/shuttle/floor/voidcraft/dark,
/area/survivalpod/superpose/SurvivalMedical)
"m" = (
/obj/structure/table/survival_pod,
/obj/item/storage/firstaid/toxin,
/obj/item/storage/firstaid/fire{
	pixel_x = 5;
	pixel_y = 5
	},
/turf/simulated/shuttle/floor/voidcraft/light,
/area/survivalpod/superpose/SurvivalMedical)
"n" = (
/obj/item/gps/computer,
/turf/simulated/shuttle/floor/voidcraft/light,
/area/survivalpod/superpose/SurvivalMedical)
"o" = (
/turf/simulated/shuttle/wall/voidcraft/survival/hard_corner,
/area/survivalpod/superpose/SurvivalMedical)
"p" = (
/obj/structure/table/glass,
/obj/structure/closet/secure_closet/guncabinet/phase{
	pixel_y = -32
	},
/obj/item/gun/energy/locked/phasegun/pistol,
/obj/item/gun/energy/locked/phasegun/pistol,
/obj/item/clothing/accessory/permit/gun/planetside,
/obj/item/clothing/accessory/permit/gun/planetside,
/obj/item/clothing/accessory/holster/waist,
/obj/item/clothing/accessory/holster/waist,
/turf/simulated/shuttle/floor/voidcraft/dark,
/area/survivalpod/superpose/SurvivalMedical)
"q" = (
/obj/structure/window/reinforced/survival_pod{
	dir = 1
	},
/obj/machinery/disposal,
/obj/effect/floor_decal/industrial/warning/full,
/obj/structure/disposalpipe/trunk{
	dir = 4
	},
/turf/simulated/shuttle/floor/voidcraft/dark,
/area/survivalpod/superpose/SurvivalMedical)
"r" = (
/obj/structure/table/steel_reinforced,
/obj/machinery/chemical_dispenser/full,
/turf/simulated/shuttle/floor/voidcraft/light,
/area/survivalpod/superpose/SurvivalMedical)
"s" = (
/obj/structure/sign/mining/survival{
	dir = 8
	},
/turf/simulated/shuttle/wall/voidcraft/lightblue,
/area/survivalpod/superpose/SurvivalMedical)
"u" = (
/obj/structure/window/reinforced/survival_pod{
	dir = 1
	},
/obj/structure/table/gamblingtable,
/obj/item/starcaster_news,
/obj/item/deck/cards,
/obj/structure/fireaxecabinet{
	pixel_y = 27
	},
/turf/simulated/shuttle/floor/voidcraft/dark,
/area/survivalpod/superpose/SurvivalMedical)
"v" = (
/obj/structure/sign/mining/survival,
/turf/simulated/shuttle/wall/voidcraft/survival/hard_corner,
/area/survivalpod/superpose/SurvivalMedical)
"w" = (
/obj/machinery/light,
/obj/machinery/sleeper{
	dir = 4
	},
/turf/simulated/shuttle/floor/voidcraft/dark,
/area/survivalpod/superpose/SurvivalMedical)
"x" = (
/obj/structure/table/survival_pod,
/obj/item/storage/firstaid/adv,
/obj/item/storage/firstaid/o2{
	pixel_x = 5;
	pixel_y = 5
	},
/turf/simulated/shuttle/floor/voidcraft/light,
/area/survivalpod/superpose/SurvivalMedical)
"y" = (
/obj/structure/sign/mining,
/turf/simulated/shuttle/wall/voidcraft/survival/hard_corner,
/area/survivalpod/superpose/SurvivalMedical)
"z" = (
/obj/machinery/iv_drip,
/obj/machinery/iv_drip,
/obj/machinery/vending/wallmed1{
	dir = 8;
	pixel_x = 22;
	pixel_y = 3
	},
/turf/simulated/shuttle/floor/voidcraft/light,
/area/survivalpod/superpose/SurvivalMedical)
"A" = (
/obj/structure/fans,
/turf/simulated/shuttle/floor/voidcraft/light,
/area/survivalpod/superpose/SurvivalMedical)
"B" = (
/turf/simulated/shuttle/plating,
/area/survivalpod/superpose/SurvivalMedical)
"C" = (
/obj/structure/sign/mining/survival{
	dir = 1
	},
/turf/simulated/shuttle/wall/voidcraft/survival,
/area/survivalpod/superpose/SurvivalMedical)
"D" = (
/turf/simulated/shuttle/wall/voidcraft/survival,
/area/survivalpod/superpose/SurvivalMedical)
"E" = (
/obj/structure/sign/mining/survival{
	dir = 1
	},
/turf/simulated/shuttle/wall/voidcraft/survival/hard_corner,
/area/survivalpod/superpose/SurvivalMedical)
"F" = (
/obj/structure/bed/padded,
/obj/item/bedsheet/medical,
/obj/structure/curtain/open/privacy,
/turf/simulated/shuttle/floor/voidcraft/light,
/area/survivalpod/superpose/SurvivalMedical)
"G" = (
/obj/machinery/optable,
/obj/machinery/oxygen_pump/anesthetic{
	pixel_x = 32
	},
/turf/simulated/shuttle/floor/voidcraft/light,
/area/survivalpod/superpose/SurvivalMedical)
"H" = (
/obj/structure/sign/nosmoking_2,
/turf/simulated/shuttle/wall/voidcraft/survival/hard_corner,
/area/survivalpod/superpose/SurvivalMedical)
"I" = (
/obj/effect/floor_decal/techfloor{
	dir = 4
	},
/obj/effect/floor_decal/industrial/warning{
	dir = 4
	},
/turf/simulated/shuttle/plating,
/area/survivalpod/superpose/SurvivalMedical)
"J" = (
/obj/structure/table/glass,
/obj/item/storage/box/masks,
/obj/item/storage/box/gloves{
	pixel_x = 4;
	pixel_y = 4
	},
/obj/machinery/newscaster{
	pixel_y = -30
	},
/obj/machinery/power/apc/alarms_hidden{
	dir = 4;
	pixel_x = 20
	},
/turf/simulated/shuttle/floor/voidcraft/dark,
/area/survivalpod/superpose/SurvivalMedical)
"K" = (
/obj/machinery/shower{
	dir = 8
	},
/obj/item/soap/deluxe,
/obj/structure/curtain,
/turf/simulated/shuttle/floor/voidcraft/light,
/area/survivalpod/superpose/SurvivalMedical)
"L" = (
/obj/structure/window/reinforced/survival_pod{
	dir = 1
	},
/obj/structure/toilet{
	dir = 8
	},
/turf/simulated/shuttle/floor/voidcraft/light,
/area/survivalpod/superpose/SurvivalMedical)
"M" = (
/obj/machinery/light/small,
/obj/structure/sink{
	dir = 8;
	pixel_x = -12;
	pixel_y = 2
	},
/turf/simulated/shuttle/floor/voidcraft/light,
/area/survivalpod/superpose/SurvivalMedical)
"N" = (
/obj/effect/floor_decal/industrial/outline,
/turf/simulated/shuttle/floor/voidcraft/dark,
/area/survivalpod/superpose/SurvivalMedical)
"O" = (
/obj/structure/sign/mining/survival{
	dir = 4
	},
/turf/simulated/shuttle/wall/voidcraft/lightblue,
/area/survivalpod/superpose/SurvivalMedical)
"P" = (
/turf/simulated/shuttle/wall/voidcraft/lightblue,
/area/survivalpod/superpose/SurvivalMedical)
"Q" = (
/obj/machinery/sleep_console{
	dir = 4
	},
/turf/simulated/shuttle/floor/voidcraft/dark,
/area/survivalpod/superpose/SurvivalMedical)
"R" = (
/obj/structure/disposalpipe/segment,
/turf/simulated/shuttle/wall/voidcraft/lightblue,
/area/survivalpod/superpose/SurvivalMedical)
"S" = (
/obj/structure/window/reinforced/survival_pod{
	dir = 8
	},
/obj/structure/window/reinforced/survival_pod{
	dir = 4
	},
/obj/structure/window/reinforced/survival_pod{
	dir = 1
	},
/obj/structure/window/reinforced/survival_pod,
/obj/structure/grille,
/obj/structure/curtain/black,
/turf/simulated/floor/plating,
/area/survivalpod/superpose/SurvivalMedical)
"T" = (
/obj/structure/disposalpipe/segment,
/turf/simulated/shuttle/wall/voidcraft/survival,
/area/survivalpod/superpose/SurvivalMedical)
"U" = (
/obj/machinery/light{
	dir = 1
	},
/turf/simulated/shuttle/floor/voidcraft/light,
/area/survivalpod/superpose/SurvivalMedical)
"V" = (
/obj/effect/floor_decal/industrial/danger/full,
/obj/structure/fans/tiny,
/obj/machinery/door/airlock/voidcraft/vertical,
/turf/simulated/floor/tiled/techmaint,
/area/survivalpod/superpose/SurvivalMedical)
"W" = (
/obj/structure/window/reinforced/survival_pod{
	dir = 4
	},
/obj/machinery/washing_machine,
/turf/simulated/shuttle/floor/voidcraft/dark,
/area/survivalpod/superpose/SurvivalMedical)
"X" = (
/obj/structure/disposalpipe/segment{
	dir = 8;
	icon_state = "pipe-c"
	},
/obj/structure/sign/mining/survival{
	dir = 4
	},
/turf/simulated/shuttle/wall/voidcraft/survival/hard_corner,
/area/survivalpod/superpose/SurvivalMedical)
"Y" = (
/turf/simulated/shuttle/floor/voidcraft/light,
/area/survivalpod/superpose/SurvivalMedical)
"Z" = (
/obj/structure/disposalpipe/segment,
/obj/structure/sign/mining/survival{
	dir = 4
	},
/turf/simulated/shuttle/wall/voidcraft/survival/hard_corner,
/area/survivalpod/superpose/SurvivalMedical)

(1,1,1) = {"
D
d
P
P
d
V
P
s
D
"}
(2,1,1) = {"
E
A
a
h
i
c
N
Q
v
"}
(3,1,1) = {"
P
k
e
Y
f
B
N
w
P
"}
(4,1,1) = {"
P
n
G
r
b
B
N
p
P
"}
(5,1,1) = {"
y
o
o
o
u
B
N
J
y
"}
(6,1,1) = {"
P
j
x
m
l
B
W
H
P
"}
(7,1,1) = {"
S
U
Y
Y
f
B
g
M
P
"}
(8,1,1) = {"
C
F
z
F
q
I
L
K
v
"}
(9,1,1) = {"
T
Z
R
R
X
V
P
O
D
"}
