"a" = (/obj/structure/closet/crate,/obj/item/stack/material/plastic{amount = 50},/obj/item/stack/material/plastic{amount = 50},/obj/item/stack/material/plastic{amount = 50},/obj/item/stack/material/plastic{amount = 50},/obj/item/stack/material/steel{amount = 50},/obj/item/stack/material/steel{amount = 50},/obj/item/stack/material/steel{amount = 50},/obj/item/stack/material/steel{amount = 50},/obj/item/stack/material/glass{amount = 50},/obj/item/stack/material/glass{amount = 50},/obj/item/stack/material/glass{amount = 50},/obj/item/stack/material/glass{amount = 50},/obj/item/stack/rods{amount = 50},/obj/item/stack/rods{amount = 50},/obj/item/stack/rods{amount = 50},/obj/item/stack/rods{amount = 50},/obj/item/stack/cable_coil{pixel_x = 3; pixel_y = 3},/obj/item/stack/cable_coil{pixel_x = 3; pixel_y = 3},/obj/item/stack/cable_coil/green,/obj/item/stack/cable_coil/blue,/obj/item/weapon/storage/briefcase/inflatable,/obj/item/weapon/storage/briefcase/inflatable,/obj/item/weapon/storage/briefcase/inflatable,/obj/item/weapon/storage/briefcase/inflatable,/turf/simulated/floor/plating,/area/survivalpod/superpose/SurvivalDIY_7x7)
"c" = (/obj/item/device/gps,/obj/item/sticky_pad/random,/obj/item/device/starcaster_news,/obj/item/weapon/pen/blue,/obj/item/device/pda,/obj/item/weapon/card/id/external,/obj/item/weapon/storage/mre/random,/obj/item/weapon/storage/mre/random,/obj/item/weapon/reagent_containers/food/drinks/cans/waterbottle,/obj/item/weapon/reagent_containers/food/drinks/cans/waterbottle,/obj/item/weapon/reagent_containers/food/snacks/sosjerky,/obj/item/weapon/reagent_containers/food/snacks/sosjerky,/obj/item/weapon/gun/energy/locked/phasegun/pistol,/obj/item/weapon/material/knife/tacknife/survival,/obj/item/clothing/accessory/permit/gun,/obj/item/device/camera,/obj/item/device/binoculars,/obj/item/device/threadneedle,/obj/random/soap,/obj/item/weapon/towel/random,/obj/item/bodybag/cryobag,/obj/item/device/flashlight/flare,/obj/item/device/flashlight/flare,/obj/item/device/flashlight/color/yellow,/obj/item/device/radio,/obj/item/device/radio,/obj/item/weapon/flame/lighter/random,/obj/item/weapon/cell/device/hyper,/obj/item/weapon/cell/device/hyper,/obj/item/weapon/extinguisher/mini,/obj/item/weapon/reagent_containers/glass/beaker/vial/tricordrazine,/obj/item/weapon/reagent_containers/glass/beaker/vial/tricordrazine,/obj/item/weapon/reagent_containers/pill/spaceacillin,/obj/item/weapon/reagent_containers/pill/spaceacillin,/obj/item/device/fbp_backup_cell,/obj/item/device/fbp_backup_cell,/obj/item/device/suit_cooling_unit/emergency,/obj/item/stack/nanopaste,/obj/item/weapon/reagent_containers/hypospray/autoinjector/biginjector/clotting,/obj/item/weapon/storage/backpack/messenger,/obj/item/clothing/accessory/storage/black_drop_pouches,/obj/item/clothing/accessory/poncho/thermal,/obj/item/weapon/storage/box/survival/comp,/obj/item/weapon/storage/toolbox/brass,/obj/item/weapon/storage/box/khcrystal,/obj/structure/closet/crate,/turf/simulated/floor/plating,/area/survivalpod/superpose/SurvivalDIY_7x7)
"d" = (/obj/machinery/autolathe,/obj/item/weapon/rcd/loaded{pixel_x = -4; pixel_y = 10},/obj/item/weapon/rcd_ammo,/obj/item/weapon/rcd_ammo,/turf/simulated/floor/plating,/area/survivalpod/superpose/SurvivalDIY_7x7)
"g" = (/obj/structure/inflatable/door,/turf/simulated/floor/plating,/area/survivalpod/superpose/SurvivalDIY_7x7)
"h" = (/obj/structure/reagent_dispensers/watertank,/turf/simulated/floor/plating,/area/survivalpod/superpose/SurvivalDIY_7x7)
"u" = (/obj/structure/reagent_dispensers/fueltank,/turf/simulated/floor/plating,/area/survivalpod/superpose/SurvivalDIY_7x7)
"w" = (/obj/machinery/power/port_gen/pacman,/obj/item/stack/material/phoron{amount = 25},/turf/simulated/floor/plating,/area/survivalpod/superpose/SurvivalDIY_7x7)
"A" = (/obj/structure/inflatable,/turf/simulated/floor/plating,/area/survivalpod/superpose/SurvivalDIY_7x7)
"C" = (/obj/machinery/portable_atmospherics/powered/pump/filled,/turf/simulated/floor/plating,/area/survivalpod/superpose/SurvivalDIY_7x7)
"D" = (/obj/machinery/portable_atmospherics/canister/oxygen,/turf/simulated/floor/plating,/area/survivalpod/superpose/SurvivalDIY_7x7)
"G" = (/turf/simulated/floor/plating,/area/survivalpod/superpose/SurvivalDIY_7x7)
"H" = (/obj/machinery/space_heater,/turf/simulated/floor/plating,/area/survivalpod/superpose/SurvivalDIY_7x7)
"M" = (/obj/structure/closet/crate,/obj/item/stack/material/cardboard{amount = 50},/obj/item/stack/material/cardboard{amount = 50},/obj/item/stack/material/cardboard{amount = 50},/obj/item/stack/material/cardboard{amount = 50},/obj/fiftyspawner/blucarpet,/obj/fiftyspawner/oracarpet,/obj/fiftyspawner/purcarpet,/obj/fiftyspawner/sblucarpet,/obj/fiftyspawner/tealcarpet,/obj/fiftyspawner/turcarpet,/obj/item/stack/material/wood{amount = 50; color = "#824B28"},/obj/item/stack/material/wood{amount = 50; color = "#824B28"},/obj/item/stack/material/wood/hard{amount = 50},/obj/item/stack/material/wood/hard{amount = 50},/obj/item/stack/material/wood/sif{amount = 50},/obj/item/stack/material/wood/sif{amount = 50},/obj/item/stack/material/marble{amount = 50},/obj/item/stack/material/marble{amount = 50},/obj/item/stack/material/marble{amount = 50},/obj/item/stack/material/cloth{amount = 50},/obj/item/stack/material/cloth{amount = 50},/obj/item/stack/material/algae{amount = 50},/obj/item/stack/material/sandstone,/obj/item/stack/material/sandstone,/obj/item/stack/material/sandstone,/obj/item/stack/material/lead{amount = 30},/obj/item/stack/material/plasteel{amount = 30; pixel_y = 5},/obj/item/stack/material/resin{amount = 50},/obj/item/stack/material/smolebricks{amount = 50},/obj/item/stack/material/smolebricks{amount = 50},/turf/simulated/floor/plating,/area/survivalpod/superpose/SurvivalDIY_7x7)
"S" = (/obj/machinery/floodlight,/turf/simulated/floor/plating,/area/survivalpod/superpose/SurvivalDIY_7x7)
"T" = (/obj/structure/closet/toolcloset,/obj/item/weapon/storage/firstaid/regular,/obj/item/weapon/storage/firstaid/fire,/obj/item/weapon/storage/firstaid/toxin,/obj/item/weapon/storage/firstaid/o2,/obj/item/weapon/module/id_auth,/obj/item/weapon/module/card_reader,/obj/item/weapon/module/cell_power,/obj/item/weapon/module/power_control,/obj/item/weapon/circuitboard/microwave,/obj/item/weapon/circuitboard/mass_driver,/obj/item/weapon/circuitboard/jukebox,/obj/item/weapon/circuitboard/intercom,/obj/item/weapon/circuitboard/firealarm,/obj/item/weapon/circuitboard/airalarm,/obj/item/weapon/cell/high,/obj/item/weapon/cell/high,/obj/item/device/flashlight,/obj/item/device/flashlight,/obj/item/weapon/tape_roll,/obj/item/weapon/tape_roll,/obj/item/weapon/reagent_containers/spray/cleaner,/obj/item/weapon/storage/box/lights/mixed,/obj/item/weapon/storage/box/lights/mixed,/obj/item/weapon/storage/belt/utility/full/multitool,/obj/item/weapon/storage/bag/trash,/obj/item/weapon/storage/bag/trash,/obj/item/weapon/storage/backpack/dufflebag/eng,/obj/item/device/geiger,/obj/item/device/mapping_unit,/turf/simulated/floor/plating,/area/survivalpod/superpose/SurvivalDIY_7x7)

(1,1,1) = {"
AAAAAAA
ATcGgGg
AGGGgGg
AdGwAAA
AGGCShA
AaMDHuA
AAAAAAA
"}
