//MAP CONVERTED BY dmm2tgm.py THIS HEADER COMMENT PREVENTS RECONVERSION, DO NOT REMOVE
"a" = (
/obj/item/storage/mre/random,
/obj/item/storage/mre/random,
/obj/item/storage/mre/random,
/obj/item/storage/mre/random,
/obj/item/storage/mre/random,
/obj/item/storage/mre/random,
/obj/item/storage/mre/menu9,
/obj/item/storage/mre/menu9,
/obj/item/storage/mre/menu10,
/obj/item/storage/mre/menu10,
/obj/item/storage/mre/menu11,
/obj/item/storage/mre/menu11,
/obj/item/fbp_backup_cell,
/obj/item/fbp_backup_cell,
/obj/item/fbp_backup_cell,
/obj/item/fbp_backup_cell,
/obj/item/fbp_backup_cell,
/obj/item/storage/pill_bottle/antitox,
/obj/item/storage/box/survival/space,
/obj/item/healthanalyzer,
/obj/item/storage/pill_bottle/dice_nerd,
/obj/item/storage/firstaid/regular,
/obj/item/extinguisher/mini,
/obj/item/extinguisher/mini,
/obj/item/storage/box/survival/space,
/obj/item/storage/box/survival/space,
/obj/item/radio,
/obj/item/radio,
/obj/item/radio,
/obj/item/starcaster_news,
/obj/item/starcaster_news,
/obj/item/threadneedle,
/obj/item/flashlight,
/obj/item/flashlight,
/obj/item/storage/toolbox/emergency,
/obj/item/storage/pill_bottle/spaceacillin,
/obj/random/soap,
/obj/item/material/knife/machete/hatchet,
/obj/item/storage/box/flare,
/obj/machinery/smartfridge/survival_pod{
	pixel_y = 28
	},
/obj/structure/table/steel_reinforced,
/turf/simulated/shuttle/floor/voidcraft,
/area/survivalpod/superpose/SurvivalBarracks)
"b" = (
/obj/effect/floor_decal/spline/fancy/wood{
	dir = 4
	},
/turf/simulated/floor/carpet/purcarpet,
/area/survivalpod/superpose/SurvivalBarracks)
"c" = (
/obj/machinery/light{
	dir = 4
	},
/turf/simulated/shuttle/plating,
/area/survivalpod/superpose/SurvivalBarracks)
"d" = (
/obj/structure/bed/double,
/obj/item/bedsheet/hopdouble,
/turf/simulated/floor/wood,
/area/survivalpod/superpose/SurvivalBarracks)
"e" = (
/obj/item/storage/backpack/messenger,
/obj/item/reagent_containers/food/drinks/cans/waterbottle,
/obj/item/reagent_containers/food/drinks/cans/waterbottle,
/obj/item/material/knife/tacknife/survival,
/obj/item/reagent_containers/food/snacks/sosjerky,
/obj/item/cell/device/hyper,
/obj/item/reagent_containers/hypospray/autoinjector/trauma,
/obj/item/reagent_containers/hypospray/autoinjector/oxy,
/obj/item/flame/lighter/random,
/obj/item/storage/box/survival/space,
/obj/item/radio,
/obj/item/clothing/accessory/storage/black_drop_pouches,
/obj/item/reagent_containers/pill/dylovene,
/obj/item/reagent_containers/pill/dylovene,
/obj/item/flashlight/maglight,
/obj/item/flashlight/flare,
/obj/item/flashlight/flare,
/obj/random/soap,
/obj/item/gun/energy/locked/phasegun/pistol,
/obj/item/fbp_backup_cell,
/obj/item/pda,
/obj/item/storage/mre/menu11,
/obj/item/storage/mre/menu11,
/obj/item/starcaster_news,
/obj/structure/closet/walllocker_double/north{
	name = "Survival Cabinet"
	},
/obj/effect/floor_decal/spline/fancy/wood{
	dir = 4
	},
/obj/item/suit_cooling_unit/emergency,
/obj/item/gps,
/obj/item/cell/device/weapon,
/turf/simulated/floor/carpet/purcarpet,
/area/survivalpod/superpose/SurvivalBarracks)
"f" = (
/obj/effect/floor_decal/spline/fancy/wood{
	dir = 4
	},
/turf/simulated/floor/carpet,
/area/survivalpod/superpose/SurvivalBarracks)
"g" = (
/turf/simulated/floor/carpet,
/area/survivalpod/superpose/SurvivalBarracks)
"h" = (
/obj/structure/fans{
	pixel_y = 32
	},
/obj/machinery/vending/loadout/clothing,
/turf/simulated/shuttle/floor/voidcraft/dark,
/area/survivalpod/superpose/SurvivalBarracks)
"i" = (
/obj/structure/bed/double,
/obj/item/bedsheet/greendouble,
/turf/simulated/floor/wood,
/area/survivalpod/superpose/SurvivalBarracks)
"j" = (
/obj/structure/table/steel_reinforced,
/obj/item/deck/cah{
	pixel_x = 2;
	pixel_y = 2
	},
/obj/item/deck/cah/black{
	pixel_x = -2;
	pixel_y = -2
	},
/turf/simulated/floor/carpet,
/area/survivalpod/superpose/SurvivalBarracks)
"k" = (
/obj/structure/bed/chair/comfy/blue{
	dir = 4
	},
/obj/machinery/light{
	dir = 8
	},
/turf/simulated/floor/carpet,
/area/survivalpod/superpose/SurvivalBarracks)
"l" = (
/obj/structure/table/steel_reinforced,
/obj/item/deck/cards,
/turf/simulated/floor/carpet,
/area/survivalpod/superpose/SurvivalBarracks)
"m" = (
/obj/machinery/computer/security/telescreen/entertainment{
	pixel_y = 28
	},
/turf/simulated/floor/carpet,
/area/survivalpod/superpose/SurvivalBarracks)
"n" = (
/obj/structure/sign/mining,
/turf/simulated/shuttle/wall/voidcraft/survival/hard_corner,
/area/survivalpod/superpose/SurvivalBarracks)
"o" = (
/turf/simulated/floor/wood,
/area/survivalpod/superpose/SurvivalBarracks)
"p" = (
/obj/effect/floor_decal/techfloor{
	dir = 1
	},
/obj/effect/floor_decal/industrial/warning{
	dir = 1
	},
/turf/simulated/shuttle/plating,
/area/survivalpod/superpose/SurvivalBarracks)
"q" = (
/obj/structure/bed/chair/comfy/blue{
	dir = 4
	},
/turf/simulated/floor/carpet,
/area/survivalpod/superpose/SurvivalBarracks)
"r" = (
/obj/structure/bed/double,
/obj/item/bedsheet/orangedouble,
/turf/simulated/floor/wood,
/area/survivalpod/superpose/SurvivalBarracks)
"s" = (
/obj/machinery/door/airlock/maintenance/common{
	name = "Dorm"
	},
/turf/simulated/floor/tiled/techmaint,
/area/survivalpod/superpose/SurvivalBarracks)
"t" = (
/turf/simulated/shuttle/wall/voidcraft/survival/hard_corner,
/area/survivalpod/superpose/SurvivalBarracks)
"u" = (
/obj/structure/table/standard,
/obj/item/flashlight/lamp{
	pixel_x = -8;
	pixel_y = 13
	},
/obj/item/reagent_containers/food/drinks/cans/waterbottle{
	pixel_x = 5;
	pixel_y = 6
	},
/turf/simulated/floor/wood,
/area/survivalpod/superpose/SurvivalBarracks)
"v" = (
/obj/structure/closet/walllocker_double/south{
	name = "Survival Cabinet"
	},
/obj/item/storage/backpack/messenger,
/obj/item/reagent_containers/food/drinks/cans/waterbottle,
/obj/item/reagent_containers/food/drinks/cans/waterbottle,
/obj/item/material/knife/tacknife/survival,
/obj/item/reagent_containers/food/snacks/sosjerky,
/obj/item/cell/device/hyper,
/obj/item/reagent_containers/hypospray/autoinjector/trauma,
/obj/item/reagent_containers/hypospray/autoinjector/oxy,
/obj/item/flame/lighter/random,
/obj/item/storage/box/survival/space,
/obj/item/radio,
/obj/item/clothing/accessory/storage/black_drop_pouches,
/obj/item/reagent_containers/pill/dylovene,
/obj/item/reagent_containers/pill/dylovene,
/obj/item/flashlight/maglight,
/obj/item/flashlight/flare,
/obj/item/flashlight/flare,
/obj/random/soap,
/obj/item/gun/energy/locked/phasegun/pistol,
/obj/item/fbp_backup_cell,
/obj/item/pda,
/obj/item/storage/mre/menu11,
/obj/item/storage/mre/menu11,
/obj/item/starcaster_news,
/obj/effect/floor_decal/spline/fancy/wood{
	dir = 9
	},
/obj/item/suit_cooling_unit/emergency,
/obj/item/gps,
/obj/item/cell/device/weapon,
/turf/simulated/floor/carpet/gaycarpet,
/area/survivalpod/superpose/SurvivalBarracks)
"w" = (
/obj/machinery/vending/fitness{
	dir = 1
	},
/turf/simulated/shuttle/floor/voidcraft/dark,
/area/survivalpod/superpose/SurvivalBarracks)
"x" = (
/obj/item/gps/computer{
	pixel_y = 0
	},
/obj/structure/table/steel_reinforced,
/turf/simulated/shuttle/floor/voidcraft/dark,
/area/survivalpod/superpose/SurvivalBarracks)
"y" = (
/obj/structure/closet/walllocker_double/south{
	name = "Survival Cabinet"
	},
/obj/item/storage/backpack/messenger,
/obj/item/reagent_containers/food/drinks/cans/waterbottle,
/obj/item/reagent_containers/food/drinks/cans/waterbottle,
/obj/item/material/knife/tacknife/survival,
/obj/item/reagent_containers/food/snacks/sosjerky,
/obj/item/cell/device/hyper,
/obj/item/reagent_containers/hypospray/autoinjector/trauma,
/obj/item/reagent_containers/hypospray/autoinjector/oxy,
/obj/item/flame/lighter/random,
/obj/item/storage/box/survival/space,
/obj/item/radio,
/obj/item/clothing/accessory/storage/black_drop_pouches,
/obj/item/reagent_containers/pill/dylovene,
/obj/item/reagent_containers/pill/dylovene,
/obj/item/flashlight/maglight,
/obj/item/flashlight/flare,
/obj/item/flashlight/flare,
/obj/random/soap,
/obj/item/gun/energy/locked/phasegun/pistol,
/obj/item/fbp_backup_cell,
/obj/item/pda,
/obj/item/storage/mre/menu11,
/obj/item/storage/mre/menu11,
/obj/item/starcaster_news,
/obj/effect/floor_decal/spline/fancy/wood{
	dir = 9
	},
/obj/item/suit_cooling_unit/emergency,
/obj/item/gps,
/obj/item/cell/device/weapon,
/turf/simulated/floor/carpet/blue,
/area/survivalpod/superpose/SurvivalBarracks)
"z" = (
/obj/structure/window/reinforced/survival_pod{
	dir = 8
	},
/obj/structure/window/reinforced/survival_pod{
	dir = 4
	},
/obj/structure/window/reinforced/survival_pod{
	dir = 1
	},
/obj/structure/window/reinforced/survival_pod,
/obj/structure/grille,
/obj/structure/curtain/black,
/turf/simulated/floor/plating,
/area/survivalpod/superpose/SurvivalBarracks)
"A" = (
/obj/structure/bed/chair/comfy/blue{
	dir = 8
	},
/obj/effect/floor_decal/spline/fancy/wood{
	dir = 4
	},
/turf/simulated/floor/carpet,
/area/survivalpod/superpose/SurvivalBarracks)
"B" = (
/obj/machinery/vending/snack{
	dir = 1
	},
/turf/simulated/shuttle/floor/voidcraft/dark,
/area/survivalpod/superpose/SurvivalBarracks)
"C" = (
/obj/structure/fans/tiny,
/obj/effect/floor_decal/industrial/danger/full,
/obj/machinery/door/airlock/voidcraft/survival_pod,
/turf/simulated/floor/tiled/techmaint,
/area/survivalpod/superpose/SurvivalBarracks)
"D" = (
/obj/structure/bed/double,
/obj/item/bedsheet/browndouble,
/turf/simulated/floor/wood,
/area/survivalpod/superpose/SurvivalBarracks)
"E" = (
/obj/effect/floor_decal/spline/fancy/wood{
	dir = 1
	},
/turf/simulated/floor/carpet/gaycarpet,
/area/survivalpod/superpose/SurvivalBarracks)
"F" = (
/obj/effect/floor_decal/spline/fancy/wood{
	dir = 4
	},
/turf/simulated/floor/carpet/oracarpet,
/area/survivalpod/superpose/SurvivalBarracks)
"G" = (
/obj/structure/sign/mining/survival,
/turf/simulated/shuttle/wall/voidcraft/survival/hard_corner,
/area/survivalpod/superpose/SurvivalBarracks)
"H" = (
/obj/structure/bed/chair/comfy/black{
	dir = 1
	},
/turf/simulated/floor/wood,
/area/survivalpod/superpose/SurvivalBarracks)
"I" = (
/turf/simulated/shuttle/wall/voidcraft/survival,
/area/survivalpod/superpose/SurvivalBarracks)
"J" = (
/turf/simulated/shuttle/plating,
/area/survivalpod/superpose/SurvivalBarracks)
"K" = (
/obj/machinery/light{
	dir = 8
	},
/obj/machinery/vending/wallmed1{
	dir = 8;
	pixel_x = 25;
	pixel_y = -1
	},
/turf/simulated/shuttle/plating,
/area/survivalpod/superpose/SurvivalBarracks)
"L" = (
/obj/structure/sign/mining/survival{
	dir = 1
	},
/turf/simulated/shuttle/wall/voidcraft/survival/hard_corner,
/area/survivalpod/superpose/SurvivalBarracks)
"M" = (
/obj/machinery/light{
	dir = 4
	},
/turf/simulated/shuttle/floor/voidcraft/dark,
/area/survivalpod/superpose/SurvivalBarracks)
"N" = (
/obj/machinery/vending/loadout/gadget,
/turf/simulated/shuttle/floor/voidcraft/dark,
/area/survivalpod/superpose/SurvivalBarracks)
"O" = (
/obj/structure/table/steel_reinforced,
/obj/item/paper_bin{
	pixel_x = -3;
	pixel_y = 7
	},
/obj/item/folder/white,
/obj/item/pen,
/obj/item/pen,
/obj/item/pen{
	pixel_x = 4;
	pixel_y = 4
	},
/obj/item/pen{
	pixel_x = 4;
	pixel_y = 4
	},
/turf/simulated/floor/carpet,
/area/survivalpod/superpose/SurvivalBarracks)
"P" = (
/obj/machinery/vending/coffee{
	dir = 1
	},
/turf/simulated/shuttle/floor/voidcraft/dark,
/area/survivalpod/superpose/SurvivalBarracks)
"Q" = (
/obj/effect/floor_decal/spline/fancy/wood{
	dir = 1
	},
/turf/simulated/floor/carpet/blue,
/area/survivalpod/superpose/SurvivalBarracks)
"R" = (
/obj/item/storage/backpack/messenger,
/obj/item/reagent_containers/food/drinks/cans/waterbottle,
/obj/item/reagent_containers/food/drinks/cans/waterbottle,
/obj/item/material/knife/tacknife/survival,
/obj/item/reagent_containers/food/snacks/sosjerky,
/obj/item/cell/device/hyper,
/obj/item/reagent_containers/hypospray/autoinjector/trauma,
/obj/item/reagent_containers/hypospray/autoinjector/oxy,
/obj/item/flame/lighter/random,
/obj/item/storage/box/survival/space,
/obj/item/radio,
/obj/item/clothing/accessory/storage/black_drop_pouches,
/obj/item/reagent_containers/pill/dylovene,
/obj/item/reagent_containers/pill/dylovene,
/obj/item/flashlight/maglight,
/obj/item/flashlight/flare,
/obj/item/flashlight/flare,
/obj/random/soap,
/obj/item/gun/energy/locked/phasegun/pistol,
/obj/item/fbp_backup_cell,
/obj/item/pda,
/obj/item/storage/mre/menu11,
/obj/item/storage/mre/menu11,
/obj/item/starcaster_news,
/obj/structure/closet/walllocker_double/north{
	name = "Survival Cabinet"
	},
/obj/effect/floor_decal/spline/fancy/wood{
	dir = 4
	},
/obj/item/suit_cooling_unit/emergency,
/obj/item/gps,
/obj/item/cell/device/weapon,
/turf/simulated/floor/carpet/oracarpet,
/area/survivalpod/superpose/SurvivalBarracks)
"S" = (
/obj/structure/sign/mining/survival{
	dir = 8
	},
/turf/simulated/shuttle/wall/voidcraft/survival/hard_corner,
/area/survivalpod/superpose/SurvivalBarracks)
"T" = (
/obj/machinery/vending/cigarette{
	dir = 1
	},
/turf/simulated/shuttle/floor/voidcraft/dark,
/area/survivalpod/superpose/SurvivalBarracks)
"U" = (
/turf/simulated/shuttle/floor/voidcraft/dark,
/area/survivalpod/superpose/SurvivalBarracks)
"V" = (
/obj/structure/sign/mining/survival{
	dir = 4
	},
/turf/simulated/shuttle/wall/voidcraft/survival/hard_corner,
/area/survivalpod/superpose/SurvivalBarracks)
"W" = (
/obj/structure/table/steel_reinforced,
/obj/item/storage/pill_bottle/dice_nerd,
/turf/simulated/floor/carpet,
/area/survivalpod/superpose/SurvivalBarracks)
"X" = (
/obj/effect/floor_decal/techfloor,
/obj/effect/floor_decal/industrial/warning,
/turf/simulated/shuttle/plating,
/area/survivalpod/superpose/SurvivalBarracks)
"Y" = (
/turf/simulated/shuttle/wall/voidcraft/green,
/area/survivalpod/superpose/SurvivalBarracks)
"Z" = (
/obj/structure/bed/chair/comfy/black{
	dir = 4
	},
/turf/simulated/floor/wood,
/area/survivalpod/superpose/SurvivalBarracks)

(1,1,1) = {"
I
z
t
S
z
Y
Y
Y
S
t
I
"}
(2,1,1) = {"
t
u
H
t
u
H
t
g
k
q
n
"}
(3,1,1) = {"
L
o
v
t
o
y
t
g
O
l
z
"}
(4,1,1) = {"
Y
D
E
t
i
Q
t
m
j
W
z
"}
(5,1,1) = {"
Y
t
s
t
t
s
t
f
A
A
Y
"}
(6,1,1) = {"
C
p
J
c
J
J
K
J
J
X
C
"}
(7,1,1) = {"
Y
t
s
t
t
s
t
N
U
w
Y
"}
(8,1,1) = {"
Y
R
F
t
e
b
t
h
U
B
Y
"}
(9,1,1) = {"
n
Z
o
t
Z
o
t
a
U
P
G
"}
(10,1,1) = {"
t
u
d
t
u
r
t
x
M
T
t
"}
(11,1,1) = {"
I
z
t
V
z
Y
Y
Y
V
t
I
"}
