"a" = (/obj/structure/sink{pixel_y = 16},/turf/simulated/shuttle/floor/voidcraft/dark,/area/space)
"b" = (/obj/effect/floor_decal/industrial/outline/yellow,/obj/structure/reagent_dispensers/watertank/high,/turf/simulated/shuttle/floor/voidcraft/dark,/area/space)
"c" = (/obj/structure/fans/tiny,/obj/effect/floor_decal/industrial/danger/full,/obj/machinery/door/airlock/voidcraft/vertical,/turf/simulated/shuttle/floor/voidcraft/dark,/area/space)
"e" = (/obj/machinery/door/window/survival_pod{dir = 8},/obj/machinery/power/apc/alarms_hidden{pixel_y = -20},/turf/simulated/shuttle/floor/voidcraft/light,/area/space)
"f" = (/obj/structure/closet/jcloset,/obj/item/weapon/soap/nanotrasen,/obj/item/weapon/shovel,/obj/fiftyspawner/steel,/obj/item/weapon/storage/briefcase/inflatable,/obj/item/weapon/pickaxe/silver,/obj/item/weapon/material/knife/machete/hatchet,/turf/simulated/shuttle/floor/voidcraft/dark,/area/space)
"g" = (/obj/structure/fans,/obj/structure/window/reinforced/survival_pod{dir = 1},/obj/structure/window/reinforced/survival_pod{dir = 8},/turf/simulated/shuttle/floor/voidcraft/light,/area/space)
"h" = (/obj/machinery/smartfridge/survival_pod,/obj/item/weapon/storage/mre/random,/obj/item/weapon/storage/mre/random,/obj/item/weapon/storage/mre/random,/obj/item/weapon/storage/mre/random,/obj/item/weapon/storage/mre/random,/obj/item/weapon/storage/mre/random,/obj/item/weapon/storage/mre/menu9,/obj/item/weapon/storage/mre/menu9,/obj/item/weapon/storage/mre/menu10,/obj/item/weapon/storage/mre/menu10,/obj/item/weapon/storage/mre/menu11,/obj/item/weapon/storage/mre/menu11,/obj/item/device/fbp_backup_cell,/obj/item/device/fbp_backup_cell,/obj/item/device/fbp_backup_cell,/obj/item/device/fbp_backup_cell,/obj/item/device/fbp_backup_cell,/obj/item/weapon/storage/pill_bottle/antitox,/obj/item/weapon/storage/box/survival/space,/obj/item/device/healthanalyzer,/obj/item/weapon/storage/pill_bottle/dice_nerd,/obj/item/weapon/storage/firstaid/regular,/obj/item/weapon/extinguisher/mini,/obj/item/weapon/extinguisher/mini,/obj/item/weapon/storage/box/survival/space,/obj/item/weapon/storage/box/survival/space,/obj/item/device/radio,/obj/item/device/radio,/obj/item/device/radio,/obj/item/device/starcaster_news,/obj/item/device/starcaster_news,/obj/item/device/threadneedle,/obj/item/device/flashlight,/obj/item/device/flashlight,/obj/item/weapon/storage/toolbox/emergency,/obj/item/weapon/storage/pill_bottle/spaceacillin,/obj/random/soap,/obj/item/weapon/material/knife/machete/hatchet,/obj/item/weapon/storage/box/flare,/obj/structure/window/reinforced/survival_pod{dir = 1},/obj/item/weapon/tape_roll,/obj/item/weapon/tape_roll,/obj/item/weapon/packageWrap,/obj/item/weapon/packageWrap,/obj/item/weapon/storage/fancy/markers,/obj/item/weapon/storage/fancy/markers,/obj/item/weapon/hand_labeler,/obj/item/weapon/hand_labeler,/turf/simulated/shuttle/floor/voidcraft/light,/area/space)
"j" = (/obj/structure/janitorialcart,/obj/effect/floor_decal/industrial/outline/yellow,/turf/simulated/shuttle/floor/voidcraft/dark,/area/space)
"k" = (/obj/structure/bed/pod,/obj/item/weapon/bedsheet/ian,/turf/simulated/shuttle/floor/voidcraft/light,/area/space)
"n" = (/turf/simulated/shuttle/floor/voidcraft/dark,/area/space)
"p" = (/turf/simulated/shuttle/wall/voidcraft/survival,/area/space)
"q" = (/obj/effect/floor_decal/techfloor{dir = 4},/obj/effect/floor_decal/industrial/warning{dir = 4},/turf/simulated/shuttle/plating/skipjack,/area/space)
"v" = (/obj/structure/closet/l3closet/janitor,/turf/simulated/shuttle/floor/voidcraft/dark,/area/space)
"w" = (/obj/machinery/newscaster{pixel_y = -30},/turf/simulated/shuttle/floor/voidcraft/dark,/area/space)
"z" = (/obj/structure/table/steel,/obj/item/weapon/reagent_containers/spray/cleaner{pixel_x = -8; pixel_y = 5},/obj/item/weapon/reagent_containers/spray/cleaner{pixel_y = 5},/obj/item/weapon/reagent_containers/spray/cleaner{pixel_x = 8; pixel_y = 5},/turf/simulated/shuttle/floor/voidcraft/dark,/area/space)
"A" = (/obj/structure/window/reinforced/survival_pod{dir = 8},/obj/structure/window/reinforced/survival_pod{dir = 4},/obj/structure/window/reinforced/survival_pod{dir = 1},/obj/structure/window/reinforced/survival_pod,/obj/structure/grille,/obj/structure/curtain/black,/turf/simulated/floor/plating,/area/space)
"G" = (/turf/simulated/shuttle/floor/voidcraft/light,/area/space)
"J" = (/obj/effect/floor_decal/techfloor{dir = 1},/obj/effect/floor_decal/industrial/warning{dir = 1},/turf/simulated/shuttle/plating/skipjack,/area/space)
"N" = (/obj/item/device/gps/computer,/obj/structure/window/reinforced/survival_pod{dir = 1},/turf/simulated/shuttle/floor/voidcraft/light,/area/space)
"P" = (/obj/structure/mopbucket,/obj/item/weapon/mop,/obj/item/weapon/reagent_containers/glass/bucket,/obj/effect/floor_decal/industrial/outline/yellow,/turf/simulated/shuttle/floor/voidcraft/dark,/area/space)
"Q" = (/obj/structure/table/steel,/obj/machinery/light,/obj/item/weapon/storage/box/lights/mixed{pixel_x = 8},/obj/item/weapon/storage/box/lights/mixed{pixel_x = -8},/obj/item/weapon/storage/box/lights/mixed{pixel_x = -8; pixel_y = 11},/obj/item/weapon/storage/box/lights/mixed{pixel_x = 8; pixel_y = 11},/turf/simulated/shuttle/floor/voidcraft/dark,/area/space)
"S" = (/turf/simulated/shuttle/plating/skipjack,/area/space)
"V" = (/obj/structure/mopbucket,/obj/item/weapon/mop,/obj/item/weapon/reagent_containers/glass/bucket,/obj/effect/floor_decal/industrial/outline/yellow,/obj/machinery/light{dir = 1},/turf/simulated/shuttle/floor/voidcraft/dark,/area/space)
"W" = (/obj/structure/fans/tiny,/obj/effect/floor_decal/industrial/danger/full,/obj/machinery/door/airlock/voidcraft/survival_pod,/turf/simulated/floor/tiled/techmaint,/area/space)

(1,1,1) = {"
pppWppp
pfaJVPp
pfnSSqc
AznQjbp
pvnghNp
pvweGkp
ppppApp
"}
