"a" = (/obj/machinery/floodlight,/turf/simulated/floor/plating,/area/survivalpod/superpose/SurvivalDIY_9x9)
"c" = (/obj/structure/closet/crate,/obj/fiftyspawner/plasteel,/obj/fiftyspawner/plasteel,/obj/fiftyspawner/phoronrglass,/obj/fiftyspawner/phoronrglass,/obj/item/stack/material/lead{amount = 50},/obj/item/stack/material/lead{amount = 50},/obj/fiftyspawner/gold,/obj/fiftyspawner/phoron,/turf/simulated/floor/plating,/area/survivalpod/superpose/SurvivalDIY_9x9)
"f" = (/obj/structure/closet/crate,/obj/fiftyspawner/glass,/obj/fiftyspawner/glass,/obj/fiftyspawner/glass,/obj/fiftyspawner/glass,/obj/fiftyspawner/glass,/obj/fiftyspawner/steel,/obj/fiftyspawner/steel,/obj/fiftyspawner/steel,/obj/fiftyspawner/steel,/obj/fiftyspawner/steel,/obj/fiftyspawner/plastic,/obj/fiftyspawner/plastic,/obj/fiftyspawner/plastic,/obj/fiftyspawner/plastic,/obj/fiftyspawner/plastic,/turf/simulated/floor/plating,/area/survivalpod/superpose/SurvivalDIY_9x9)
"g" = (/obj/machinery/autolathe,/obj/item/weapon/rcd/loaded{pixel_x = -4; pixel_y = 10},/obj/item/weapon/rcd_ammo,/obj/item/weapon/rcd_ammo,/turf/simulated/floor/plating,/area/survivalpod/superpose/SurvivalDIY_9x9)
"h" = (/obj/structure/inflatable,/turf/simulated/floor/plating,/area/survivalpod/superpose/SurvivalDIY_9x9)
"i" = (/obj/structure/closet/secure_closet/engineering_welding{locked = 0},/turf/simulated/floor/plating,/area/survivalpod/superpose/SurvivalDIY_9x9)
"o" = (/obj/item/weapon/storage/backpack/messenger,/obj/item/weapon/reagent_containers/food/drinks/cans/waterbottle,/obj/item/weapon/reagent_containers/food/drinks/cans/waterbottle,/obj/item/weapon/material/knife/tacknife/survival,/obj/item/weapon/reagent_containers/food/snacks/sosjerky,/obj/item/weapon/cell/device/hyper,/obj/item/weapon/reagent_containers/hypospray/autoinjector/trauma,/obj/item/weapon/reagent_containers/hypospray/autoinjector/oxy,/obj/item/weapon/flame/lighter/random,/obj/item/weapon/storage/box/survival/space,/obj/item/device/radio,/obj/item/clothing/accessory/storage/black_drop_pouches,/obj/item/weapon/reagent_containers/pill/dylovene,/obj/item/weapon/reagent_containers/pill/dylovene,/obj/item/device/flashlight/maglight,/obj/item/device/flashlight/flare,/obj/item/device/flashlight/flare,/obj/random/soap,/obj/item/weapon/gun/energy/locked/frontier/holdout/unlocked,/obj/item/device/fbp_backup_cell,/obj/item/device/pda,/obj/item/weapon/storage/mre/menu11,/obj/item/weapon/storage/mre/menu11,/obj/item/device/starcaster_news,/obj/effect/floor_decal/spline/fancy/wood{dir = 4},/obj/item/device/suit_cooling_unit/emergency,/obj/item/device/gps,/obj/structure/closet{name = "Survival closet"},/turf/simulated/floor/plating,/area/survivalpod/superpose/SurvivalDIY_9x9)
"q" = (/obj/vehicle/train/engine/quadbike/built{dir = 4},/turf/simulated/floor/plating,/area/survivalpod/superpose/SurvivalDIY_9x9)
"u" = (/turf/simulated/floor/plating,/area/survivalpod/superpose/SurvivalDIY_9x9)
"y" = (/obj/machinery/space_heater,/turf/simulated/floor/plating,/area/survivalpod/superpose/SurvivalDIY_9x9)
"z" = (/obj/structure/closet/toolcloset,/obj/item/weapon/storage/box/lights/mixed,/obj/item/weapon/storage/box/lights/mixed,/obj/item/device/flashlight,/obj/item/weapon/storage/belt/utility/full/multitool,/obj/item/weapon/cell/high,/obj/item/weapon/cell/high,/obj/item/weapon/module/power_control,/obj/item/weapon/module/cell_power,/obj/item/weapon/module/card_reader,/obj/item/weapon/module/id_auth,/obj/item/weapon/storage/firstaid/regular,/turf/simulated/floor/plating,/area/survivalpod/superpose/SurvivalDIY_9x9)
"C" = (/obj/structure/closet/crate,/obj/fiftyspawner/wood,/obj/fiftyspawner/wood,/obj/fiftyspawner/wood/sif,/obj/fiftyspawner/wood/sif,/obj/fiftyspawner/turcarpet,/obj/fiftyspawner/tealcarpet,/obj/fiftyspawner/sblucarpet,/obj/fiftyspawner/purcarpet,/obj/fiftyspawner/oracarpet,/obj/fiftyspawner/blucarpet,/obj/fiftyspawner/marble,/obj/item/weapon/storage/briefcase/inflatable,/obj/item/weapon/storage/briefcase/inflatable,/obj/item/weapon/storage/briefcase/inflatable,/obj/fiftyspawner/cardboard,/obj/fiftyspawner/cardboard,/turf/simulated/floor/plating,/area/survivalpod/superpose/SurvivalDIY_9x9)
"F" = (/obj/machinery/power/port_gen/pacman,/obj/item/stack/material/phoron{amount = 25},/turf/simulated/floor/plating,/area/survivalpod/superpose/SurvivalDIY_9x9)
"H" = (/obj/structure/inflatable/door,/turf/simulated/floor/plating,/area/survivalpod/superpose/SurvivalDIY_9x9)
"I" = (/obj/structure/closet/secure_closet/engineering_electrical,/turf/simulated/floor/plating,/area/survivalpod/superpose/SurvivalDIY_9x9)
"M" = (/obj/machinery/portable_atmospherics/powered/pump/filled,/turf/simulated/floor/plating,/area/survivalpod/superpose/SurvivalDIY_9x9)
"Q" = (/obj/structure/reagent_dispensers/watertank,/turf/simulated/floor/plating,/area/survivalpod/superpose/SurvivalDIY_9x9)
"T" = (/obj/structure/reagent_dispensers/fueltank,/turf/simulated/floor/plating,/area/survivalpod/superpose/SurvivalDIY_9x9)
"V" = (/obj/machinery/portable_atmospherics/canister/oxygen,/turf/simulated/floor/plating,/area/survivalpod/superpose/SurvivalDIY_9x9)

(1,1,1) = {"
hhhhhhhhh
hziIqHuuH
huuuuHuuH
hFguuhhhh
huuuuuuuh
hufCuVTuh
hufcuaauh
huoMuQyuh
hhhhhhhhh
"}
