"a" = (/obj/item/weapon/storage/mre/random,/obj/item/weapon/storage/mre/random,/obj/item/weapon/storage/mre/random,/obj/item/weapon/storage/mre/random,/obj/item/weapon/storage/mre/random,/obj/item/weapon/storage/mre/random,/obj/item/weapon/storage/mre/menu9,/obj/item/weapon/storage/mre/menu9,/obj/item/weapon/storage/mre/menu10,/obj/item/weapon/storage/mre/menu10,/obj/item/weapon/storage/mre/menu11,/obj/item/weapon/storage/mre/menu11,/obj/item/device/fbp_backup_cell,/obj/item/device/fbp_backup_cell,/obj/item/device/fbp_backup_cell,/obj/item/device/fbp_backup_cell,/obj/item/device/fbp_backup_cell,/obj/item/weapon/storage/pill_bottle/antitox,/obj/item/weapon/storage/box/survival/space,/obj/item/device/healthanalyzer,/obj/item/weapon/storage/pill_bottle/dice_nerd,/obj/item/weapon/storage/firstaid/regular,/obj/item/weapon/extinguisher/mini,/obj/item/weapon/extinguisher/mini,/obj/item/weapon/storage/box/survival/space,/obj/item/weapon/storage/box/survival/space,/obj/item/device/radio,/obj/item/device/radio,/obj/item/device/radio,/obj/item/device/starcaster_news,/obj/item/device/starcaster_news,/obj/item/device/threadneedle,/obj/item/device/flashlight,/obj/item/device/flashlight,/obj/item/weapon/storage/toolbox/emergency,/obj/item/weapon/storage/pill_bottle/spaceacillin,/obj/random/soap,/obj/item/weapon/material/knife/machete/hatchet,/obj/item/weapon/storage/box/flare,/obj/machinery/smartfridge/survival_pod{pixel_y = 28},/obj/structure/table/steel_reinforced,/turf/simulated/shuttle/floor/voidcraft,/area/space)
"b" = (/obj/effect/floor_decal/spline/fancy/wood{dir = 4},/turf/simulated/floor/carpet/purcarpet,/area/space)
"c" = (/obj/machinery/light{dir = 4},/turf/simulated/shuttle/plating/skipjack,/area/space)
"d" = (/obj/structure/bed/double,/obj/item/weapon/bedsheet/hopdouble,/turf/simulated/floor/wood,/area/space)
"e" = (/obj/item/weapon/storage/backpack/messenger,/obj/item/weapon/reagent_containers/food/drinks/cans/waterbottle,/obj/item/weapon/reagent_containers/food/drinks/cans/waterbottle,/obj/item/weapon/material/knife/tacknife/survival,/obj/item/weapon/reagent_containers/food/snacks/sosjerky,/obj/item/weapon/cell/device/hyper,/obj/item/weapon/reagent_containers/hypospray/autoinjector/trauma,/obj/item/weapon/reagent_containers/hypospray/autoinjector/oxy,/obj/item/weapon/flame/lighter/random,/obj/item/weapon/storage/box/survival/space,/obj/item/device/radio,/obj/item/clothing/accessory/storage/black_drop_pouches,/obj/item/weapon/reagent_containers/pill/dylovene,/obj/item/weapon/reagent_containers/pill/dylovene,/obj/item/device/flashlight/maglight,/obj/item/device/flashlight/flare,/obj/item/device/flashlight/flare,/obj/random/soap,/obj/item/weapon/gun/energy/locked/frontier/holdout/unlocked,/obj/item/device/fbp_backup_cell,/obj/item/device/pda,/obj/item/weapon/storage/mre/menu11,/obj/item/weapon/storage/mre/menu11,/obj/item/device/starcaster_news,/obj/structure/closet/walllocker_double/north{name = "Survival Cabinet"},/obj/effect/floor_decal/spline/fancy/wood{dir = 4},/obj/item/device/suit_cooling_unit/emergency,/obj/item/device/gps,/turf/simulated/floor/carpet/purcarpet,/area/space)
"f" = (/obj/effect/floor_decal/spline/fancy/wood{dir = 4},/turf/simulated/floor/carpet,/area/space)
"g" = (/turf/simulated/floor/carpet,/area/space)
"h" = (/obj/structure/fans{pixel_y = 32},/obj/machinery/vending/loadout/clothing,/turf/simulated/shuttle/floor/voidcraft/dark,/area/space)
"i" = (/obj/structure/bed/double,/obj/item/weapon/bedsheet/greendouble,/turf/simulated/floor/wood,/area/space)
"j" = (/obj/structure/table/steel_reinforced,/obj/item/weapon/deck/cah{pixel_x = 2; pixel_y = 2},/obj/item/weapon/deck/cah/black{pixel_x = -2; pixel_y = -2},/turf/simulated/floor/carpet,/area/space)
"k" = (/obj/structure/bed/chair/comfy/blue{dir = 4},/obj/machinery/light{dir = 8},/turf/simulated/floor/carpet,/area/space)
"l" = (/obj/structure/table/steel_reinforced,/obj/item/weapon/deck/cards,/turf/simulated/floor/carpet,/area/space)
"m" = (/obj/machinery/computer/security/telescreen/entertainment{pixel_y = 28},/turf/simulated/floor/carpet,/area/space)
"o" = (/turf/simulated/floor/wood,/area/space)
"p" = (/obj/effect/floor_decal/techfloor{dir = 1},/obj/effect/floor_decal/industrial/warning{dir = 1},/turf/simulated/shuttle/plating/skipjack,/area/space)
"q" = (/obj/structure/bed/chair/comfy/blue{dir = 4},/turf/simulated/floor/carpet,/area/space)
"r" = (/obj/structure/bed/double,/obj/item/weapon/bedsheet/orangedouble,/turf/simulated/floor/wood,/area/space)
"s" = (/obj/machinery/door/airlock/maintenance/common{name = "Dorm"},/turf/simulated/floor/tiled/techmaint,/area/space)
"u" = (/obj/structure/table/standard,/obj/item/device/flashlight/lamp{pixel_x = -8; pixel_y = 13},/obj/item/weapon/reagent_containers/food/drinks/cans/waterbottle{pixel_x = 5; pixel_y = 6},/turf/simulated/floor/wood,/area/space)
"v" = (/obj/structure/closet/walllocker_double/south{name = "Survival Cabinet"},/obj/item/weapon/storage/backpack/messenger,/obj/item/weapon/reagent_containers/food/drinks/cans/waterbottle,/obj/item/weapon/reagent_containers/food/drinks/cans/waterbottle,/obj/item/weapon/material/knife/tacknife/survival,/obj/item/weapon/reagent_containers/food/snacks/sosjerky,/obj/item/weapon/cell/device/hyper,/obj/item/weapon/reagent_containers/hypospray/autoinjector/trauma,/obj/item/weapon/reagent_containers/hypospray/autoinjector/oxy,/obj/item/weapon/flame/lighter/random,/obj/item/weapon/storage/box/survival/space,/obj/item/device/radio,/obj/item/clothing/accessory/storage/black_drop_pouches,/obj/item/weapon/reagent_containers/pill/dylovene,/obj/item/weapon/reagent_containers/pill/dylovene,/obj/item/device/flashlight/maglight,/obj/item/device/flashlight/flare,/obj/item/device/flashlight/flare,/obj/random/soap,/obj/item/weapon/gun/energy/locked/frontier/holdout/unlocked,/obj/item/device/fbp_backup_cell,/obj/item/device/pda,/obj/item/weapon/storage/mre/menu11,/obj/item/weapon/storage/mre/menu11,/obj/item/device/starcaster_news,/obj/effect/floor_decal/spline/fancy/wood{dir = 9},/obj/item/device/suit_cooling_unit/emergency,/obj/item/device/gps,/turf/simulated/floor/carpet/gaycarpet,/area/space)
"w" = (/obj/machinery/vending/fitness{dir = 1},/turf/simulated/shuttle/floor/voidcraft/dark,/area/space)
"x" = (/obj/item/device/gps/computer{pixel_y = 0},/obj/structure/table/steel_reinforced,/turf/simulated/shuttle/floor/voidcraft/dark,/area/space)
"y" = (/obj/structure/closet/walllocker_double/south{name = "Survival Cabinet"},/obj/item/weapon/storage/backpack/messenger,/obj/item/weapon/reagent_containers/food/drinks/cans/waterbottle,/obj/item/weapon/reagent_containers/food/drinks/cans/waterbottle,/obj/item/weapon/material/knife/tacknife/survival,/obj/item/weapon/reagent_containers/food/snacks/sosjerky,/obj/item/weapon/cell/device/hyper,/obj/item/weapon/reagent_containers/hypospray/autoinjector/trauma,/obj/item/weapon/reagent_containers/hypospray/autoinjector/oxy,/obj/item/weapon/flame/lighter/random,/obj/item/weapon/storage/box/survival/space,/obj/item/device/radio,/obj/item/clothing/accessory/storage/black_drop_pouches,/obj/item/weapon/reagent_containers/pill/dylovene,/obj/item/weapon/reagent_containers/pill/dylovene,/obj/item/device/flashlight/maglight,/obj/item/device/flashlight/flare,/obj/item/device/flashlight/flare,/obj/random/soap,/obj/item/weapon/gun/energy/locked/frontier/holdout/unlocked,/obj/item/device/fbp_backup_cell,/obj/item/device/pda,/obj/item/weapon/storage/mre/menu11,/obj/item/weapon/storage/mre/menu11,/obj/item/device/starcaster_news,/obj/effect/floor_decal/spline/fancy/wood{dir = 9},/obj/item/device/suit_cooling_unit/emergency,/obj/item/device/gps,/turf/simulated/floor/carpet/blue,/area/space)
"z" = (/obj/structure/window/reinforced/survival_pod{dir = 8},/obj/structure/window/reinforced/survival_pod{dir = 4},/obj/structure/window/reinforced/survival_pod{dir = 1},/obj/structure/window/reinforced/survival_pod,/obj/structure/grille,/obj/structure/curtain/black,/turf/simulated/floor/plating,/area/space)
"A" = (/obj/structure/bed/chair/comfy/blue{dir = 8},/obj/effect/floor_decal/spline/fancy/wood{dir = 4},/turf/simulated/floor/carpet,/area/space)
"B" = (/obj/machinery/vending/snack{dir = 1},/turf/simulated/shuttle/floor/voidcraft/dark,/area/space)
"C" = (/obj/structure/fans/tiny,/obj/effect/floor_decal/industrial/danger/full,/obj/machinery/door/airlock/voidcraft/survival_pod,/turf/simulated/floor/tiled/techmaint,/area/space)
"D" = (/obj/structure/bed/double,/obj/item/weapon/bedsheet/browndouble,/turf/simulated/floor/wood,/area/space)
"E" = (/obj/effect/floor_decal/spline/fancy/wood{dir = 1},/turf/simulated/floor/carpet/gaycarpet,/area/space)
"F" = (/obj/effect/floor_decal/spline/fancy/wood{dir = 4},/turf/simulated/floor/carpet/oracarpet,/area/space)
"H" = (/obj/structure/bed/chair/comfy/black{dir = 1},/turf/simulated/floor/wood,/area/space)
"I" = (/turf/simulated/shuttle/wall/voidcraft/survival,/area/space)
"J" = (/turf/simulated/shuttle/plating/skipjack,/area/space)
"K" = (/obj/machinery/light{dir = 8},/obj/machinery/vending/wallmed1{dir = 8; pixel_x = 25; pixel_y = -1},/turf/simulated/shuttle/plating/skipjack,/area/space)
"M" = (/obj/machinery/light{dir = 4},/turf/simulated/shuttle/floor/voidcraft/dark,/area/space)
"N" = (/obj/machinery/vending/loadout/gadget,/turf/simulated/shuttle/floor/voidcraft/dark,/area/space)
"O" = (/obj/structure/table/steel_reinforced,/obj/item/weapon/paper_bin{pixel_x = -3; pixel_y = 7},/obj/item/weapon/folder/white,/obj/item/weapon/pen,/obj/item/weapon/pen,/obj/item/weapon/pen{pixel_x = 4; pixel_y = 4},/obj/item/weapon/pen{pixel_x = 4; pixel_y = 4},/turf/simulated/floor/carpet,/area/space)
"P" = (/obj/machinery/vending/coffee{dir = 1},/turf/simulated/shuttle/floor/voidcraft/dark,/area/space)
"Q" = (/obj/effect/floor_decal/spline/fancy/wood{dir = 1},/turf/simulated/floor/carpet/blue,/area/space)
"R" = (/obj/item/weapon/storage/backpack/messenger,/obj/item/weapon/reagent_containers/food/drinks/cans/waterbottle,/obj/item/weapon/reagent_containers/food/drinks/cans/waterbottle,/obj/item/weapon/material/knife/tacknife/survival,/obj/item/weapon/reagent_containers/food/snacks/sosjerky,/obj/item/weapon/cell/device/hyper,/obj/item/weapon/reagent_containers/hypospray/autoinjector/trauma,/obj/item/weapon/reagent_containers/hypospray/autoinjector/oxy,/obj/item/weapon/flame/lighter/random,/obj/item/weapon/storage/box/survival/space,/obj/item/device/radio,/obj/item/clothing/accessory/storage/black_drop_pouches,/obj/item/weapon/reagent_containers/pill/dylovene,/obj/item/weapon/reagent_containers/pill/dylovene,/obj/item/device/flashlight/maglight,/obj/item/device/flashlight/flare,/obj/item/device/flashlight/flare,/obj/random/soap,/obj/item/weapon/gun/energy/locked/frontier/holdout/unlocked,/obj/item/device/fbp_backup_cell,/obj/item/device/pda,/obj/item/weapon/storage/mre/menu11,/obj/item/weapon/storage/mre/menu11,/obj/item/device/starcaster_news,/obj/structure/closet/walllocker_double/north{name = "Survival Cabinet"},/obj/effect/floor_decal/spline/fancy/wood{dir = 4},/obj/item/device/suit_cooling_unit/emergency,/obj/item/device/gps,/turf/simulated/floor/carpet/oracarpet,/area/space)
"T" = (/obj/machinery/vending/cigarette{dir = 1},/turf/simulated/shuttle/floor/voidcraft/dark,/area/space)
"U" = (/turf/simulated/shuttle/floor/voidcraft/dark,/area/space)
"W" = (/obj/structure/table/steel_reinforced,/obj/item/weapon/storage/pill_bottle/dice_nerd,/turf/simulated/floor/carpet,/area/space)
"X" = (/obj/effect/floor_decal/techfloor,/obj/effect/floor_decal/industrial/warning,/turf/simulated/shuttle/plating/skipjack,/area/space)
"Z" = (/obj/structure/bed/chair/comfy/black{dir = 4},/turf/simulated/floor/wood,/area/space)

(1,1,1) = {"
IIIIICIIIII
zuoDIpIRZuz
IHvEsJsFodI
IIIIIcIIIII
zuoiIJIeZuz
IHyQsJsborI
IIIIIKIIIII
IggmfJNhaxI
IkOjAJUUUMI
IqlWAXwBPTI
IIzzICIIIII
"}
