"a" = (/turf/simulated/shuttle/floor/voidcraft/light,/area/space)
"b" = (/obj/item/device/tape/random,/obj/item/device/taperecorder,/obj/structure/cable/green{d1 = 4; d2 = 8; icon_state = "4-8"},/obj/item/weapon/paper_bin{pixel_x = -3; pixel_y = 7},/obj/item/weapon/pen,/obj/item/weapon/pen,/obj/structure/table/survival_pod,/turf/simulated/shuttle/floor/voidcraft/light,/area/space)
"c" = (/obj/structure/window/reinforced/survival_pod{dir = 8},/obj/structure/window/reinforced/survival_pod{dir = 4},/obj/structure/window/reinforced/survival_pod{dir = 1},/obj/structure/window/reinforced/survival_pod,/obj/structure/grille,/turf/simulated/floor/plating,/area/space)
"d" = (/obj/machinery/button/remote/blast_door{dir = 8; id = "SP-Cell2"; name = "Cell Door"; pixel_x = -25; pixel_y = 8; req_one_access = list(2,4)},/obj/structure/closet/walllocker_double/survival/south,/obj/effect/floor_decal/industrial/warning/corner{dir = 1},/turf/simulated/shuttle/plating/skipjack,/area/space)
"e" = (/obj/structure/grille,/obj/structure/window/reinforced/polarized{dir = 1; id = "SP-Sec"},/obj/structure/window/reinforced/polarized{dir = 4; id = "SP-Sec"},/obj/structure/window/reinforced/polarized{dir = 8; id = "SP-Sec"},/obj/structure/window/reinforced/polarized{id = "SP-Sec"},/obj/structure/cable/green{d2 = 2; icon_state = "0-2"},/turf/simulated/floor/plating,/area/space)
"f" = (/obj/structure/cable/green{d1 = 4; d2 = 8; icon_state = "4-8"},/turf/simulated/shuttle/plating/skipjack,/area/space)
"g" = (/obj/structure/window/reinforced/polarized{dir = 4; id = "SP-Sec"},/obj/structure/window/reinforced/polarized{id = "SP-Sec"},/obj/machinery/washing_machine{pixel_x = 2; pixel_y = 18},/obj/item/weapon/storage/laundry_basket{pixel_x = -1; pixel_y = -7},/turf/simulated/shuttle/floor/voidcraft/light,/area/space)
"h" = (/obj/structure/grille,/obj/structure/window/reinforced/polarized{dir = 1; id = "SP-Sec"},/obj/structure/window/reinforced/polarized{dir = 4; id = "SP-Sec"},/obj/structure/window/reinforced/polarized{dir = 8; id = "SP-Sec"},/obj/structure/window/reinforced/polarized{id = "SP-Sec"},/obj/structure/cable/green{d1 = 1; d2 = 4; icon_state = "1-4"},/obj/structure/cable/green{d2 = 4; icon_state = "0-4"},/turf/simulated/floor/plating,/area/space)
"i" = (/obj/machinery/shower{dir = 1},/obj/structure/curtain/open/shower,/obj/structure/window/reinforced/survival_pod{dir = 1},/turf/simulated/floor/tiled/freezer,/area/space)
"j" = (/obj/structure/sign/mining/survival{dir = 8},/turf/simulated/shuttle/wall/voidcraft/survival,/area/space)
"l" = (/obj/machinery/door/airlock/maintenance/sec{name = "Security Door"},/obj/structure/cable/green{d1 = 1; d2 = 2; icon_state = "1-2"},/turf/simulated/floor/tiled/techmaint,/area/space)
"m" = (/obj/structure/window/reinforced/survival_pod{dir = 1},/obj/structure/curtain/open/shower,/obj/structure/toilet/prison{dir = 4},/turf/simulated/floor/tiled/freezer,/area/space)
"n" = (/obj/structure/grille,/obj/structure/window/reinforced/polarized{dir = 1; id = "SP-Sec"},/obj/structure/window/reinforced/polarized{dir = 4; id = "SP-Sec"},/obj/structure/window/reinforced/polarized{dir = 8; id = "SP-Sec"},/obj/structure/window/reinforced/polarized{id = "SP-Sec"},/obj/structure/cable/green{d2 = 4; icon_state = "0-4"},/obj/structure/cable/green{d1 = 2; d2 = 4; icon_state = "2-4"},/turf/simulated/floor/plating,/area/space)
"o" = (/obj/structure/closet/secure_closet/brig{id = "Cell"; name = "Cell Locker"},/obj/machinery/light/small,/turf/simulated/shuttle/floor/voidcraft/light,/area/space)
"p" = (/obj/structure/sign/mining/survival{dir = 1},/turf/simulated/shuttle/wall/voidcraft/survival,/area/space)
"q" = (/obj/machinery/light{dir = 4},/obj/effect/floor_decal/industrial/warning{dir = 8},/turf/simulated/shuttle/plating/skipjack,/area/space)
"r" = (/obj/machinery/door/blast/regular{dir = 4; id = "SP-Cell"; name = "Cell Door"},/obj/effect/floor_decal/industrial/danger/full,/turf/simulated/floor/tiled/techmaint,/area/space)
"t" = (/obj/structure/bed/pod,/obj/item/weapon/bedsheet/red,/turf/simulated/shuttle/floor/voidcraft/light,/area/space)
"v" = (/obj/machinery/light{dir = 8},/obj/machinery/button/flasher{id = "SP-Cell flash"; name = "Cell Flash"; pixel_x = 7; pixel_y = 26; req_access = list(2,4)},/obj/structure/cable/green{d1 = 4; d2 = 8; icon_state = "4-8"},/obj/structure/bed/chair/bay/chair/padded/black{dir = 8},/turf/simulated/shuttle/plating/skipjack,/area/space)
"w" = (/obj/machinery/newscaster{pixel_x = 30},/obj/effect/floor_decal/industrial/warning/corner{dir = 8},/turf/simulated/shuttle/plating/skipjack,/area/space)
"x" = (/obj/machinery/dnaforensics{pixel_x = -4},/obj/structure/tubes,/turf/simulated/shuttle/floor/voidcraft/light,/area/space)
"y" = (/obj/structure/bed/padded,/obj/machinery/flasher{id = "SP-Cell flash"; pixel_y = -26},/turf/simulated/shuttle/floor/voidcraft/light,/area/space)
"z" = (/obj/structure/sign/mining/survival{dir = 4},/turf/simulated/shuttle/wall/voidcraft/survival,/area/space)
"A" = (/obj/effect/floor_decal/techfloor{dir = 4},/obj/effect/floor_decal/industrial/warning{dir = 4},/obj/machinery/power/apc/alarms_hidden{dir = 1; pixel_y = 20},/obj/structure/cable/green{d2 = 8; icon_state = "0-8"},/turf/simulated/shuttle/plating/skipjack,/area/space)
"B" = (/obj/machinery/flasher{id = "SP-Cell flash"; name = "Floor mounted flash"},/obj/effect/floor_decal/industrial/outline/yellow,/turf/simulated/shuttle/floor/voidcraft/light,/area/space)
"C" = (/obj/structure/grille,/obj/structure/window/reinforced/polarized{dir = 1; id = "SP-Sec"},/obj/structure/window/reinforced/polarized{dir = 4; id = "SP-Sec"},/obj/structure/window/reinforced/polarized{dir = 8; id = "SP-Sec"},/obj/structure/window/reinforced/polarized{id = "SP-Sec"},/obj/structure/cable/green,/turf/simulated/floor/plating,/area/space)
"D" = (/obj/structure/fans/tiny,/obj/effect/floor_decal/industrial/danger/full,/obj/machinery/door/airlock/voidcraft/vertical,/turf/simulated/floor/tiled/techmaint,/area/space)
"E" = (/obj/structure/bed/chair,/obj/machinery/newscaster{pixel_x = -30},/turf/simulated/shuttle/floor/voidcraft/light,/area/space)
"F" = (/obj/structure/table/steel,/obj/machinery/button/windowtint{id = "SP-Sec"; pixel_x = 10; pixel_y = 25},/obj/structure/fans{pixel_y = 32},/obj/machinery/microscope{pixel_y = 4},/obj/effect/floor_decal/techfloor{dir = 8},/turf/simulated/shuttle/floor/voidcraft/light,/area/space)
"G" = (/turf/simulated/shuttle/wall/voidcraft/survival,/area/space)
"H" = (/obj/structure/sign/mining/survival,/turf/simulated/shuttle/wall/voidcraft/survival,/area/space)
"I" = (/obj/machinery/light{dir = 1},/turf/simulated/shuttle/floor/voidcraft/light,/area/space)
"J" = (/obj/machinery/vending/emergencyfood/filled,/turf/simulated/shuttle/floor/voidcraft/light,/area/space)
"K" = (/obj/structure/bed/pod,/obj/item/weapon/bedsheet/green,/turf/simulated/shuttle/floor/voidcraft/light,/area/space)
"L" = (/obj/machinery/door/window/survival_pod{dir = 1; icon_state = "windoor"},/turf/simulated/floor/tiled/freezer,/area/space)
"M" = (/obj/machinery/door/window/brigdoor/northright{dir = 8; id = "SP-Cell"; name = "Cell"; req_access = null; req_one_access = list(2,4)},/obj/machinery/door/blast/regular{dir = 4; id = "SP-Cell2"; name = "Cell Door"},/obj/effect/floor_decal/industrial/danger/full,/turf/simulated/floor/tiled/techmaint,/area/space)
"N" = (/obj/machinery/button/remote/blast_door{id = "SP-Cell"; name = "Cell Door"; pixel_x = 6; pixel_y = -33; req_one_access = list(2,4)},/obj/machinery/button/flasher{id = "SP-Cell flash"; name = "Cell Flash"; pixel_x = 7; pixel_y = -24; req_access = list(2,4)},/obj/structure/cable/green{d1 = 1; d2 = 8; icon_state = "1-8"},/obj/structure/cable/green{d1 = 4; d2 = 8; icon_state = "4-8"},/turf/simulated/shuttle/plating/skipjack,/area/space)
"P" = (/obj/machinery/vending/security,/turf/simulated/shuttle/wall/voidcraft/survival,/area/space)
"Q" = (/obj/item/weapon/storage/mre/random,/obj/item/weapon/storage/mre/random,/obj/item/weapon/storage/mre/random,/obj/item/weapon/storage/mre/random,/obj/item/weapon/storage/mre/random,/obj/item/weapon/storage/mre/random,/obj/item/weapon/storage/mre/menu9,/obj/item/weapon/storage/mre/menu9,/obj/item/weapon/storage/mre/menu10,/obj/item/weapon/storage/mre/menu10,/obj/item/weapon/storage/mre/menu11,/obj/item/weapon/storage/mre/menu11,/obj/item/device/fbp_backup_cell,/obj/item/device/fbp_backup_cell,/obj/item/device/fbp_backup_cell,/obj/item/device/fbp_backup_cell,/obj/item/device/fbp_backup_cell,/obj/item/weapon/storage/pill_bottle/antitox,/obj/item/weapon/storage/box/survival/space,/obj/item/device/healthanalyzer,/obj/item/weapon/storage/pill_bottle/dice_nerd,/obj/machinery/light{dir = 1},/obj/item/weapon/storage/firstaid/regular,/obj/item/weapon/extinguisher/mini,/obj/item/weapon/extinguisher/mini,/obj/item/weapon/storage/box/survival/space,/obj/item/weapon/storage/box/survival/space,/obj/item/device/radio,/obj/item/device/radio,/obj/item/device/radio,/obj/item/device/starcaster_news,/obj/item/device/starcaster_news,/obj/item/device/threadneedle,/obj/item/device/flashlight,/obj/item/device/flashlight,/obj/item/weapon/storage/toolbox/emergency,/obj/item/weapon/storage/pill_bottle/spaceacillin,/obj/random/soap,/obj/item/weapon/material/knife/machete/hatchet,/obj/item/weapon/storage/box/flare,/obj/structure/bed/chair/comfy/black{dir = 8},/obj/machinery/smartfridge/survival_pod{pixel_y = 28},/obj/item/device/reagent_scanner,/obj/item/device/mass_spectrometer/adv,/obj/item/weapon/forensics/sample_kit/powder,/obj/item/weapon/forensics/sample_kit,/obj/item/clothing/gloves/sterile/latex,/obj/item/weapon/reagent_containers/spray/luminol,/obj/item/weapon/storage/briefcase/crimekit,/obj/item/weapon/storage/briefcase/crimekit,/obj/item/weapon/storage/box/bodybags,/obj/item/weapon/storage/box/bodybags,/obj/item/device/camera{desc = "A one use - polaroid camera. 30 photos left."; name = "detectives camera"; pictures_left = 30; pixel_x = 2; pixel_y = 3},/obj/item/device/camera_film,/obj/item/weapon/storage/photo_album{pixel_y = -10},/obj/item/device/flash,/obj/item/device/flash,/obj/item/device/flash,/turf/simulated/shuttle/floor/voidcraft/light,/area/space)
"S" = (/obj/structure/table/steel,/obj/item/device/starcaster_news{pixel_x = -6; pixel_y = 10},/obj/item/toy/eight_ball{pixel_x = 5; pixel_y = 4},/turf/simulated/shuttle/floor/voidcraft/light,/area/space)
"T" = (/obj/structure/cable/green{d1 = 2; d2 = 8; icon_state = "2-8"},/obj/effect/floor_decal/industrial/loading{dir = 1},/turf/simulated/shuttle/floor/voidcraft/light,/area/space)
"U" = (/obj/structure/sign/mining,/turf/simulated/shuttle/wall/voidcraft/survival,/area/space)
"V" = (/obj/structure/bed/pod,/obj/item/weapon/bedsheet/purple,/obj/item/device/gps/computer{pixel_y = 0},/turf/simulated/shuttle/floor/voidcraft/light,/area/space)
"W" = (/obj/structure/sink{dir = 4; pixel_x = 11},/obj/structure/mirror{dir = 8; pixel_x = 25},/turf/simulated/floor/tiled/freezer,/area/space)
"Y" = (/obj/structure/reagent_dispensers/water_cooler/full{pixel_x = -10; pixel_y = 12},/obj/structure/closet/crate/bin{pixel_x = 6; pixel_y = 13},/turf/simulated/shuttle/floor/voidcraft/light,/area/space)
"Z" = (/obj/item/weapon/newspaper,/obj/item/device/tape,/obj/item/device/taperecorder{pixel_x = -4; pixel_y = 2},/obj/structure/table/standard,/obj/machinery/light{dir = 8},/obj/item/weapon/paper_bin,/obj/item/weapon/pen,/turf/simulated/shuttle/floor/voidcraft/light,/area/space)

(1,1,1) = {"
GGpGGGUGG
GtIYeFQVG
jKaShbTxz
GEBgGPlGG
GZanvfNAD
GJBCGcGwG
jmLraaMqz
GiWGyoGdG
GGUGGGHGG
"}
