"a" = (/turf/template_noop,/area/template_noop)
"b" = (/obj/machinery/disperser/front{dir = 1},/turf/template_noop,/area/template_noop)
"c" = (/turf/simulated/floor/tiled/techmaint,/area/survivalpod/superpose/TinyCombatShip)
"f" = (/obj/structure/fans/hardlight/colorable{color = "red"},/obj/machinery/door/airlock/hatch{req_one_access = null},/turf/simulated/floor/plating/external,/area/survivalpod/superpose/TinyCombatShip)
"h" = (/obj/structure/window/reinforced/survival_pod{dir = 1},/obj/structure/shuttle/engine/heater,/turf/simulated/floor/plating/external,/area/survivalpod/superpose/TinyCombatShip)
"j" = (/obj/structure/salvageable/machine,/turf/simulated/floor/tiled/techmaint,/area/survivalpod/superpose/TinyCombatShip)
"k" = (/turf/simulated/wall/rshull,/area/survivalpod/superpose/TinyCombatShip)
"l" = (/obj/machinery/disperser/back{dir = 1},/obj/structure/ship_munition/disperser_charge/explosive,/turf/simulated/wall/shull,/area/survivalpod/superpose/TinyCombatShip)
"n" = (/obj/structure/closet/walllocker_double/medical/west,/obj/item/weapon/storage/firstaid,/obj/item/weapon/storage/firstaid/fire,/obj/item/weapon/storage/firstaid/toxin,/obj/item/weapon/storage/firstaid/o2,/obj/item/roller,/obj/effect/floor_decal/techfloor{dir = 4},/turf/simulated/shuttle/floor/voidcraft,/area/survivalpod/superpose/TinyCombatShip)
"q" = (/obj/effect/floor_decal/techfloor{dir = 8},/obj/structure/window/reinforced/survival_pod,/obj/machinery/light/poi{dir = 1},/turf/simulated/shuttle/floor/voidcraft,/area/survivalpod/superpose/TinyCombatShip)
"s" = (/obj/structure/window/plastitanium/full,/obj/structure/window/reinforced/survival_pod{dir = 4},/obj/structure/window/reinforced/survival_pod{dir = 8},/obj/structure/window/reinforced/survival_pod{dir = 1},/obj/structure/window/reinforced/survival_pod,/obj/structure/grille/rustic{health = 25; name = "reinforced grille"},/obj/machinery/door/blast/regular/open{dir = 4; id = "stargazer_blast"; name = "window blast shield"},/turf/simulated/shuttle/plating,/area/survivalpod/superpose/TinyCombatShip)
"t" = (/obj/effect/catwalk_plated/dark,/turf/template_noop,/area/survivalpod/superpose/TinyCombatShip)
"u" = (/obj/machinery/disperser/middle{dir = 1},/turf/template_noop,/area/template_noop)
"x" = (/obj/item/device/gps,/obj/item/sticky_pad/random,/obj/item/device/starcaster_news,/obj/item/weapon/pen/blue,/obj/item/device/pda,/obj/item/weapon/card/id/external,/obj/item/weapon/storage/mre/random,/obj/item/weapon/storage/mre/random,/obj/item/weapon/reagent_containers/food/drinks/cans/waterbottle,/obj/item/weapon/reagent_containers/food/drinks/cans/waterbottle,/obj/item/weapon/reagent_containers/food/snacks/sosjerky,/obj/item/weapon/reagent_containers/food/snacks/sosjerky,/obj/item/weapon/gun/energy/locked/phasegun/pistol,/obj/item/weapon/material/knife/tacknife/survival,/obj/item/clothing/accessory/permit/gun,/obj/item/device/camera,/obj/item/device/binoculars,/obj/item/device/threadneedle,/obj/random/soap,/obj/item/weapon/towel/random,/obj/item/bodybag/cryobag,/obj/item/device/flashlight/flare,/obj/item/device/flashlight/flare,/obj/item/device/flashlight/color/yellow,/obj/item/device/radio,/obj/item/device/radio,/obj/item/weapon/flame/lighter/random,/obj/item/weapon/cell/device/hyper,/obj/item/weapon/cell/device/hyper,/obj/item/weapon/extinguisher/mini,/obj/item/weapon/reagent_containers/glass/beaker/vial/tricordrazine,/obj/item/weapon/reagent_containers/glass/beaker/vial/tricordrazine,/obj/item/weapon/reagent_containers/pill/spaceacillin,/obj/item/weapon/reagent_containers/pill/spaceacillin,/obj/item/device/fbp_backup_cell,/obj/item/device/fbp_backup_cell,/obj/item/device/suit_cooling_unit/emergency,/obj/item/stack/nanopaste,/obj/item/weapon/reagent_containers/hypospray/autoinjector/biginjector/clotting,/obj/item/weapon/storage/backpack/messenger,/obj/item/clothing/accessory/storage/black_drop_pouches,/obj/item/clothing/accessory/poncho/thermal,/obj/item/weapon/storage/box/survival/comp,/obj/item/weapon/storage/toolbox/brass,/obj/item/weapon/storage/box/khcrystal,/obj/structure/closet/walllocker_double/kitchen/east{name = "Ration Cabinet"},/obj/effect/floor_decal/techfloor{dir = 8},/turf/simulated/shuttle/floor/voidcraft,/area/survivalpod/superpose/TinyCombatShip)
"D" = (/obj/effect/floor_decal/techfloor{dir = 4},/turf/simulated/shuttle/floor/voidcraft,/area/survivalpod/superpose/TinyCombatShip)
"F" = (/obj/machinery/portable_atmospherics/canister/phoron,/obj/machinery/atmospherics/portables_connector{dir = 4},/turf/simulated/floor/tiled/techfloor,/area/survivalpod/superpose/TinyCombatShip)
"H" = (/obj/structure/bed/chair/bay/comfy/red{dir = 1},/obj/machinery/door/window/survival_pod{dir = 2},/turf/simulated/floor/tiled/techmaint,/area/survivalpod/superpose/TinyCombatShip)
"L" = (/obj/machinery/atmospherics/unary/engine{dir = 1},/turf/template_noop,/area/survivalpod/superpose/TinyCombatShip)
"M" = (/obj/effect/catwalk_plated/dark,/obj/machinery/light/poi{dir = 1},/turf/template_noop,/area/survivalpod/superpose/TinyCombatShip)
"P" = (/obj/effect/floor_decal/techfloor{dir = 8},/turf/simulated/shuttle/floor/voidcraft,/area/survivalpod/superpose/TinyCombatShip)
"S" = (/turf/simulated/wall/shull,/area/survivalpod/superpose/TinyCombatShip)
"U" = (/obj/effect/floor_decal/techfloor{dir = 4},/obj/structure/window/reinforced/survival_pod,/obj/machinery/light/poi{dir = 1},/turf/simulated/shuttle/floor/voidcraft,/area/survivalpod/superpose/TinyCombatShip)
"X" = (/obj/structure/closet/crate,/obj/item/stack/material/plastic{amount = 50},/obj/item/stack/material/plastic{amount = 50},/obj/item/stack/material/plastic{amount = 50},/obj/item/stack/material/plastic{amount = 50},/obj/item/stack/material/steel{amount = 50},/obj/item/stack/material/steel{amount = 50},/obj/item/stack/material/steel{amount = 50},/obj/item/stack/material/steel{amount = 50},/obj/item/stack/material/glass{amount = 50},/obj/item/stack/material/glass{amount = 50},/obj/item/stack/material/glass{amount = 50},/obj/item/stack/material/glass{amount = 50},/obj/item/stack/rods{amount = 50},/obj/item/stack/rods{amount = 50},/obj/item/stack/rods{amount = 50},/obj/item/stack/rods{amount = 50},/obj/item/stack/cable_coil{pixel_x = 3; pixel_y = 3},/obj/item/stack/cable_coil{pixel_x = 3; pixel_y = 3},/obj/item/stack/cable_coil/green,/obj/item/stack/cable_coil/blue,/obj/item/weapon/storage/briefcase/inflatable,/obj/item/weapon/storage/briefcase/inflatable,/obj/item/weapon/storage/briefcase/inflatable,/obj/item/weapon/storage/briefcase/inflatable,/turf/simulated/floor/tiled/techfloor,/area/survivalpod/superpose/TinyCombatShip)

(1,1,1) = {"
aaakskaaa
abkkjkkba
SusUHqsuS
SlSncxSlS
SSFDcPXSS
aShSfShSa
aSLMtMLSa
"}
