//MAP CONVERTED BY dmm2tgm.py THIS HEADER COMMENT PREVENTS RECONVERSION, DO NOT REMOVE
"a" = (
/turf/template_noop,
/area/template_noop)
"b" = (
/turf/simulated/wall/log_sif,
/area/survivalpod/superpose/WoodenCamp)
"c" = (
/obj/structure/grille/rustic,
/obj/structure/window/reinforced/full,
/turf/simulated/floor/plating,
/area/survivalpod/superpose/WoodenCamp)
"d" = (
/obj/structure/bed/padded,
/obj/item/weapon/bedsheet/brown,
/turf/simulated/floor/outdoors/dirt{
	outdoors = 0
	},
/area/survivalpod/superpose/WoodenCamp)
"e" = (
/obj/item/device/flashlight/lantern,
/turf/simulated/floor/outdoors/dirt{
	outdoors = 0
	},
/area/survivalpod/superpose/WoodenCamp)
"f" = (
/turf/simulated/floor/outdoors/dirt{
	outdoors = 0
	},
/area/survivalpod/superpose/WoodenCamp)
"g" = (
/obj/machinery/portable_atmospherics/powered/scrubber/huge/stationary,
/turf/simulated/floor/outdoors/dirt{
	outdoors = 0
	},
/area/survivalpod/superpose/WoodenCamp)
"h" = (
/obj/structure/simple_door/sifwood,
/turf/simulated/floor/outdoors/dirt{
	outdoors = 0
	},
/area/survivalpod/superpose/WoodenCamp)
"i" = (
/obj/structure/table/rack,
/obj/item/weapon/gun/launcher/crossbow,
/obj/item/stack/rods{
	amount = 17
	},
/turf/simulated/floor/outdoors/dirt{
	outdoors = 0
	},
/area/survivalpod/superpose/WoodenCamp)
"j" = (
/obj/structure/kitchenspike,
/turf/simulated/floor,
/area/survivalpod/superpose/WoodenCamp)
"k" = (
/obj/structure/table/bench/wooden,
/turf/simulated/floor/outdoors/dirt,
/area/survivalpod/superpose/WoodenCamp)
"l" = (
/turf/simulated/floor/outdoors/dirt,
/area/survivalpod/superpose/WoodenCamp)
"m" = (
/obj/item/weapon/material/knife/machete/hatchet,
/turf/template_noop,
/area/template_noop)
"n" = (
/obj/item/weapon/flame/lighter,
/turf/simulated/floor/outdoors/dirt,
/area/survivalpod/superpose/WoodenCamp)
"o" = (
/obj/structure/bonfire/sifwood,
/turf/simulated/floor/outdoors/dirt,
/area/survivalpod/superpose/WoodenCamp)
"q" = (
/obj/structure/bed/padded,
/obj/item/weapon/bedsheet/mime,
/turf/simulated/floor/outdoors/dirt{
	outdoors = 0
	},
/area/survivalpod/superpose/WoodenCamp)
"t" = (
/obj/structure/bed/padded,
/obj/item/weapon/bedsheet/blue,
/turf/simulated/floor/outdoors/dirt{
	outdoors = 0
	},
/area/survivalpod/superpose/WoodenCamp)
"v" = (
/obj/structure/table/standard,
/obj/item/weapon/paper_bin{
	pixel_x = -3;
	pixel_y = 7
	},
/obj/item/weapon/folder/white,
/turf/simulated/floor/outdoors/dirt{
	outdoors = 0
	},
/area/survivalpod/superpose/WoodenCamp)
"y" = (
/obj/machinery/portable_atmospherics/canister/air,
/turf/simulated/floor/outdoors/dirt{
	outdoors = 0
	},
/area/survivalpod/superpose/WoodenCamp)
"B" = (
/obj/machinery/power/apc/alarms_hidden{
	dir = 1;
	pixel_y = 20
	},
/obj/structure/cable/green{
	d2 = 8;
	icon_state = "0-8"
	},
/turf/simulated/floor,
/area/survivalpod/superpose/WoodenCamp)
"F" = (
/obj/item/device/flashlight/lamp{
	pixel_x = -8;
	pixel_y = 13
	},
/obj/structure/table/standard,
/obj/item/weapon/reagent_containers/food/drinks/cans/waterbottle{
	pixel_x = 5;
	pixel_y = 6
	},
/obj/item/weapon/reagent_containers/food/drinks/cans/waterbottle{
	pixel_x = 5;
	pixel_y = 6
	},
/turf/simulated/floor/outdoors/dirt{
	outdoors = 0
	},
/area/survivalpod/superpose/WoodenCamp)
"H" = (
/obj/structure/bed/padded,
/obj/item/weapon/bedsheet/ian,
/turf/simulated/floor/outdoors/dirt{
	outdoors = 0
	},
/area/survivalpod/superpose/WoodenCamp)
"I" = (
/obj/structure/closet/crate,
/obj/item/stack/material/plastic{
	amount = 50
	},
/obj/item/stack/material/plastic{
	amount = 50
	},
/obj/item/stack/material/plastic{
	amount = 50
	},
/obj/item/stack/material/plastic{
	amount = 50
	},
/obj/item/stack/material/steel{
	amount = 50
	},
/obj/item/stack/material/steel{
	amount = 50
	},
/obj/item/stack/material/steel{
	amount = 50
	},
/obj/item/stack/material/steel{
	amount = 50
	},
/obj/item/stack/material/glass{
	amount = 50
	},
/obj/item/stack/material/glass{
	amount = 50
	},
/obj/item/stack/material/glass{
	amount = 50
	},
/obj/item/stack/material/glass{
	amount = 50
	},
/obj/item/stack/rods{
	amount = 50
	},
/obj/item/stack/rods{
	amount = 50
	},
/obj/item/stack/rods{
	amount = 50
	},
/obj/item/stack/rods{
	amount = 50
	},
/obj/item/stack/cable_coil{
	pixel_x = 3;
	pixel_y = 3
	},
/obj/item/stack/cable_coil{
	pixel_x = 3;
	pixel_y = 3
	},
/obj/item/stack/cable_coil/green,
/obj/item/stack/cable_coil/blue,
/obj/item/weapon/storage/briefcase/inflatable,
/obj/item/weapon/storage/briefcase/inflatable,
/obj/item/weapon/storage/briefcase/inflatable,
/obj/item/weapon/storage/briefcase/inflatable,
/turf/simulated/floor/outdoors/dirt{
	outdoors = 0
	},
/area/survivalpod/superpose/WoodenCamp)
"K" = (
/obj/item/device/gps,
/obj/item/sticky_pad/random,
/obj/item/device/starcaster_news,
/obj/item/weapon/pen/blue,
/obj/item/device/pda,
/obj/item/weapon/card/id/external,
/obj/item/weapon/storage/mre/random,
/obj/item/weapon/storage/mre/random,
/obj/item/weapon/reagent_containers/food/drinks/cans/waterbottle,
/obj/item/weapon/reagent_containers/food/drinks/cans/waterbottle,
/obj/item/weapon/reagent_containers/food/snacks/sosjerky,
/obj/item/weapon/reagent_containers/food/snacks/sosjerky,
/obj/item/weapon/gun/energy/locked/frontier/holdout/unlocked,
/obj/item/weapon/material/knife/tacknife/survival,
/obj/item/clothing/accessory/permit/gun,
/obj/item/device/camera,
/obj/item/device/binoculars,
/obj/item/device/threadneedle,
/obj/random/soap,
/obj/item/weapon/towel/random,
/obj/item/bodybag/cryobag,
/obj/item/device/flashlight/flare,
/obj/item/device/flashlight/flare,
/obj/item/device/flashlight/color/yellow,
/obj/item/device/radio,
/obj/item/device/radio,
/obj/item/weapon/flame/lighter/random,
/obj/item/weapon/cell/device/hyper,
/obj/item/weapon/cell/device/hyper,
/obj/item/weapon/extinguisher/mini,
/obj/item/weapon/reagent_containers/glass/beaker/vial/tricordrazine,
/obj/item/weapon/reagent_containers/glass/beaker/vial/tricordrazine,
/obj/item/weapon/reagent_containers/pill/spaceacillin,
/obj/item/weapon/reagent_containers/pill/spaceacillin,
/obj/item/device/fbp_backup_cell,
/obj/item/device/fbp_backup_cell,
/obj/item/device/suit_cooling_unit/emergency,
/obj/item/stack/nanopaste,
/obj/item/weapon/reagent_containers/hypospray/autoinjector/biginjector/clotting,
/obj/item/weapon/storage/backpack/messenger,
/obj/item/clothing/accessory/storage/black_drop_pouches,
/obj/item/clothing/accessory/poncho/thermal,
/obj/item/weapon/storage/box/survival/comp,
/obj/item/weapon/storage/toolbox/brass,
/obj/item/weapon/storage/box/khcrystal,
/obj/structure/closet/walllocker_double/west,
/turf/simulated/floor/outdoors/dirt{
	outdoors = 0
	},
/area/survivalpod/superpose/WoodenCamp)
"Q" = (
/obj/machinery/power/port_gen/pacman,
/obj/structure/cable/green{
	d2 = 4;
	icon_state = "0-4"
	},
/turf/simulated/floor,
/area/survivalpod/superpose/WoodenCamp)
"W" = (
/obj/structure/table/rack/shelf/steel,
/obj/item/weapon/chainsaw,
/obj/item/weapon/storage/box/lights/mixed,
/obj/item/weapon/extinguisher,
/obj/item/weapon/storage/toolbox/mechanical,
/obj/item/stack/material/log/sif{
	amount = 25
	},
/obj/item/stack/material/log/sif{
	amount = 25
	},
/turf/simulated/floor,
/area/survivalpod/superpose/WoodenCamp)
"Y" = (
/obj/item/device/gps,
/obj/item/sticky_pad/random,
/obj/item/device/starcaster_news,
/obj/item/weapon/pen/blue,
/obj/item/device/pda,
/obj/item/weapon/card/id/external,
/obj/item/weapon/storage/mre/random,
/obj/item/weapon/storage/mre/random,
/obj/item/weapon/reagent_containers/food/drinks/cans/waterbottle,
/obj/item/weapon/reagent_containers/food/drinks/cans/waterbottle,
/obj/item/weapon/reagent_containers/food/snacks/sosjerky,
/obj/item/weapon/reagent_containers/food/snacks/sosjerky,
/obj/item/weapon/gun/energy/locked/frontier/holdout/unlocked,
/obj/item/weapon/material/knife/tacknife/survival,
/obj/item/clothing/accessory/permit/gun,
/obj/item/device/camera,
/obj/item/device/binoculars,
/obj/item/device/threadneedle,
/obj/random/soap,
/obj/item/weapon/towel/random,
/obj/item/bodybag/cryobag,
/obj/item/device/flashlight/flare,
/obj/item/device/flashlight/flare,
/obj/item/device/flashlight/color/yellow,
/obj/item/device/radio,
/obj/item/device/radio,
/obj/item/weapon/flame/lighter/random,
/obj/item/weapon/cell/device/hyper,
/obj/item/weapon/cell/device/hyper,
/obj/item/weapon/extinguisher/mini,
/obj/item/weapon/reagent_containers/glass/beaker/vial/tricordrazine,
/obj/item/weapon/reagent_containers/glass/beaker/vial/tricordrazine,
/obj/item/weapon/reagent_containers/pill/spaceacillin,
/obj/item/weapon/reagent_containers/pill/spaceacillin,
/obj/item/device/fbp_backup_cell,
/obj/item/device/fbp_backup_cell,
/obj/item/device/suit_cooling_unit/emergency,
/obj/item/stack/nanopaste,
/obj/item/weapon/reagent_containers/hypospray/autoinjector/biginjector/clotting,
/obj/item/weapon/storage/backpack/messenger,
/obj/item/clothing/accessory/storage/black_drop_pouches,
/obj/item/clothing/accessory/poncho/thermal,
/obj/item/weapon/storage/box/survival/comp,
/obj/item/weapon/storage/toolbox/brass,
/obj/item/weapon/storage/box/khcrystal,
/obj/structure/closet/walllocker_double/east,
/turf/simulated/floor/outdoors/dirt{
	outdoors = 0
	},
/area/survivalpod/superpose/WoodenCamp)
"Z" = (
/obj/structure/table/steel,
/obj/item/stack/material/phoron{
	amount = 5
	},
/obj/item/stack/material/phoron{
	amount = 5
	},
/obj/fiftyspawner/wood,
/obj/fiftyspawner/steel,
/turf/simulated/floor,
/area/survivalpod/superpose/WoodenCamp)

(1,1,1) = {"
a
a
a
a
a
a
a
a
a
a
"}
(2,1,1) = {"
b
b
c
b
b
b
Q
a
a
a
"}
(3,1,1) = {"
b
q
f
K
g
b
B
k
k
k
"}
(4,1,1) = {"
b
d
f
F
b
b
b
l
l
n
"}
(5,1,1) = {"
c
y
e
f
h
f
h
l
o
l
"}
(6,1,1) = {"
c
I
f
f
b
b
b
l
l
l
"}
(7,1,1) = {"
b
t
f
f
v
b
Z
k
k
k
"}
(8,1,1) = {"
b
H
f
Y
i
b
W
a
a
a
"}
(9,1,1) = {"
b
b
c
b
b
b
j
m
a
a
"}
(10,1,1) = {"
a
a
a
a
a
a
a
a
a
a
"}
