//MAP CONVERTED BY dmm2tgm.py THIS HEADER COMMENT PREVENTS RECONVERSION, DO NOT REMOVE
"a" = (
/turf/space,
/area/space)
"R" = (
/turf/simulated/wall/plastihull,
/area/space)
"S" = (
/turf/simulated/floor/light,
/area/space)
"X" = (
/obj/effect/landmark/darkcomplex_room{
	width = 7;
	height = 4
	},
/turf/simulated/floor/light,
/area/space)

(1,1,1) = {"
a
a
a
a
a
a
a
a
a
a
a
a
a
a
a
"}
(2,1,1) = {"
a
a
a
a
a
a
a
a
a
a
a
a
a
a
a
"}
(3,1,1) = {"
a
a
a
a
a
a
a
a
a
a
a
a
a
a
a
"}
(4,1,1) = {"
a
a
a
R
R
R
R
R
R
R
R
R
a
a
a
"}
(5,1,1) = {"
a
a
a
R
S
S
S
S
S
S
S
R
a
a
a
"}
(6,1,1) = {"
a
a
a
R
S
S
S
S
S
S
S
R
a
a
a
"}
(7,1,1) = {"
a
a
a
R
S
S
S
S
S
S
S
R
a
a
a
"}
(8,1,1) = {"
a
a
a
R
S
S
S
S
S
S
S
R
a
a
a
"}
(9,1,1) = {"
a
a
a
R
S
S
S
S
S
S
S
R
a
a
a
"}
(10,1,1) = {"
a
a
a
R
S
S
S
S
S
S
S
R
a
a
a
"}
(11,1,1) = {"
a
a
a
R
S
S
S
X
S
S
S
R
a
a
a
"}
(12,1,1) = {"
a
a
a
R
S
S
S
S
S
S
S
R
a
a
a
"}
(13,1,1) = {"
a
a
a
R
S
S
S
S
S
S
S
R
a
a
a
"}
(14,1,1) = {"
a
a
a
R
S
S
S
S
S
S
S
R
a
a
a
"}
(15,1,1) = {"
a
a
a
R
S
S
S
S
S
S
S
R
a
a
a
"}
(16,1,1) = {"
a
a
a
R
S
S
S
S
S
S
S
R
a
a
a
"}
(17,1,1) = {"
a
a
a
R
S
S
S
S
S
S
S
R
a
a
a
"}
(18,1,1) = {"
a
a
a
R
R
R
R
R
R
R
R
R
a
a
a
"}
(19,1,1) = {"
a
a
a
a
a
a
a
a
a
a
a
a
a
a
a
"}
(20,1,1) = {"
a
a
a
a
a
a
a
a
a
a
a
a
a
a
a
"}
(21,1,1) = {"
a
a
a
a
a
a
a
a
a
a
a
a
a
a
a
"}
