//MAP CONVERTED BY dmm2tgm.py THIS HEADER COMMENT PREVENTS RECONVERSION, DO NOT REMOVE
"aa" = (
/turf/template_noop,
/area/submap/explorerhouse)
"ab" = (
/obj/structure/railing,
/turf/template_noop,
/area/submap/explorerhouse)
"ac" = (
/obj/structure/railing{
	dir = 4
	},
/turf/template_noop,
/area/submap/explorerhouse)
"ad" = (
/turf/simulated/floor/outdoors/grass/sif,
/area/submap/explorerhouse)
"ae" = (
/obj/structure/railing{
	dir = 8
	},
/turf/template_noop,
/area/submap/explorerhouse)
"af" = (
/obj/structure/railing{
	dir = 4
	},
/turf/simulated/floor/outdoors/grass/sif,
/area/submap/explorerhouse)
"ag" = (
/turf/simulated/floor/outdoors/dirt,
/area/submap/explorerhouse)
"ah" = (
/obj/structure/table/bench/wooden,
/turf/simulated/floor/outdoors/dirt,
/area/submap/explorerhouse)
"ai" = (
/obj/structure/railing{
	dir = 8
	},
/turf/simulated/floor/outdoors/grass/sif,
/area/submap/explorerhouse)
"aj" = (
/obj/structure/target_stake,
/turf/simulated/floor/outdoors/dirt,
/area/submap/explorerhouse)
"ak" = (
/obj/item/target,
/turf/simulated/floor/outdoors/grass/sif,
/area/submap/explorerhouse)
"al" = (
/obj/item/target/syndicate,
/turf/simulated/floor/outdoors/grass/sif,
/area/submap/explorerhouse)
"am" = (
/turf/simulated/wall/wood,
/area/submap/explorerhouse)
"an" = (
/obj/structure/simple_door/wood,
/turf/simulated/floor/wood,
/area/submap/explorerhouse)
"ao" = (
/obj/machinery/portable_atmospherics/powered/scrubber/huge/stationary,
/turf/simulated/floor/wood,
/area/submap/explorerhouse)
"ap" = (
/turf/simulated/floor/wood,
/area/submap/explorerhouse)
"aq" = (
/obj/structure/table/marble,
/obj/item/weapon/material/kitchen/rollingpin,
/turf/simulated/floor/tiled,
/area/submap/explorerhouse)
"ar" = (
/obj/structure/table/marble,
/obj/item/weapon/material/knife,
/turf/simulated/floor/tiled,
/area/submap/explorerhouse)
"as" = (
/obj/structure/grille/rustic,
/obj/structure/window/reinforced/full,
/turf/simulated/floor/plating,
/area/submap/explorerhouse)
"at" = (
/obj/structure/table/standard,
/obj/item/weapon/reagent_containers/hypospray/autoinjector/biginjector/brute,
/obj/item/weapon/reagent_containers/hypospray/autoinjector/biginjector/burn,
/obj/item/weapon/reagent_containers/hypospray/autoinjector/biginjector/purity,
/turf/simulated/floor/tiled/freezer,
/area/submap/explorerhouse)
"au" = (
/obj/structure/toilet,
/turf/simulated/floor/tiled/freezer,
/area/submap/explorerhouse)
"av" = (
/obj/structure/table/marble,
/obj/random/drinkbottle,
/turf/simulated/floor/tiled,
/area/submap/explorerhouse)
"aw" = (
/obj/item/device/flashlight/lantern,
/turf/simulated/floor/tiled,
/area/submap/explorerhouse)
"ax" = (
/obj/structure/table/glass,
/obj/structure/window/reinforced,
/obj/item/weapon/coin/phoron,
/turf/simulated/floor/wood,
/area/submap/explorerhouse)
"ay" = (
/obj/item/clothing/head/bearpelt{
	pixel_y = 6
	},
/obj/structure/table/glass,
/obj/structure/window/reinforced,
/turf/simulated/floor/wood,
/area/submap/explorerhouse)
"az" = (
/obj/item/weapon/material/harpoon,
/obj/structure/table/glass,
/obj/structure/window/reinforced,
/turf/simulated/floor/wood,
/area/submap/explorerhouse)
"aA" = (
/obj/structure/table/glass,
/obj/structure/window/reinforced,
/obj/item/clothing/accessory/medal/conduct{
	pixel_y = 6
	},
/turf/simulated/floor/wood,
/area/submap/explorerhouse)
"aB" = (
/obj/structure/sink{
	dir = 8;
	icon_state = "sink";
	pixel_x = -12;
	pixel_y = 2
	},
/obj/structure/mirror{
	dir = 4;
	pixel_x = -28;
	pixel_y = 0
	},
/turf/simulated/floor/tiled/freezer,
/area/submap/explorerhouse)
"aC" = (
/obj/item/weapon/towel,
/turf/simulated/floor/tiled/freezer,
/area/submap/explorerhouse)
"aD" = (
/obj/structure/closet/secure_closet/freezer/fridge,
/turf/simulated/floor/tiled,
/area/submap/explorerhouse)
"aE" = (
/turf/simulated/floor/tiled,
/area/submap/explorerhouse)
"aF" = (
/obj/structure/simple_door/wood,
/turf/simulated/floor/tiled,
/area/submap/explorerhouse)
"aG" = (
/obj/structure/simple_door/wood,
/turf/simulated/floor/tiled/freezer,
/area/submap/explorerhouse)
"aH" = (
/obj/item/device/flashlight/lantern,
/turf/simulated/floor/tiled/freezer,
/area/submap/explorerhouse)
"aI" = (
/obj/structure/window/reinforced/tinted{
	dir = 8;
	icon_state = "twindow"
	},
/obj/machinery/shower{
	dir = 1
	},
/obj/random/soap,
/turf/simulated/floor/tiled/freezer,
/area/submap/explorerhouse)
"aJ" = (
/turf/simulated/floor/carpet/turcarpet,
/area/submap/explorerhouse)
"aK" = (
/obj/structure/bed/chair/wood,
/turf/simulated/floor/carpet/turcarpet,
/area/submap/explorerhouse)
"aL" = (
/obj/structure/bed/chair/wood{
	dir = 4
	},
/turf/simulated/floor/carpet/turcarpet,
/area/submap/explorerhouse)
"aM" = (
/obj/structure/table/wooden_reinforced,
/obj/item/weapon/storage/fancy/candle_box,
/turf/simulated/floor/carpet/turcarpet,
/area/submap/explorerhouse)
"aN" = (
/obj/structure/table/wooden_reinforced,
/obj/item/device/binoculars/spyglass,
/turf/simulated/floor/carpet/turcarpet,
/area/submap/explorerhouse)
"aO" = (
/obj/structure/table/wooden_reinforced,
/obj/item/device/flashlight/lantern,
/turf/simulated/floor/carpet/turcarpet,
/area/submap/explorerhouse)
"aP" = (
/obj/structure/bed/chair/wood{
	dir = 1
	},
/turf/simulated/floor/carpet/turcarpet,
/area/submap/explorerhouse)
"aQ" = (
/obj/structure/table/rack,
/obj/item/device/gps/explorer,
/turf/simulated/floor/wood,
/area/submap/explorerhouse)
"aR" = (
/obj/structure/simple_door/wood,
/turf/simulated/floor/carpet/sblucarpet,
/area/submap/explorerhouse)
"aS" = (
/turf/simulated/floor/carpet/sblucarpet,
/area/submap/explorerhouse)
"aT" = (
/obj/machinery/space_heater,
/turf/simulated/floor/carpet/sblucarpet,
/area/submap/explorerhouse)
"aU" = (
/obj/structure/table/rack,
/obj/item/clothing/under/explorer,
/obj/item/weapon/cell/device,
/obj/item/weapon/cell/device,
/obj/item/weapon/cell/device,
/turf/simulated/floor/wood,
/area/submap/explorerhouse)
"aV" = (
/obj/item/device/flashlight/lantern,
/turf/simulated/floor/wood,
/area/submap/explorerhouse)
"aW" = (
/obj/machinery/space_heater,
/turf/simulated/floor/wood,
/area/submap/explorerhouse)
"aX" = (
/obj/structure/coatrack,
/turf/simulated/floor/wood,
/area/submap/explorerhouse)
"aY" = (
/obj/structure/table/rack,
/obj/item/clothing/suit/storage/hooded/explorer,
/obj/item/clothing/mask/gas/explorer,
/obj/item/weapon/material/knife/tacknife/survival,
/turf/simulated/floor/wood,
/area/submap/explorerhouse)
"aZ" = (
/obj/item/clothing/shoes/boots/winter/explorer,
/turf/simulated/floor/wood,
/area/submap/explorerhouse)
"ba" = (
/obj/structure/table/woodentable,
/obj/random/action_figure,
/obj/item/device/flashlight/lantern,
/turf/simulated/floor/carpet/sblucarpet,
/area/submap/explorerhouse)
"bb" = (
/obj/item/weapon/bedsheet/hopdouble,
/obj/structure/bed/double/padded,
/turf/simulated/floor/carpet/sblucarpet,
/area/submap/explorerhouse)
"bc" = (
/obj/structure/loot_pile/maint/trash,
/turf/simulated/floor/outdoors/grass/sif,
/area/submap/explorerhouse)
"bd" = (
/obj/structure/loot_pile/maint/junk,
/turf/simulated/floor/outdoors/grass/sif,
/area/submap/explorerhouse)
"be" = (
/obj/structure/sign/kiddieplaque{
	desc = "To anyone reading this, you'll note that I'm not home right now, and unfortunately due to reassignment, I won't be for a very long time. Exploring somewhere really far and dangerous now. You can stay if you want, but please try to keep my home in good condition.";
	name = "read me visitors"
	},
/turf/simulated/wall/wood,
/area/submap/explorerhouse)
"bf" = (
/obj/structure/bonfire/sifwood,
/turf/simulated/floor/outdoors/dirt,
/area/submap/explorerhouse)
"GN" = (
/obj/machinery/portable_atmospherics/canister/air,
/turf/simulated/floor/wood,
/area/submap/explorerhouse)

(1,1,1) = {"
aa
ac
af
af
af
af
ad
ad
ad
ad
ad
ad
ad
ad
ad
ad
ad
ad
ad
ad
"}
(2,1,1) = {"
ab
ad
ad
ag
ad
ak
am
am
as
am
am
ad
am
am
as
am
am
bc
ag
ag
"}
(3,1,1) = {"
ab
ad
ag
aj
ag
al
am
aq
av
aD
am
ad
am
aQ
aU
aY
am
bc
ag
ag
"}
(4,1,1) = {"
ab
ad
ag
ag
ag
ak
am
ar
aw
aE
am
ad
am
ap
aV
aZ
am
bc
ag
ag
"}
(5,1,1) = {"
ab
ad
ag
ag
ag
ad
am
am
am
aF
am
am
am
an
am
am
am
bd
ag
ag
"}
(6,1,1) = {"
ab
ad
ag
ag
ag
ad
ad
as
ax
ap
ap
GN
ap
ap
ap
as
ad
ad
ag
ag
"}
(7,1,1) = {"
ab
ad
ag
ag
ag
am
am
am
ay
ap
aJ
aL
aJ
ap
aW
am
am
am
ag
ag
"}
(8,1,1) = {"
ab
ad
ag
ag
ag
am
ao
am
am
ap
aK
aM
aP
ap
am
am
ao
am
ag
ag
"}
(9,1,1) = {"
ab
ad
ag
ag
ag
an
ap
ap
an
ap
aK
aN
aP
ap
an
ap
ap
an
ag
ag
"}
(10,1,1) = {"
ab
ad
ag
ag
ag
am
ao
am
am
ap
aK
aO
aP
ap
am
am
ao
be
ag
ag
"}
(11,1,1) = {"
ab
ad
ag
ag
ag
am
am
am
az
ap
aJ
aP
aJ
ap
aX
am
am
am
ag
ag
"}
(12,1,1) = {"
ab
ad
ah
ag
ah
ad
ad
as
aA
ap
ap
ap
ap
ap
ap
as
ad
ad
ag
ag
"}
(13,1,1) = {"
ab
ad
ah
bf
ah
ad
am
am
am
aG
am
am
am
aR
am
am
am
ad
ag
ag
"}
(14,1,1) = {"
ab
ad
ah
ag
ah
ad
am
at
aB
aH
am
ad
am
aS
aS
ba
am
ad
ag
ag
"}
(15,1,1) = {"
ab
ad
ag
ag
ag
ad
am
au
aC
aI
am
ad
am
aT
aS
bb
am
ad
ag
ag
"}
(16,1,1) = {"
ab
ad
ad
ag
ad
ad
am
am
am
am
am
ad
am
am
as
am
am
ad
ag
ag
"}
(17,1,1) = {"
aa
ae
ai
ai
ai
ai
ad
ad
ad
ad
ad
ad
ad
ad
ad
ad
ad
ad
ad
ad
"}
