"a" = (/turf/template_noop,/area/submap/hotspring)
"c" = (/obj/structure/bonfire/sifwood,/turf/simulated/floor/outdoors/dirt,/area/submap/hotspring)
"e" = (/obj/structure/window/reinforced{dir = 8; health = 1e+006},/obj/random/trash_pile,/turf/simulated/floor/outdoors/grass/sif,/area/submap/hotspring)
"f" = (/obj/effect/decal/cleanable/dirt,/obj/effect/decal/cleanable/dirt,/obj/effect/decal/cleanable/dirt,/obj/effect/decal/cleanable/dirt,/turf/simulated/floor/wood/sif,/area/submap/hotspring)
"g" = (/turf/simulated/floor/outdoors/mud,/area/submap/hotspring)
"h" = (/obj/structure/window/reinforced{dir = 8; health = 1e+006},/turf/simulated/floor/outdoors/grass/sif,/area/submap/hotspring)
"i" = (/obj/random/trash,/turf/simulated/floor/outdoors/grass/sif,/area/submap/hotspring)
"j" = (/obj/structure/table/rack,/obj/item/weapon/storage/fancy/candle_box,/obj/item/weapon/flame/lighter/random{pixel_x = 7},/obj/item/weapon/storage/fancy/candle_box{pixel_x = -6},/obj/item/weapon/storage/firstaid{pixel_x = 4; pixel_y = -6},/obj/item/weapon/wrapping_paper,/turf/simulated/floor/wood/sif,/area/submap/hotspring)
"k" = (/obj/effect/effect/steam,/obj/effect/map_effect/interval/effect_emitter/steam,/turf/simulated/floor/water/hotspring,/area/submap/hotspring)
"m" = (/obj/effect/effect/steam,/turf/simulated/floor/water/hotspring,/area/submap/hotspring)
"n" = (/obj/item/clothing/accessory/medal/fluff/rindeimos,/obj/effect/decal/cleanable/dirt,/obj/effect/decal/cleanable/dirt,/turf/simulated/floor/wood/sif,/area/submap/hotspring)
"o" = (/obj/structure/table/woodentable,/obj/item/pizzavoucher,/obj/item/pizzavoucher{pixel_x = -4; pixel_y = 6},/obj/item/weapon/material/harpoon,/turf/simulated/floor/wood/sif,/area/submap/hotspring)
"r" = (/obj/item/weapon/material/shard,/obj/structure/bed/chair{dir = 1},/turf/simulated/floor/wood/sif,/area/submap/hotspring)
"s" = (/obj/random/junk,/turf/simulated/floor/outdoors/dirt,/area/submap/hotspring)
"t" = (/obj/structure/table/bench/wooden,/turf/simulated/floor/outdoors/dirt,/area/submap/hotspring)
"u" = (/obj/random/junk,/turf/simulated/floor/outdoors/mud,/area/submap/hotspring)
"w" = (/obj/structure/closet/crate/bin,/turf/simulated/floor/wood/sif,/area/submap/hotspring)
"x" = (/obj/structure/table/woodentable,/obj/item/trash/candle,/obj/item/clothing/glasses/fluff/scylla,/turf/simulated/floor/wood/sif,/area/submap/hotspring)
"A" = (/obj/item/weapon/material/shard,/turf/template_noop,/area/submap/hotspring)
"D" = (/obj/structure/window/reinforced{dir = 4; health = 1e+006},/turf/template_noop,/area/submap/hotspring)
"E" = (/mob/living/simple_mob/animal/passive/gaslamp/snow,/turf/simulated/floor/outdoors/grass/sif,/area/submap/hotspring)
"F" = (/turf/simulated/floor/outdoors/dirt,/area/submap/hotspring)
"H" = (/obj/random/trash,/turf/simulated/floor/outdoors/mud,/area/submap/hotspring)
"J" = (/obj/structure/simple_door/sifwood,/turf/simulated/floor/wood/sif,/area/submap/hotspring)
"K" = (/turf/simulated/floor/outdoors/grass/sif,/area/submap/hotspring)
"L" = (/obj/item/weapon/inflatable_duck,/obj/effect/effect/steam,/turf/simulated/floor/water/hotspring,/area/submap/hotspring)
"M" = (/obj/random/junk,/obj/random/junk,/obj/effect/decal/cleanable/dirt,/turf/simulated/floor/wood/sif,/area/submap/hotspring)
"N" = (/turf/simulated/floor/outdoors/rocks,/area/submap/hotspring)
"O" = (/obj/random/trash_pile,/turf/template_noop,/area/submap/hotspring)
"P" = (/obj/structure/window/reinforced{dir = 4; health = 1e+006},/obj/item/weapon/material/shard{pixel_x = 4; pixel_y = 7},/turf/template_noop,/area/submap/hotspring)
"R" = (/obj/structure/window/reinforced{dir = 8; health = 1e+006},/obj/item/weapon/material/shard,/turf/template_noop,/area/submap/hotspring)
"T" = (/obj/effect/decal/cleanable/dirt,/turf/simulated/floor/wood/sif,/area/submap/hotspring)
"U" = (/obj/structure/table/rack,/obj/item/clothing/under/swimsuit/striped,/obj/item/clothing/under/swimsuit/fluff/zara_uniform,/obj/item/clothing/under/swimsuit/stripper/stripper_pink,/turf/simulated/floor/wood/sif,/area/submap/hotspring)
"X" = (/obj/random/junk,/obj/random/junk,/turf/simulated/floor/outdoors/dirt,/area/submap/hotspring)
"Y" = (/turf/simulated/wall/log_sif,/area/submap/hotspring)
"Z" = (/obj/item/weapon/material/shard,/obj/item/weapon/material/shard{pixel_x = 5},/turf/template_noop,/area/submap/hotspring)

(1,1,1) = {"
DYYYYYRaaaaFaaa
DoxwjUZaaaKFaga
ArMnfTeKKKFKKKa
PYYYJYhtttuFFKa
aOKXggFggHgNgFK
aaKEFggNmmmggKa
aatKsgmLmmggsKa
aFcFggmkmggFKia
aatKFgmmmgFKEKa
aaKFugNgggsKKFg
aaKKFtttFgFKFKa
aaKKiKKKKFKKFKa
aaKKFKFKKKKFKKa
aKgFaagFaaaaaKa
aaaaaaaaaaaaaaa
"}
