//MAP CONVERTED BY dmm2tgm.py THIS HEADER COMMENT PREVENTS RECONVERSION, DO NOT REMOVE
"au" = (
/obj/item/organ/internal/lungs/vox,
/obj/item/weapon/beartrap/hunting{
	anchored = 1;
	deployed = 1;
	icon_state = "beartrap1"
	},
/obj/structure/curtain/black,
/obj/random/junk,
/obj/random/junk,
/obj/random/junk,
/obj/effect/decal/cleanable/dirt,
/obj/effect/decal/cleanable/dirt,
/turf/simulated/floor,
/area/submap/lonehome)
"aw" = (
/obj/structure/flora/tree/sif,
/turf/template_noop,
/area/submap/lonehome)
"aI" = (
/obj/structure/window/reinforced{
	dir = 8;
	health = 1e+006
	},
/obj/structure/flora/pottedplant/fern{
	pixel_y = 12
	},
/obj/structure/table/bench/wooden,
/turf/simulated/floor/wood,
/area/submap/lonehome)
"aJ" = (
/obj/item/weapon/paper{
	info = "Seems to be filled with odd runes drawn with blood";
	name = "Blood stained paper"
	},
/turf/simulated/floor/wood/broken,
/area/submap/lonehome)
"aK" = (
/obj/effect/decal/cleanable/dirt,
/turf/simulated/floor,
/area/submap/lonehome)
"bK" = (
/obj/effect/decal/cleanable/dirt,
/obj/effect/decal/cleanable/dirt,
/obj/effect/decal/cleanable/dirt,
/turf/simulated/floor/wood/broken,
/area/submap/lonehome)
"ck" = (
/obj/machinery/light/small{
	dir = 8
	},
/obj/effect/decal/cleanable/dirt,
/obj/effect/decal/cleanable/dirt,
/obj/effect/decal/cleanable/dirt,
/turf/simulated/floor/wood,
/area/submap/lonehome)
"cn" = (
/obj/machinery/light{
	dir = 8
	},
/obj/item/weapon/paper/courtroom,
/obj/item/weapon/paper/courtroom,
/obj/item/weapon/paper_bin,
/obj/structure/table/wooden_reinforced,
/turf/simulated/floor/wood,
/area/submap/lonehome)
"cE" = (
/obj/structure/table/marble,
/obj/item/organ/internal/brain/grey,
/obj/item/weapon/material/knife/plastic,
/turf/simulated/floor,
/area/submap/lonehome)
"dv" = (
/obj/item/weapon/paper{
	info = "Seems to be filled with odd runes drawn with blood";
	name = "Blood stained paper"
	},
/turf/simulated/floor/wood,
/area/submap/lonehome)
"ew" = (
/obj/machinery/light/small{
	dir = 4
	},
/obj/effect/decal/cleanable/dirt,
/obj/effect/decal/cleanable/dirt,
/turf/simulated/floor,
/area/submap/lonehome)
"eA" = (
/obj/structure/table/fancyblack,
/obj/effect/decal/cleanable/dirt,
/turf/simulated/floor/wood,
/area/submap/lonehome)
"fi" = (
/obj/effect/decal/cleanable/dirt,
/obj/effect/decal/cleanable/dirt,
/turf/simulated/floor,
/area/submap/lonehome)
"fl" = (
/obj/random/trash_pile,
/turf/template_noop,
/area/submap/lonehome)
"gn" = (
/obj/structure/window/reinforced{
	dir = 4;
	health = 1e+006
	},
/turf/template_noop,
/area/submap/lonehome)
"gC" = (
/obj/structure/girder,
/obj/effect/decal/cleanable/dirt,
/turf/simulated/floor,
/area/submap/lonehome)
"gI" = (
/obj/structure/table/rack,
/obj/item/weapon/material/knife/ritual,
/obj/structure/curtain/open/bed,
/obj/item/clothing/under/suit_jacket/really_black,
/obj/item/clothing/under/suit_jacket/navy,
/obj/item/clothing/head/soft/solgov/veteranhat,
/turf/simulated/floor/wood,
/area/submap/lonehome)
"hh" = (
/obj/item/weapon/reagent_containers/food/condiment/small/peppermill,
/obj/item/weapon/pen,
/turf/simulated/floor/wood,
/area/submap/lonehome)
"hq" = (
/obj/structure/table/bench/marble,
/obj/structure/flora/pottedplant/dead{
	pixel_y = 7
	},
/obj/structure/window/reinforced/polarized{
	id = "h-master"
	},
/turf/simulated/floor/wood,
/area/submap/lonehome)
"hH" = (
/obj/structure/table/marble,
/obj/item/weapon/material/sharpeningkit,
/obj/item/weapon/reagent_containers/dropper,
/turf/simulated/floor/tiled/white,
/area/submap/lonehome)
"hK" = (
/obj/structure/bed/chair/wood{
	dir = 1
	},
/obj/structure/window/reinforced/polarized{
	dir = 4;
	id = "h-kitchen"
	},
/turf/simulated/floor/wood,
/area/submap/lonehome)
"ii" = (
/obj/random/junk,
/obj/effect/decal/cleanable/dirt,
/turf/simulated/floor/wood,
/area/submap/lonehome)
"ip" = (
/obj/item/weapon/pen,
/obj/effect/decal/cleanable/dirt,
/turf/simulated/floor/wood,
/area/submap/lonehome)
"iw" = (
/turf/simulated/floor/wood/broken,
/area/submap/lonehome)
"iQ" = (
/obj/structure/table/marble,
/obj/item/weapon/material/knife/butch,
/obj/item/weapon/material/kitchen/rollingpin,
/turf/simulated/floor/tiled/white,
/area/submap/lonehome)
"jt" = (
/obj/structure/fence/corner{
	dir = 8
	},
/turf/simulated/floor/outdoors/grass/heavy,
/area/submap/lonehome)
"jy" = (
/obj/item/weapon/material/shard,
/obj/item/weapon/material/shard{
	pixel_x = 5;
	pixel_y = 10
	},
/obj/effect/decal/cleanable/dirt,
/obj/effect/decal/cleanable/dirt,
/turf/simulated/floor/wood,
/area/submap/lonehome)
"jH" = (
/obj/item/weapon/material/kitchen/utensil/spoon{
	pixel_x = 2
	},
/turf/simulated/floor/wood,
/area/submap/lonehome)
"jK" = (
/obj/structure/bed/chair/wood,
/turf/simulated/floor/wood,
/area/submap/lonehome)
"kg" = (
/obj/structure/table/marble,
/obj/item/weapon/material/kitchen/utensil/spoon,
/turf/simulated/floor/tiled/white,
/area/submap/lonehome)
"kn" = (
/obj/structure/bed/chair/wood,
/obj/structure/window/reinforced/polarized{
	dir = 4;
	id = "h-kitchen"
	},
/turf/simulated/floor/wood,
/area/submap/lonehome)
"ks" = (
/obj/item/weapon/photo,
/obj/item/weapon/photo{
	pixel_x = 4
	},
/obj/structure/table/bench/wooden,
/turf/simulated/floor/wood,
/area/submap/lonehome)
"kT" = (
/obj/machinery/light/small{
	dir = 1
	},
/obj/structure/bed/padded,
/obj/item/weapon/bedsheet/cosmos,
/obj/item/weapon/book/custom_library/fiction/truelovehathmyheart,
/obj/effect/decal/cleanable/dirt,
/turf/simulated/floor/wood,
/area/submap/lonehome)
"kU" = (
/obj/structure/table/rack/shelf/steel,
/obj/item/weapon/chainsaw,
/obj/item/weapon/storage/box/lights/mixed,
/obj/item/weapon/extinguisher,
/obj/item/weapon/storage/toolbox/mechanical,
/turf/simulated/floor,
/area/submap/lonehome)
"ld" = (
/obj/machinery/power/port_gen/pacman,
/turf/simulated/floor,
/area/submap/lonehome)
"lz" = (
/obj/item/weapon/reagent_containers/glass/rag,
/obj/item/clothing/gloves/ring/engagement,
/obj/structure/table/wooden_reinforced,
/turf/simulated/floor/wood,
/area/submap/lonehome)
"lB" = (
/obj/structure/table/fancyblack,
/obj/item/trash/plate,
/obj/structure/window/reinforced/polarized{
	dir = 4;
	id = "h-kitchen"
	},
/turf/simulated/floor/wood,
/area/submap/lonehome)
"lJ" = (
/obj/item/device/tape,
/obj/structure/table/wooden_reinforced,
/turf/simulated/floor/wood,
/area/submap/lonehome)
"lS" = (
/obj/item/organ/internal/liver,
/obj/random/trash,
/turf/simulated/floor,
/area/submap/lonehome)
"mn" = (
/obj/item/clothing/mask/muzzle,
/obj/random/trash,
/turf/simulated/floor,
/area/submap/lonehome)
"na" = (
/mob/living/simple_mob/animal/passive/cat/bones{
	desc = "A very odd behaved cat, their scratched name tag reads 'Felix'. They look very malnourished.";
	name = "Felix"
	},
/turf/simulated/floor/wood,
/area/submap/lonehome)
"nz" = (
/obj/item/device/flashlight{
	pixel_x = 2;
	pixel_y = 2
	},
/obj/effect/decal/cleanable/dirt,
/obj/effect/decal/cleanable/dirt,
/turf/simulated/floor,
/area/submap/lonehome)
"nD" = (
/obj/structure/bed/chair/oldsofa/left,
/turf/simulated/floor/wood,
/area/submap/lonehome)
"nL" = (
/obj/machinery/appliance/cooker/oven,
/turf/simulated/floor/tiled/white,
/area/submap/lonehome)
"nT" = (
/obj/item/stack/cable_coil,
/obj/effect/decal/cleanable/dirt,
/turf/simulated/floor/wood/broken,
/area/submap/lonehome)
"ox" = (
/obj/structure/closet/cabinet,
/obj/item/weapon/storage/wallet/random,
/obj/item/weapon/towel/random,
/obj/item/weapon/melee/umbrella/random,
/obj/random/ammo,
/obj/random/cigarettes,
/obj/random/contraband,
/obj/random/junk,
/obj/random/maintenance/security,
/turf/simulated/floor/wood,
/area/submap/lonehome)
"oS" = (
/obj/structure/closet/cabinet,
/obj/random/tech_supply/component,
/obj/random/tech_supply/component,
/obj/random/tech_supply/component,
/obj/random/tech_supply/component,
/obj/random/tech_supply/component,
/obj/random/toolbox,
/obj/random/toolbox,
/turf/simulated/floor/wood,
/area/submap/lonehome)
"oZ" = (
/obj/structure/table/fancyblack,
/turf/simulated/floor/wood,
/area/submap/lonehome)
"pb" = (
/obj/structure/fence/cut/large{
	dir = 8
	},
/turf/template_noop,
/area/submap/lonehome)
"po" = (
/obj/structure/sign/periodic,
/turf/simulated/wall/wood,
/area/submap/lonehome)
"pX" = (
/obj/structure/simple_door/wood,
/obj/structure/sign/graffiti/pisoff,
/turf/simulated/floor/wood,
/area/submap/lonehome)
"qa" = (
/obj/structure/fence,
/turf/simulated/floor/outdoors/grass/heavy,
/area/submap/lonehome)
"qi" = (
/obj/structure/table/marble,
/obj/machinery/chemical_dispenser/bar_alc/full,
/turf/simulated/floor/tiled/white,
/area/submap/lonehome)
"qk" = (
/obj/structure/table/marble,
/obj/machinery/light{
	dir = 1
	},
/obj/machinery/microwave,
/turf/simulated/floor/tiled/white,
/area/submap/lonehome)
"qo" = (
/obj/item/weapon/phone,
/obj/structure/table/bench/wooden,
/obj/item/weapon/paper{
	info = "Seems to be filled with odd runes drawn with blood";
	name = "Blood stained paper"
	},
/obj/machinery/button/windowtint{
	id = "h-master";
	pixel_y = -29
	},
/turf/simulated/floor/wood,
/area/submap/lonehome)
"qz" = (
/obj/effect/decal/cleanable/dirt,
/obj/effect/decal/cleanable/dirt,
/turf/simulated/floor/wood,
/area/submap/lonehome)
"qE" = (
/obj/effect/decal/cleanable/blood/gibs,
/turf/simulated/floor,
/area/submap/lonehome)
"rg" = (
/obj/structure/bed/chair/oldsofa{
	dir = 4
	},
/obj/structure/window/reinforced/polarized{
	dir = 8;
	id = "h-living"
	},
/turf/simulated/floor/wood,
/area/submap/lonehome)
"ro" = (
/obj/item/weapon/pack/cardemon,
/obj/effect/decal/cleanable/dirt,
/obj/effect/decal/cleanable/dirt,
/turf/simulated/floor/carpet/bcarpet,
/area/submap/lonehome)
"ru" = (
/obj/structure/table/rack,
/obj/item/weapon/makeover,
/obj/structure/curtain/open/bed,
/obj/item/clothing/under/swimsuit/fluff/penelope,
/turf/simulated/floor/wood,
/area/submap/lonehome)
"rE" = (
/obj/item/weapon/material/shard,
/turf/simulated/floor/outdoors/grass/heavy,
/area/submap/lonehome)
"tp" = (
/obj/structure/flora/pottedplant/bamboo{
	pixel_y = 12
	},
/obj/structure/table/bench/wooden,
/turf/simulated/floor/wood,
/area/submap/lonehome)
"uc" = (
/obj/structure/girder,
/turf/simulated/floor,
/area/submap/lonehome)
"uh" = (
/obj/structure/fence/cut/medium{
	dir = 4
	},
/turf/simulated/floor/outdoors/grass/heavy,
/area/submap/lonehome)
"um" = (
/obj/structure/window/reinforced/tinted/frosted{
	dir = 8
	},
/obj/item/weapon/book/tome/imbued,
/obj/structure/table/wooden_reinforced,
/turf/simulated/floor/wood,
/area/submap/lonehome)
"uo" = (
/obj/item/weapon/material/shard,
/turf/simulated/floor/outdoors/dirt,
/area/submap/lonehome)
"ur" = (
/obj/structure/table/marble,
/obj/item/organ/internal/fruitgland,
/obj/item/weapon/material/knife/hook,
/turf/simulated/floor,
/area/submap/lonehome)
"uw" = (
/obj/item/seeds/random,
/obj/item/weapon/reagent_containers/spray/cleaner,
/obj/structure/table/wooden_reinforced,
/turf/simulated/floor/wood,
/area/submap/lonehome)
"uC" = (
/obj/item/seeds/random,
/obj/item/seeds/random,
/obj/machinery/space_heater,
/turf/simulated/floor/wood,
/area/submap/lonehome)
"uI" = (
/obj/machinery/portable_atmospherics/hydroponics/soil,
/turf/simulated/floor/outdoors/grass/heavy,
/area/submap/lonehome)
"uK" = (
/obj/item/weapon/material/minihoe,
/turf/simulated/floor/outdoors/grass/heavy,
/area/submap/lonehome)
"uR" = (
/obj/structure/trash_pile,
/turf/template_noop,
/area/submap/lonehome)
"ve" = (
/obj/structure/table/bench/glass,
/turf/simulated/floor/carpet/sblucarpet,
/area/submap/lonehome)
"wa" = (
/turf/simulated/floor/wood,
/area/submap/lonehome)
"wj" = (
/obj/item/weapon/bedsheet/rddouble,
/turf/simulated/floor/wood,
/area/submap/lonehome)
"xr" = (
/obj/effect/decal/cleanable/dirt,
/obj/effect/decal/cleanable/dirt,
/obj/effect/decal/cleanable/dirt,
/turf/simulated/floor/carpet/bcarpet,
/area/submap/lonehome)
"xA" = (
/obj/random/trash,
/obj/effect/decal/cleanable/dirt,
/turf/simulated/floor/carpet/sblucarpet,
/area/submap/lonehome)
"xM" = (
/obj/structure/fence/cut/large{
	dir = 8
	},
/turf/simulated/floor/outdoors/grass/heavy,
/area/submap/lonehome)
"xO" = (
/obj/item/clothing/suit/straight_jacket,
/turf/simulated/floor,
/area/submap/lonehome)
"yh" = (
/turf/simulated/floor/outdoors/dirt,
/area/submap/lonehome)
"yn" = (
/obj/structure/bed/chair/oldsofa/corner{
	dir = 4
	},
/obj/structure/window/reinforced/polarized{
	dir = 8;
	id = "h-living"
	},
/turf/simulated/floor/wood,
/area/submap/lonehome)
"yr" = (
/obj/item/weapon/reagent_containers/blood,
/obj/item/weapon/pack/cardemon,
/obj/item/weapon/pack/cardemon,
/obj/item/weapon/deck/tarot,
/obj/structure/table/wooden_reinforced,
/turf/simulated/floor/wood,
/area/submap/lonehome)
"yv" = (
/obj/effect/decal/cleanable/dirt,
/obj/effect/decal/cleanable/dirt,
/turf/simulated/floor/wood/broken,
/area/submap/lonehome)
"yF" = (
/obj/structure/bed/chair/oldsofa/left{
	dir = 1
	},
/turf/simulated/floor/wood,
/area/submap/lonehome)
"Aq" = (
/obj/effect/decal/cleanable/dirt,
/obj/item/weapon/paper{
	info = "F%$K this detective, I swear I can see them peeking from behind the window, these tinted glasses help but I swear I can still see them snooping around. His days are counted... I am so close to figuring this out, just need a few more days. Then Shepiffany will be part of the family once again, then our two kids and I can go back on having a normal life... a normal life...";
	name = "Stained sheet of paper"
	},
/turf/simulated/floor/carpet/sblucarpet,
/area/submap/lonehome)
"AQ" = (
/obj/structure/window/reinforced{
	dir = 8;
	health = 1e+006
	},
/obj/item/weapon/material/shard,
/turf/simulated/floor/outdoors/dirt,
/area/submap/lonehome)
"BS" = (
/obj/effect/decal/cleanable/dirt,
/obj/effect/decal/cleanable/dirt,
/turf/simulated/floor/tiled/white,
/area/submap/lonehome)
"Dd" = (
/obj/structure/table/rack/shelf/steel,
/obj/item/weapon/storage/box/donkpockets,
/obj/item/weapon/storage/box/condimentbottles,
/obj/item/weapon/reagent_containers/food/condiment/sugar,
/obj/structure/curtain/open/bed,
/obj/structure/window/reinforced/polarized{
	dir = 4;
	id = "h-kitchen"
	},
/turf/simulated/floor/tiled/white,
/area/submap/lonehome)
"Dr" = (
/obj/effect/decal/cleanable/dirt,
/turf/simulated/floor/carpet/sblucarpet,
/area/submap/lonehome)
"DE" = (
/obj/structure/window/reinforced/tinted/frosted{
	dir = 8
	},
/obj/structure/table/rack/shelf/steel,
/obj/item/weapon/storage/box/glasses/square{
	pixel_y = -2
	},
/obj/item/weapon/storage/box/glass_extras/sticks{
	pixel_y = 4
	},
/obj/item/weapon/storage/box/glass_extras/straws{
	pixel_y = 7
	},
/obj/item/weapon/packageWrap,
/obj/structure/curtain/open/bed,
/obj/item/weapon/material/kitchen/utensil/fork,
/obj/item/weapon/material/kitchen/utensil/fork,
/obj/item/weapon/material/kitchen/utensil/spoon{
	pixel_x = 2
	},
/obj/item/weapon/material/kitchen/utensil/spoon{
	pixel_x = 2
	},
/turf/simulated/floor/tiled/white,
/area/submap/lonehome)
"DG" = (
/obj/structure/simple_door/wood,
/turf/simulated/floor,
/area/submap/lonehome)
"DL" = (
/obj/structure/closet/cabinet,
/obj/item/weapon/storage/wallet/random,
/obj/item/weapon/towel/random,
/obj/item/weapon/melee/umbrella/random,
/obj/random/carp_plushie,
/obj/random/curseditem,
/obj/random/junk,
/obj/random/maintenance/medical,
/obj/random/maintenance/medical,
/turf/simulated/floor/wood,
/area/submap/lonehome)
"Ea" = (
/obj/item/weapon/pack/cardemon,
/obj/effect/decal/cleanable/dirt,
/turf/simulated/floor/wood,
/area/submap/lonehome)
"Ek" = (
/obj/structure/window/reinforced{
	dir = 4;
	health = 1e+006
	},
/turf/simulated/floor/outdoors/dirt,
/area/submap/lonehome)
"Eo" = (
/obj/random/junk,
/turf/simulated/floor/carpet/sblucarpet,
/area/submap/lonehome)
"EZ" = (
/obj/effect/decal/cleanable/blood/gibs,
/obj/structure/table/marble,
/obj/item/organ/internal/intestine/unathi,
/obj/item/weapon/surgical/bonesetter,
/obj/item/weapon/bone/ribs,
/obj/item/weapon/bone/skull{
	pixel_x = 4;
	pixel_y = 6
	},
/turf/simulated/floor,
/area/submap/lonehome)
"Fh" = (
/obj/structure/coatrack,
/obj/machinery/button/windowtint{
	id = "h-living";
	pixel_x = -27
	},
/turf/simulated/floor/wood,
/area/submap/lonehome)
"Fu" = (
/turf/simulated/floor/carpet/sblucarpet,
/area/submap/lonehome)
"Fy" = (
/obj/structure/window/reinforced{
	dir = 1
	},
/obj/machinery/portable_atmospherics/hydroponics/soil,
/turf/simulated/floor/outdoors/grass/heavy,
/area/submap/lonehome)
"Gm" = (
/turf/simulated/wall/wood,
/area/submap/lonehome)
"Gr" = (
/obj/structure/table/bench/marble,
/obj/structure/flora/pottedplant/bamboo{
	pixel_y = 7
	},
/obj/structure/window/reinforced/polarized{
	id = "h-master"
	},
/turf/simulated/floor/wood,
/area/submap/lonehome)
"GA" = (
/obj/structure/table/fancyblack,
/obj/item/weapon/reagent_containers/food/snacks/ghostmuffin/poison,
/turf/simulated/floor/wood,
/area/submap/lonehome)
"GS" = (
/obj/structure/table/steel,
/obj/item/stack/material/phoron{
	amount = 5
	},
/obj/item/stack/material/phoron{
	amount = 5
	},
/obj/fiftyspawner/wood,
/obj/fiftyspawner/steel,
/turf/simulated/floor,
/area/submap/lonehome)
"Hc" = (
/obj/effect/decal/cleanable/blood/gibs,
/obj/structure/kitchenspike,
/obj/effect/rune,
/turf/simulated/floor,
/area/submap/lonehome)
"Hu" = (
/obj/item/frame/apc,
/obj/machinery/light_switch{
	pixel_x = 11;
	pixel_y = 22
	},
/obj/random/junk,
/turf/simulated/floor,
/area/submap/lonehome)
"Im" = (
/obj/structure/window/reinforced/tinted/frosted{
	dir = 8
	},
/turf/simulated/floor/wood,
/area/submap/lonehome)
"Ji" = (
/obj/structure/fence/cut/medium,
/turf/simulated/floor/outdoors/grass/heavy,
/area/submap/lonehome)
"Jq" = (
/obj/structure/bed/double/padded,
/obj/machinery/light/small{
	dir = 4
	},
/turf/simulated/floor/wood,
/area/submap/lonehome)
"JW" = (
/obj/structure/simple_door/wood,
/turf/simulated/floor/wood,
/area/submap/lonehome)
"Kb" = (
/obj/structure/loot_pile/maint/trash,
/turf/simulated/floor/outdoors/grass/heavy,
/area/submap/lonehome)
"Ki" = (
/obj/structure/closet/cabinet,
/obj/random/multiple,
/obj/random/multiple,
/obj/random/multiple,
/obj/random/multiple,
/obj/random/multiple,
/obj/random/toy,
/obj/random/toy,
/obj/item/weapon/storage/mre/random,
/obj/item/weapon/storage/mre/random,
/turf/simulated/floor/wood,
/area/submap/lonehome)
"Kr" = (
/obj/machinery/portable_atmospherics/hydroponics/soil,
/obj/item/weapon/material/shard,
/turf/simulated/floor/outdoors/grass/heavy,
/area/submap/lonehome)
"Kw" = (
/obj/structure/closet/secure_closet/freezer/fridge,
/obj/random/meat,
/obj/random/meat,
/obj/random/meat,
/obj/random/meat,
/obj/random/meat,
/turf/simulated/floor/tiled/white,
/area/submap/lonehome)
"KM" = (
/obj/effect/decal/cleanable/dirt,
/obj/effect/decal/cleanable/dirt,
/obj/item/weapon/paper{
	info = "Seems to be filled with odd runes drawn with blood";
	name = "Blood stained paper"
	},
/turf/simulated/floor/carpet/sblucarpet,
/area/submap/lonehome)
"Ll" = (
/obj/machinery/space_heater,
/turf/simulated/floor/wood,
/area/submap/lonehome)
"Lv" = (
/obj/effect/decal/cleanable/dirt,
/turf/simulated/floor/wood/broken,
/area/submap/lonehome)
"LS" = (
/obj/structure/table/fancyblack,
/obj/item/trash/plate,
/obj/item/weapon/reagent_containers/food/condiment/small/saltshaker,
/turf/simulated/floor/wood,
/area/submap/lonehome)
"Mb" = (
/obj/structure/bed/chair/wood{
	dir = 1
	},
/obj/machinery/button/windowtint{
	id = "h-kitchen";
	pixel_y = -29
	},
/turf/simulated/floor/wood,
/area/submap/lonehome)
"Mn" = (
/obj/item/weapon/reagent_containers/food/condiment/enzyme,
/obj/structure/window/reinforced/polarized{
	dir = 4;
	id = "h-kitchen"
	},
/turf/simulated/floor/tiled/white,
/area/submap/lonehome)
"MM" = (
/turf/simulated/floor/outdoors/grass/heavy,
/area/submap/lonehome)
"Nx" = (
/obj/machinery/light{
	dir = 4
	},
/turf/simulated/floor/wood,
/area/submap/lonehome)
"ND" = (
/obj/structure/table/bench/marble,
/obj/structure/window/reinforced/polarized{
	dir = 8;
	id = "h-living"
	},
/turf/simulated/floor/wood,
/area/submap/lonehome)
"NK" = (
/obj/random/trash,
/obj/effect/decal/cleanable/dirt,
/obj/effect/decal/cleanable/dirt,
/turf/simulated/floor/carpet/sblucarpet,
/area/submap/lonehome)
"NL" = (
/turf/template_noop,
/area/submap/lonehome)
"Od" = (
/obj/structure/table/rack/shelf/steel,
/obj/item/weapon/extinguisher{
	pixel_x = 8;
	pixel_y = 1
	},
/obj/random/maintenance/medical,
/obj/random/maintenance/medical,
/obj/random/maintenance/medical,
/obj/random/medical/lite,
/obj/random/medical/lite,
/obj/structure/mopbucket{
	pixel_x = -8;
	pixel_y = -4
	},
/obj/item/weapon/mop,
/obj/item/device/multitool,
/obj/item/device/flashlight{
	pixel_x = 2;
	pixel_y = 2
	},
/obj/random/unidentified_medicine,
/obj/random/unidentified_medicine,
/obj/random/unidentified_medicine,
/turf/simulated/floor/tiled,
/area/submap/lonehome)
"Oe" = (
/obj/structure/window/reinforced{
	dir = 8;
	health = 1e+006
	},
/turf/template_noop,
/area/submap/lonehome)
"Or" = (
/obj/structure/table/bench/marble,
/obj/structure/flora/pottedplant/overgrown{
	pixel_y = 7
	},
/obj/structure/window/reinforced/polarized{
	id = "h-master"
	},
/turf/simulated/floor/wood,
/area/submap/lonehome)
"OL" = (
/obj/structure/table/fancyblack,
/obj/item/weapon/material/kitchen/utensil/spoon{
	pixel_x = 2
	},
/obj/structure/window/reinforced/polarized{
	dir = 4;
	id = "h-kitchen"
	},
/turf/simulated/floor/wood,
/area/submap/lonehome)
"Pc" = (
/obj/item/weapon/material/kitchen/utensil/fork,
/obj/random/trash,
/turf/simulated/floor/wood,
/area/submap/lonehome)
"Qx" = (
/obj/item/weapon/material/shard{
	pixel_x = 6
	},
/obj/item/weapon/material/shard,
/turf/simulated/floor/outdoors/dirt,
/area/submap/lonehome)
"QU" = (
/obj/effect/decal/cleanable/blood/gibs,
/obj/item/clothing/gloves/yellow,
/turf/simulated/floor,
/area/submap/lonehome)
"QX" = (
/obj/random/trash,
/turf/simulated/floor/wood,
/area/submap/lonehome)
"RI" = (
/obj/structure/window/reinforced{
	dir = 8;
	health = 1e+006
	},
/turf/simulated/floor/outdoors/dirt,
/area/submap/lonehome)
"Sd" = (
/obj/structure/fence/corner,
/turf/template_noop,
/area/submap/lonehome)
"Sp" = (
/obj/item/weapon/material/shard,
/obj/item/weapon/material/shard{
	pixel_x = 5;
	pixel_y = 3
	},
/turf/simulated/floor/outdoors/dirt,
/area/submap/lonehome)
"SN" = (
/obj/structure/bed/chair/wood/wings{
	dir = 1
	},
/obj/effect/decal/cleanable/dirt,
/turf/simulated/floor/carpet/sblucarpet,
/area/submap/lonehome)
"Ta" = (
/obj/effect/decal/cleanable/dirt,
/turf/simulated/floor/tiled/white,
/area/submap/lonehome)
"Tg" = (
/obj/item/weapon/material/kitchen/utensil/fork,
/obj/effect/decal/cleanable/dirt,
/turf/simulated/floor/wood,
/area/submap/lonehome)
"Tw" = (
/obj/item/weapon/cell/high/empty,
/turf/simulated/floor/carpet/sblucarpet,
/area/submap/lonehome)
"TX" = (
/obj/item/clothing/suit/storage/apron/white,
/obj/effect/decal/cleanable/dirt,
/obj/effect/decal/cleanable/dirt,
/turf/simulated/floor/tiled/white,
/area/submap/lonehome)
"Uj" = (
/obj/machinery/light/small,
/obj/item/weapon/ore/diamond,
/obj/structure/sign/goldenplaque{
	desc = "Done No Harm.";
	name = "Best Doctor 2552";
	pixel_y = -32
	},
/obj/structure/table/wooden_reinforced,
/turf/simulated/floor/wood,
/area/submap/lonehome)
"UA" = (
/obj/structure/fence/door/opened,
/turf/template_noop,
/area/submap/lonehome)
"UB" = (
/obj/structure/table/rack/shelf/steel,
/obj/item/weapon/storage/box/characters,
/obj/structure/curtain/open/bed,
/turf/simulated/floor/wood,
/area/submap/lonehome)
"US" = (
/turf/simulated/floor/tiled/white,
/area/submap/lonehome)
"Vn" = (
/obj/item/weapon/reagent_containers/food/condiment/small/sugar,
/obj/effect/decal/cleanable/dirt,
/turf/simulated/floor/wood/broken,
/area/submap/lonehome)
"VI" = (
/obj/structure/fence{
	dir = 4
	},
/turf/template_noop,
/area/submap/lonehome)
"Wf" = (
/obj/structure/bed/padded,
/obj/item/weapon/bedsheet/pirate,
/obj/random/trash,
/obj/random/trash,
/obj/random/trash,
/obj/random/trash,
/obj/random/trash,
/obj/random/junk,
/obj/random/junk,
/obj/random/junk,
/obj/random/junk,
/turf/simulated/floor/wood,
/area/submap/lonehome)
"Wj" = (
/obj/machinery/gibber/autogibber{
	emagged = 1
	},
/turf/simulated/floor,
/area/submap/lonehome)
"Wn" = (
/obj/structure/fence/cut/medium{
	dir = 4
	},
/turf/template_noop,
/area/submap/lonehome)
"WQ" = (
/obj/structure/bed/chair/oldsofa/corner{
	dir = 1
	},
/obj/structure/window/reinforced/polarized{
	dir = 8;
	id = "h-living"
	},
/turf/simulated/floor/wood,
/area/submap/lonehome)
"Xc" = (
/obj/item/weapon/module/power_control,
/obj/effect/decal/cleanable/dirt,
/turf/simulated/floor/wood,
/area/submap/lonehome)
"Xz" = (
/obj/item/weapon/material/shard,
/turf/template_noop,
/area/submap/lonehome)
"Ys" = (
/obj/item/weapon/pen/fountain,
/turf/simulated/floor/wood,
/area/submap/lonehome)
"YK" = (
/obj/structure/table/marble,
/obj/item/organ/internal/intestine/unathi{
	pixel_x = -1;
	pixel_y = 8
	},
/obj/item/organ/internal/lungs,
/turf/simulated/floor,
/area/submap/lonehome)
"Zg" = (
/obj/effect/decal/cleanable/dirt,
/turf/simulated/floor/wood,
/area/submap/lonehome)
"Zi" = (
/obj/machinery/light{
	dir = 8
	},
/obj/effect/decal/cleanable/dirt,
/turf/simulated/floor/wood,
/area/submap/lonehome)
"ZL" = (
/obj/effect/decal/cleanable/dirt,
/obj/effect/decal/cleanable/dirt,
/turf/simulated/floor/carpet/sblucarpet,
/area/submap/lonehome)
"ZR" = (
/obj/structure/fence{
	dir = 4
	},
/turf/simulated/floor/outdoors/grass/heavy,
/area/submap/lonehome)

(1,1,1) = {"
NL
NL
NL
NL
NL
NL
yh
NL
Xz
NL
Xz
NL
NL
NL
NL
uR
NL
NL
MM
NL
NL
NL
NL
MM
NL
"}
(2,1,1) = {"
NL
NL
NL
NL
NL
Gm
NL
gn
Sp
Ek
Ek
uc
Gm
Gm
Gm
Gm
Gm
NL
NL
MM
MM
NL
MM
MM
NL
"}
(3,1,1) = {"
NL
NL
NL
yh
Gm
Gm
ND
yn
rg
rg
WQ
Gm
Gm
DL
cn
ox
po
Gm
Gm
qa
Ji
qa
jt
NL
NL
"}
(4,1,1) = {"
NL
NL
NL
Gm
Gm
Fh
wa
nD
ve
ve
yF
Gm
ru
dv
Ys
na
Ll
Gm
Kr
MM
MM
MM
VI
NL
NL
"}
(5,1,1) = {"
NL
yh
yh
yh
JW
Lv
qz
eA
Fu
Fu
oZ
Gm
gI
Tw
KM
xA
iw
Or
Fy
MM
MM
MM
pb
NL
NL
"}
(6,1,1) = {"
yh
yh
NL
Gm
Gm
Ll
iw
Lv
Dr
Dr
wa
Gm
um
SN
NK
Fu
wa
Gr
Kr
rE
MM
MM
uh
NL
NL
"}
(7,1,1) = {"
NL
yh
NL
NL
Gm
uc
wa
iw
Eo
ZL
Zg
uc
Zg
Aq
Fu
Fu
wj
hq
uI
MM
MM
MM
ZR
NL
NL
"}
(8,1,1) = {"
yh
NL
NL
NL
NL
Gm
lJ
QX
wa
Nx
Xc
Gm
aJ
iw
ks
Jq
qo
Gm
Fy
MM
MM
MM
ZR
NL
NL
"}
(9,1,1) = {"
NL
NL
aw
NL
NL
Gm
Gm
uc
JW
Gm
tp
Gm
JW
Gm
uc
Gm
Gm
Gm
Gm
uK
MM
MM
pb
NL
NL
"}
(10,1,1) = {"
NL
NL
NL
NL
fl
Gm
Od
JW
Zg
Zg
jy
bK
yv
ck
qz
qz
qz
Lv
JW
MM
Kb
MM
UA
NL
NL
"}
(11,1,1) = {"
NL
NL
NL
NL
Gm
Gm
Gm
Gm
JW
Gm
aI
uc
Gm
Gm
Gm
pX
Gm
Gm
Gm
DG
Gm
MM
VI
NL
aw
"}
(12,1,1) = {"
NL
NL
NL
NL
Gm
Kw
BS
iQ
wa
Zi
wa
ip
uC
Gm
UB
yv
Ll
aK
ld
fi
Gm
MM
pb
NL
NL
"}
(13,1,1) = {"
NL
NL
NL
NL
uc
nL
BS
kg
Zg
nT
Zg
jH
uw
uc
Im
xr
Ea
Gm
Hu
fi
Gm
MM
VI
NL
NL
"}
(14,1,1) = {"
NL
NL
NL
NL
uc
qk
TX
hH
ii
Lv
Vn
wa
Uj
Gm
kT
ro
Wf
Gm
GS
nz
uc
MM
Wn
NL
NL
"}
(15,1,1) = {"
NL
NL
NL
NL
Gm
qi
Ta
Ta
Tg
Lv
Pc
hh
lz
Gm
Ki
yr
oS
Gm
kU
ew
Gm
MM
VI
NL
NL
"}
(16,1,1) = {"
NL
NL
NL
NL
Gm
Gm
DE
US
jK
LS
GA
Mb
Gm
Gm
Gm
Gm
Gm
Gm
Gm
gC
Gm
MM
VI
NL
NL
"}
(17,1,1) = {"
NL
NL
NL
NL
NL
Gm
Dd
Mn
kn
OL
lB
hK
Gm
Hc
xO
lS
mn
QU
qE
au
uc
MM
xM
NL
NL
"}
(18,1,1) = {"
NL
aw
NL
NL
NL
Gm
yh
AQ
Qx
RI
Xz
Oe
Gm
Gm
Wj
EZ
cE
ur
YK
Gm
Gm
qa
Sd
MM
NL
"}
(19,1,1) = {"
NL
NL
NL
NL
NL
yh
NL
NL
uo
NL
NL
yh
uR
Gm
Gm
Gm
Gm
Gm
Gm
Gm
NL
NL
NL
NL
NL
"}
(20,1,1) = {"
NL
NL
NL
NL
NL
NL
NL
NL
NL
NL
NL
NL
NL
NL
NL
NL
NL
NL
NL
NL
NL
NL
NL
NL
NL
"}
