"an" = (/obj/structure/table/woodentable,/obj/random/plushie,/obj/effect/decal/cleanable/dirt,/turf/simulated/floor/outdoors/grass/sif,/area/submap/priderock)
"cR" = (/obj/random/trash,/obj/effect/decal/cleanable/dirt,/turf/simulated/floor/outdoors/grass/sif,/area/submap/priderock)
"dD" = (/obj/structure/closet/crate/bin,/turf/simulated/floor/outdoors/dirt,/area/submap/priderock)
"ik" = (/obj/structure/cliff/automatic{dir = 5},/obj/structure/railing{dir = 1},/obj/structure/railing{dir = 4},/turf/simulated/floor/outdoors/dirt,/area/submap/priderock)
"kv" = (/obj/structure/cliff/automatic/ramp,/obj/structure/railing{dir = 4},/turf/simulated/floor/outdoors/dirt,/area/submap/priderock)
"kP" = (/obj/structure/cliff/automatic{dir = 10},/obj/structure/railing,/obj/structure/railing{dir = 8},/turf/simulated/floor/outdoors/dirt,/area/submap/priderock)
"lu" = (/obj/structure/cliff/automatic{dir = 9},/obj/structure/railing{dir = 1},/obj/structure/railing{dir = 8},/turf/simulated/floor/outdoors/dirt,/area/submap/priderock)
"nN" = (/obj/structure/cliff/automatic/ramp{dir = 9},/obj/structure/railing{dir = 8},/turf/simulated/floor/outdoors/dirt,/area/submap/priderock)
"nV" = (/obj/structure/cliff/automatic{dir = 2},/turf/simulated/floor/outdoors/dirt,/area/submap/priderock)
"oz" = (/obj/structure/cliff/automatic{dir = 2},/obj/structure/railing,/turf/simulated/floor/outdoors/dirt,/area/submap/priderock)
"oO" = (/obj/random/trash,/obj/random/trash,/turf/simulated/floor/outdoors/dirt,/area/submap/priderock)
"qh" = (/obj/structure/cliff/automatic/corner{dir = 10},/turf/simulated/floor/outdoors/dirt,/area/submap/priderock)
"qq" = (/obj/structure/table/woodentable,/turf/simulated/floor/outdoors/grass/sif,/area/submap/priderock)
"qP" = (/obj/random/trash,/obj/effect/decal/cleanable/dirt,/turf/simulated/floor/outdoors/dirt,/area/submap/priderock)
"rJ" = (/obj/structure/cliff/automatic{dir = 10},/obj/structure/railing{dir = 8},/turf/simulated/floor/outdoors/dirt,/area/submap/priderock)
"sh" = (/obj/structure/cliff/automatic,/turf/simulated/floor/outdoors/dirt,/area/submap/priderock)
"sr" = (/obj/structure/loot_pile/maint/trash,/turf/template_noop,/area/submap/priderock)
"uv" = (/obj/item/weapon/storage/backpack/dufflebag/syndie/med,/turf/simulated/floor/outdoors/dirt,/area/submap/priderock)
"vh" = (/obj/random/trash,/obj/effect/decal/cleanable/dirt,/obj/structure/ledge/ledge_stairs{dir = 8},/turf/simulated/floor/outdoors/dirt,/area/submap/priderock)
"xE" = (/obj/random/tool,/obj/random/tool,/turf/simulated/floor/outdoors/dirt,/area/submap/priderock)
"yi" = (/obj/structure/table/bench/wooden,/turf/simulated/floor/outdoors/dirt,/area/submap/priderock)
"An" = (/obj/structure/ledge/ledge_stairs{dir = 8},/turf/simulated/floor/outdoors/dirt,/area/submap/priderock)
"Bf" = (/obj/structure/cliff/automatic/corner{dir = 6},/turf/simulated/floor/outdoors/dirt,/area/submap/priderock)
"Bv" = (/obj/structure/bed/chair{dir = 1},/turf/simulated/floor/outdoors/dirt,/area/submap/priderock)
"BB" = (/obj/item/clothing/head/bearpelt,/obj/item/device/binoculars/spyglass,/obj/item/weapon/oldtwohanded/spear/fluff/madoka_koto_1,/turf/simulated/floor/outdoors/rocks,/area/submap/priderock)
"Dk" = (/obj/random/maintenance/medical,/obj/random/maintenance/medical,/obj/random/maintenance/medical,/obj/item/weapon/towel/random,/turf/simulated/floor/outdoors/dirt,/area/submap/priderock)
"Dx" = (/obj/structure/cliff/automatic{dir = 8},/turf/simulated/floor/outdoors/dirt,/area/submap/priderock)
"DU" = (/obj/structure/cliff/automatic{dir = 4},/turf/simulated/floor/outdoors/dirt,/area/submap/priderock)
"EI" = (/obj/structure/flora/tree/sif,/turf/template_noop,/area/submap/priderock)
"Ff" = (/obj/structure/cliff/automatic{dir = 8},/obj/structure/railing{dir = 8},/turf/simulated/floor/outdoors/dirt,/area/submap/priderock)
"Fg" = (/obj/effect/decal/cleanable/dirt,/obj/structure/ledge/ledge_stairs{dir = 4},/turf/simulated/floor/outdoors/dirt,/area/submap/priderock)
"Fo" = (/obj/structure/cliff/automatic{dir = 4},/obj/structure/railing{dir = 4},/turf/simulated/floor/outdoors/dirt,/area/submap/priderock)
"FO" = (/obj/vehicle/train/engine/quadbike/random,/turf/simulated/floor/outdoors/dirt,/area/submap/priderock)
"Gk" = (/obj/structure/loot_pile/maint/trash,/turf/simulated/floor/outdoors/dirt,/area/submap/priderock)
"If" = (/obj/effect/decal/cleanable/dirt,/obj/structure/bonfire/sifwood,/turf/simulated/floor/outdoors/grass/sif,/area/submap/priderock)
"Ix" = (/obj/random/trash,/turf/simulated/floor/outdoors/dirt,/area/submap/priderock)
"Jk" = (/obj/structure/bed/chair,/obj/effect/decal/cleanable/dirt,/turf/simulated/floor/outdoors/dirt,/area/submap/priderock)
"Lm" = (/turf/simulated/floor/outdoors/rocks,/area/submap/priderock)
"Lo" = (/obj/effect/decal/cleanable/dirt,/obj/structure/ledge/ledge_stairs{dir = 8},/turf/simulated/floor/outdoors/dirt,/area/submap/priderock)
"LK" = (/obj/structure/ledge/ledge_stairs,/turf/simulated/floor/outdoors/rocks,/area/submap/priderock)
"Mg" = (/obj/random/trash,/turf/template_noop,/area/submap/priderock)
"Oc" = (/obj/effect/decal/cleanable/dirt,/turf/simulated/floor/outdoors/dirt,/area/submap/priderock)
"Od" = (/obj/item/stack/material/log/sif,/obj/effect/decal/cleanable/dirt,/turf/simulated/floor/outdoors/dirt,/area/submap/priderock)
"Pn" = (/obj/structure/bed/chair{dir = 1},/turf/simulated/floor/outdoors/grass/sif,/area/submap/priderock)
"PW" = (/obj/structure/cliff/automatic/corner{dir = 9},/turf/simulated/floor/outdoors/dirt,/area/submap/priderock)
"SE" = (/obj/structure/cliff/automatic/corner,/turf/simulated/floor/outdoors/dirt,/area/submap/priderock)
"Tb" = (/obj/effect/decal/cleanable/dirt,/obj/structure/ledge/ledge_stairs,/turf/simulated/floor/outdoors/dirt,/area/submap/priderock)
"Td" = (/obj/effect/decal/cleanable/dirt,/turf/simulated/floor/outdoors/rocks,/area/submap/priderock)
"UG" = (/obj/structure/closet/crate,/obj/random/maintenance/clean,/obj/random/maintenance/clean,/obj/random/maintenance/clean,/obj/random/maintenance/cargo,/obj/random/maintenance/medical,/obj/random/maintenance/medical,/turf/simulated/floor/outdoors/dirt,/area/submap/priderock)
"VF" = (/obj/structure/cliff/automatic{dir = 6},/obj/structure/railing{dir = 4},/obj/structure/railing,/turf/simulated/floor/outdoors/dirt,/area/submap/priderock)
"Wk" = (/turf/simulated/floor/outdoors/dirt,/area/submap/priderock)
"Xd" = (/turf/simulated/floor/outdoors/grass/sif,/area/submap/priderock)
"YP" = (/obj/effect/decal/cleanable/dirt,/obj/effect/decal/cleanable/dirt,/turf/simulated/floor/outdoors/dirt,/area/submap/priderock)
"Zc" = (/obj/structure/cliff/automatic,/obj/structure/railing{dir = 1},/turf/simulated/floor/outdoors/dirt,/area/submap/priderock)
"Zm" = (/turf/template_noop,/area/submap/priderock)
"ZJ" = (/obj/effect/decal/cleanable/dirt,/turf/simulated/floor/outdoors/grass/sif,/area/submap/priderock)
"ZO" = (/obj/effect/decal/cleanable/dirt,/obj/structure/table/bench/wooden,/turf/simulated/floor/outdoors/dirt,/area/submap/priderock)

(1,1,1) = {"
ZmZmZmWkXdWkWkZmZmOcZmWkZmZmZm
ZmZmOckvOcZJnNoOZmZmZmZmGkZmZm
WkEIWkFoTbTbrJozoznVoznVozozqh
WkZmZmFoZJYPZJOcOcZJOcXdyixEFf
ZmWkFOSEZcshshZcikOccROcIfWkDx
ZmBfozoznVnVoznVVFOdZJZJZOXdFf
ZmFouvXdAnLmXdAnXdZJZJcRZJdDFf
IxFoXdTdvhZJTdLoqPZJOcJkJkXdFf
ZmFoLmluZcshZcZcikWkXdqqanDkDx
ZmDUTdkPoznVozqhFoUGWkBvPnWkFf
WkFoOcTdFgLmWkFfSEZcshZcZcZcPW
ZmSEZcZcZcikLmDxZmZmWkZmWkZmWk
ZmWkWkWkZmDULKFfIxIxsrZmsrZmZm
ZmMgMgsrWkFoBBFfZmWkZmWkEIZmZm
ZmZmZmZmZmSEshPWWkZmZmZmZmZmZm
"}
