//MAP CONVERTED BY dmm2tgm.py THIS HEADER COMMENT PREVENTS RECONVERSION, DO NOT REMOVE
"a" = (
/turf/simulated/floor/outdoors/crystal_planet/redsand,
/area/submap/crystalcore/red/eight)
"b" = (
/obj/structure/table/woodentable,
/obj/machinery/chemical_dispenser/bar_soft/full,
/turf/simulated/floor/wood,
/area/submap/crystalcore/red/eight)
"c" = (
/obj/structure/closet/crate/chest,
/obj/random/firstaid,
/obj/random/maintenance/morestuff,
/obj/random/maintenance/misc,
/turf/simulated/floor/wood,
/area/submap/crystalcore/red/eight)
"i" = (
/turf/template_noop,
/area/template_noop)
"k" = (
/obj/structure/table/woodentable,
/obj/random/medical/pillbottle,
/turf/simulated/floor/wood,
/area/submap/crystalcore/red/eight)
"l" = (
/mob/living/simple_mob/humanoid/obsidianscale/melee,
/turf/simulated/floor/wood,
/area/submap/crystalcore/red/eight)
"n" = (
/turf/simulated/floor/wood,
/area/submap/crystalcore/red/eight)
"o" = (
/turf/template_noop,
/area/submap/crystalcore/red/eight)
"w" = (
/turf/simulated/wall/log,
/area/submap/crystalcore/red/eight)
"y" = (
/obj/structure/table/woodentable,
/turf/simulated/floor/wood,
/area/submap/crystalcore/red/eight)
"z" = (
/obj/item/weapon/stool,
/turf/simulated/floor/wood,
/area/submap/crystalcore/red/eight)
"C" = (
/obj/structure/closet/crate/chest,
/obj/random/maintenance/morestuff,
/obj/random/maintenance/misc,
/obj/item/weapon/gun/energy/xray,
/turf/simulated/floor/wood,
/area/submap/crystalcore/red/eight)
"E" = (
/obj/item/weapon/stool,
/mob/living/simple_mob/humanoid/obsidianscale/melee/green,
/turf/simulated/floor/wood,
/area/submap/crystalcore/red/eight)
"M" = (
/obj/item/weapon/stool,
/mob/living/simple_mob/humanoid/obsidianscale/melee/diamond,
/turf/simulated/floor/wood,
/area/submap/crystalcore/red/eight)
"N" = (
/obj/structure/table/woodentable,
/obj/random/maintenance/foodstuff,
/turf/simulated/floor/wood,
/area/submap/crystalcore/red/eight)
"O" = (
/obj/structure/closet/crate/chest,
/obj/random/medical/pillbottle,
/obj/random/maintenance/morestuff,
/obj/random/maintenance/misc,
/turf/simulated/floor/wood,
/area/submap/crystalcore/red/eight)
"Q" = (
/obj/item/weapon/stool,
/mob/living/simple_mob/humanoid/obsidianscale/melee/silver,
/turf/simulated/floor/wood,
/area/submap/crystalcore/red/eight)
"R" = (
/obj/structure/simple_door/wood,
/turf/simulated/floor/wood,
/area/submap/crystalcore/red/eight)
"T" = (
/obj/structure/table/woodentable,
/obj/machinery/chemical_dispenser/bar_coffee/full,
/turf/simulated/floor/wood,
/area/submap/crystalcore/red/eight)

(1,1,1) = {"
i
i
i
i
i
i
i
i
i
i
i
i
i
i
i
i
i
i
i
i
i
i
i
i
i
"}
(2,1,1) = {"
i
o
o
o
o
o
o
o
o
o
o
a
a
a
o
o
o
o
o
o
o
o
o
o
i
"}
(3,1,1) = {"
i
o
o
o
o
o
o
o
o
o
a
a
a
a
a
o
o
o
o
o
o
o
o
o
i
"}
(4,1,1) = {"
i
o
o
o
o
o
o
o
o
a
a
a
a
a
a
a
o
o
o
o
o
o
o
o
i
"}
(5,1,1) = {"
i
o
o
o
o
o
o
o
a
a
a
a
a
a
a
a
a
o
o
o
o
o
o
o
i
"}
(6,1,1) = {"
i
o
o
o
o
o
o
a
a
a
a
a
a
a
a
a
a
a
o
o
o
o
o
o
i
"}
(7,1,1) = {"
i
o
o
o
o
o
a
a
a
a
a
a
a
a
a
a
a
a
a
o
o
o
o
o
i
"}
(8,1,1) = {"
i
o
o
o
o
a
a
w
w
w
w
w
w
w
w
w
w
w
a
a
o
o
o
o
i
"}
(9,1,1) = {"
i
o
o
o
a
a
a
w
O
n
n
n
n
z
Q
n
n
w
a
a
a
o
o
o
i
"}
(10,1,1) = {"
i
o
o
a
a
a
a
w
C
n
N
n
n
N
N
n
n
w
a
a
a
a
o
o
i
"}
(11,1,1) = {"
i
o
a
a
a
a
a
w
y
n
N
M
n
N
N
n
n
w
a
a
a
a
a
o
i
"}
(12,1,1) = {"
i
a
a
a
a
a
a
w
T
n
N
n
n
E
z
n
n
w
a
a
a
a
a
a
i
"}
(13,1,1) = {"
i
a
a
a
a
a
a
w
k
l
N
z
n
n
n
n
n
R
a
a
a
a
a
a
i
"}
(14,1,1) = {"
i
a
a
a
a
a
a
w
b
n
N
n
n
z
E
n
n
w
a
a
a
a
a
a
i
"}
(15,1,1) = {"
i
o
a
a
a
a
a
w
y
n
N
M
n
N
N
n
n
w
a
a
a
a
a
o
i
"}
(16,1,1) = {"
i
o
o
a
a
a
a
w
C
n
N
n
n
N
N
n
n
w
a
a
a
a
o
o
i
"}
(17,1,1) = {"
i
o
o
o
a
a
a
w
c
n
n
n
n
Q
z
n
n
w
a
a
a
o
o
o
i
"}
(18,1,1) = {"
i
o
o
o
o
a
a
w
w
w
w
w
w
w
w
w
w
w
a
a
o
o
o
o
i
"}
(19,1,1) = {"
i
o
o
o
o
o
a
a
a
a
a
a
a
a
a
a
a
a
a
o
o
o
o
o
i
"}
(20,1,1) = {"
i
o
o
o
o
o
o
a
a
a
a
a
a
a
a
a
a
a
o
o
o
o
o
o
i
"}
(21,1,1) = {"
i
o
o
o
o
o
o
o
a
a
a
a
a
a
a
a
a
o
o
o
o
o
o
o
i
"}
(22,1,1) = {"
i
o
o
o
o
o
o
o
o
a
a
a
a
a
a
a
o
o
o
o
o
o
o
o
i
"}
(23,1,1) = {"
i
o
o
o
o
o
o
o
o
o
a
a
a
a
a
o
o
o
o
o
o
o
o
o
i
"}
(24,1,1) = {"
i
o
o
o
o
o
o
o
o
o
o
a
a
a
o
o
o
o
o
o
o
o
o
o
i
"}
(25,1,1) = {"
i
i
i
i
i
i
i
i
i
i
i
i
i
i
i
i
i
i
i
i
i
i
i
i
i
"}
