//MAP CONVERTED BY dmm2tgm.py THIS HEADER COMMENT PREVENTS RECONVERSION, DO NOT REMOVE
"a" = (
/turf/template_noop,
/area/submap/crystalcore/red/eightteen)
"s" = (
/turf/simulated/floor/outdoors/crystal_planet/redsand,
/area/submap/crystalcore/red/eightteen)
"y" = (
/turf/template_noop,
/area/template_noop)
"P" = (
/mob/living/simple_mob/humanoid/cultist/magus/rift,
/turf/simulated/floor/outdoors/crystal_planet/redsand,
/area/submap/crystalcore/red/eightteen)

(1,1,1) = {"
y
y
y
y
y
y
y
y
y
y
y
y
y
y
y
y
y
y
y
y
y
y
y
y
y
"}
(2,1,1) = {"
y
a
a
a
a
a
a
a
a
a
a
a
s
a
a
a
a
a
a
a
a
a
a
a
y
"}
(3,1,1) = {"
y
a
a
a
a
a
a
a
a
a
a
s
s
s
a
a
a
a
a
a
a
a
a
a
y
"}
(4,1,1) = {"
y
a
a
a
a
a
a
a
a
a
s
s
s
s
s
a
a
a
a
a
a
a
a
a
y
"}
(5,1,1) = {"
y
a
a
a
a
a
a
a
a
s
s
s
s
s
s
s
a
a
a
a
a
a
a
a
y
"}
(6,1,1) = {"
y
a
a
a
a
a
a
a
s
s
s
s
s
s
s
s
s
a
a
a
a
a
a
a
y
"}
(7,1,1) = {"
y
a
a
a
a
a
a
s
s
s
s
s
s
s
s
s
s
s
a
a
a
a
a
a
y
"}
(8,1,1) = {"
y
a
a
a
a
a
s
s
s
s
s
s
s
s
s
s
s
s
s
a
a
a
a
a
y
"}
(9,1,1) = {"
y
a
a
a
a
s
s
s
s
s
s
s
s
s
s
s
s
s
s
s
a
a
a
a
y
"}
(10,1,1) = {"
y
a
a
a
s
s
s
s
s
s
s
s
s
s
s
s
s
s
s
s
s
a
a
a
y
"}
(11,1,1) = {"
y
a
a
s
s
s
s
s
s
s
s
s
s
s
s
s
s
s
s
s
s
s
a
a
y
"}
(12,1,1) = {"
y
a
s
s
s
s
s
s
s
s
s
s
s
s
s
s
s
s
s
s
s
s
s
a
y
"}
(13,1,1) = {"
y
s
s
s
s
s
s
s
s
s
s
s
P
s
s
s
s
s
s
s
s
s
s
s
y
"}
(14,1,1) = {"
y
a
s
s
s
s
s
s
s
s
s
s
s
s
s
s
s
s
s
s
s
s
s
a
y
"}
(15,1,1) = {"
y
a
a
s
s
s
s
s
s
s
s
s
s
s
s
s
s
s
s
s
s
s
a
a
y
"}
(16,1,1) = {"
y
a
a
a
s
s
s
s
s
s
s
s
s
s
s
s
s
s
s
s
s
a
a
a
y
"}
(17,1,1) = {"
y
a
a
a
a
s
s
s
s
s
s
s
s
s
s
s
s
s
s
s
a
a
a
a
y
"}
(18,1,1) = {"
y
a
a
a
a
a
s
s
s
s
s
s
s
s
s
s
s
s
s
a
a
a
a
a
y
"}
(19,1,1) = {"
y
a
a
a
a
a
a
s
s
s
s
s
s
s
s
s
s
s
a
a
a
a
a
a
y
"}
(20,1,1) = {"
y
a
a
a
a
a
a
a
s
s
s
s
s
s
s
s
s
a
a
a
a
a
a
a
y
"}
(21,1,1) = {"
y
a
a
a
a
a
a
a
a
s
s
s
s
s
s
s
a
a
a
a
a
a
a
a
y
"}
(22,1,1) = {"
y
a
a
a
a
a
a
a
a
a
s
s
s
s
s
a
a
a
a
a
a
a
a
a
y
"}
(23,1,1) = {"
y
a
a
a
a
a
a
a
a
a
a
s
s
s
a
a
a
a
a
a
a
a
a
a
y
"}
(24,1,1) = {"
y
a
a
a
a
a
a
a
a
a
a
a
s
a
a
a
a
a
a
a
a
a
a
a
y
"}
(25,1,1) = {"
y
y
y
y
y
y
y
y
y
y
y
y
y
y
y
y
y
y
y
y
y
y
y
y
y
"}
