//MAP CONVERTED BY dmm2tgm.py THIS HEADER COMMENT PREVENTS RECONVERSION, DO NOT REMOVE
"a" = (
/turf/template_noop,
/area/template_noop)
"c" = (
/mob/living/simple_mob/mechanical/cyber_horror/plasma_cyber_horror,
/turf/simulated/floor/bmarble,
/area/submap/crystalcore/red/eleven)
"d" = (
/obj/structure/table/bench/sifwooden/padded,
/turf/simulated/floor/bmarble,
/area/submap/crystalcore/red/eleven)
"f" = (
/obj/structure/table/bench/sifwooden/padded,
/turf/simulated/floor/wmarble,
/area/submap/crystalcore/red/eleven)
"k" = (
/obj/structure/closet/coffin,
/turf/simulated/floor/wmarble,
/area/submap/crystalcore/red/eleven)
"o" = (
/turf/simulated/floor/lava/warm,
/area/submap/crystalcore/red/eleven)
"r" = (
/mob/living/simple_mob/mechanical/cyber_horror/grey,
/turf/simulated/floor/bmarble,
/area/submap/crystalcore/red/eleven)
"s" = (
/obj/structure/closet/coffin,
/turf/simulated/floor/bmarble,
/area/submap/crystalcore/red/eleven)
"t" = (
/obj/structure/table/hardwoodtable,
/obj/random/material,
/obj/item/weapon/stock_parts/manipulator/omni,
/turf/simulated/floor/wmarble,
/area/submap/crystalcore/red/eleven)
"u" = (
/turf/simulated/floor/bmarble,
/area/submap/crystalcore/red/eleven)
"v" = (
/obj/effect/decal/cleanable/blood,
/turf/simulated/floor/bmarble,
/area/submap/crystalcore/red/eleven)
"w" = (
/turf/simulated/floor/outdoors/crystal_planet/redsand,
/area/submap/crystalcore/red/eleven)
"y" = (
/obj/item/weapon/storage/firstaid/surgery,
/obj/structure/table/hardwoodtable,
/turf/simulated/floor/wmarble,
/area/submap/crystalcore/red/eleven)
"z" = (
/obj/machinery/optable,
/turf/simulated/floor/bmarble,
/area/submap/crystalcore/red/eleven)
"B" = (
/obj/item/weapon/storage/firstaid/surgery,
/obj/structure/table/hardwoodtable,
/turf/simulated/floor/bmarble,
/area/submap/crystalcore/red/eleven)
"C" = (
/obj/effect/decal/cleanable/blood,
/turf/simulated/floor/wmarble,
/area/submap/crystalcore/red/eleven)
"E" = (
/obj/effect/decal/cleanable/blood,
/mob/living/simple_mob/mechanical/cyber_horror/plasma_cyber_horror,
/turf/simulated/floor/bmarble,
/area/submap/crystalcore/red/eleven)
"F" = (
/mob/living/simple_mob/mechanical/cyber_horror/corgi,
/turf/simulated/floor/bmarble,
/area/submap/crystalcore/red/eleven)
"H" = (
/mob/living/simple_mob/mechanical/cyber_horror/plasma_cyber_horror,
/turf/simulated/floor/wmarble,
/area/submap/crystalcore/red/eleven)
"L" = (
/obj/machinery/optable,
/turf/simulated/floor/wmarble,
/area/submap/crystalcore/red/eleven)
"M" = (
/turf/template_noop,
/area/submap/crystalcore/red/eleven)
"N" = (
/obj/structure/table/hardwoodtable,
/obj/random/material,
/turf/simulated/floor/bmarble,
/area/submap/crystalcore/red/eleven)
"Q" = (
/obj/structure/table/hardwoodtable,
/obj/item/weapon/telecube,
/turf/simulated/floor/bmarble,
/area/submap/crystalcore/red/eleven)
"S" = (
/turf/simulated/floor/wmarble,
/area/submap/crystalcore/red/eleven)
"T" = (
/mob/living/simple_mob/mechanical/cyber_horror/cat_cyber_horror,
/turf/simulated/floor/bmarble,
/area/submap/crystalcore/red/eleven)
"U" = (
/obj/structure/table/hardwoodtable,
/obj/random/material,
/turf/simulated/floor/wmarble,
/area/submap/crystalcore/red/eleven)
"V" = (
/obj/structure/table/bench/sifwooden/padded,
/obj/effect/decal/cleanable/blood,
/turf/simulated/floor/bmarble,
/area/submap/crystalcore/red/eleven)
"X" = (
/obj/structure/table/hardwoodtable,
/turf/simulated/floor/wmarble,
/area/submap/crystalcore/red/eleven)
"Y" = (
/turf/simulated/wall/iron,
/area/submap/crystalcore/red/eleven)
"Z" = (
/obj/machinery/door/airlock/silver,
/turf/simulated/floor/bmarble,
/area/submap/crystalcore/red/eleven)

(1,1,1) = {"
a
a
a
a
a
a
a
a
a
a
a
a
a
a
a
a
a
a
a
a
a
a
a
a
a
"}
(2,1,1) = {"
a
M
M
M
M
M
M
M
M
M
M
M
M
M
M
M
M
M
M
M
M
M
M
M
a
"}
(3,1,1) = {"
a
M
M
M
M
M
M
M
M
M
M
M
M
M
M
M
M
M
M
M
M
M
M
M
a
"}
(4,1,1) = {"
a
M
M
M
Y
Y
Y
Y
Y
Y
Y
Y
Y
Y
Y
Y
w
M
M
M
M
M
M
M
a
"}
(5,1,1) = {"
a
M
M
M
Y
U
u
S
s
k
s
k
s
k
s
Y
w
w
M
M
M
M
M
M
a
"}
(6,1,1) = {"
a
M
M
M
Y
N
S
u
S
c
S
v
H
u
H
Y
w
w
M
M
M
M
M
M
a
"}
(7,1,1) = {"
a
M
M
M
Y
y
u
S
v
S
u
S
u
S
u
Y
w
w
w
M
M
M
M
M
a
"}
(8,1,1) = {"
a
M
M
M
Y
z
S
u
S
u
S
u
C
Y
Y
Y
w
w
w
M
M
M
M
M
a
"}
(9,1,1) = {"
a
M
M
M
Y
Y
Y
Y
Y
Y
Z
Y
Y
Y
o
o
o
w
w
w
M
M
M
M
a
"}
(10,1,1) = {"
a
M
M
M
Y
u
S
F
S
u
S
u
f
Y
o
o
o
w
w
w
M
M
M
M
a
"}
(11,1,1) = {"
a
M
M
M
Y
S
u
S
d
S
d
S
V
Y
Y
Y
Y
w
w
w
w
M
M
M
a
"}
(12,1,1) = {"
a
M
M
M
Y
u
X
u
f
v
f
u
S
u
S
u
Y
w
w
w
w
M
M
M
a
"}
(13,1,1) = {"
a
M
M
M
Y
S
Q
S
u
S
r
S
u
S
u
S
Z
w
w
w
w
M
M
M
a
"}
(14,1,1) = {"
a
M
M
M
Y
u
X
u
f
u
f
u
C
u
S
u
Y
w
w
w
w
M
M
M
a
"}
(15,1,1) = {"
a
M
M
M
Y
S
u
C
d
S
d
S
d
Y
Y
Y
Y
w
w
w
w
M
M
M
a
"}
(16,1,1) = {"
a
M
M
M
Y
u
S
T
S
u
S
u
f
Y
o
o
o
w
w
w
M
M
M
M
a
"}
(17,1,1) = {"
a
M
M
M
Y
Y
Y
Y
Y
Y
Z
Y
Y
Y
o
o
o
w
w
w
M
M
M
M
a
"}
(18,1,1) = {"
a
M
M
M
Y
L
u
S
v
S
u
S
u
Y
Y
Y
w
w
w
M
M
M
M
M
a
"}
(19,1,1) = {"
a
M
M
M
Y
B
S
u
S
u
C
u
S
u
S
Y
w
w
w
M
M
M
M
M
a
"}
(20,1,1) = {"
a
M
M
M
Y
t
u
C
c
S
c
S
E
S
c
Y
w
w
M
M
M
M
M
M
a
"}
(21,1,1) = {"
a
M
M
M
Y
N
S
u
k
s
k
s
k
s
k
Y
w
w
M
M
M
M
M
M
a
"}
(22,1,1) = {"
a
M
M
M
Y
Y
Y
Y
Y
Y
Y
Y
Y
Y
Y
Y
w
M
M
M
M
M
M
M
a
"}
(23,1,1) = {"
a
M
M
M
M
M
M
M
M
M
M
M
M
M
M
M
M
M
M
M
M
M
M
M
a
"}
(24,1,1) = {"
a
M
M
M
M
M
M
M
M
M
M
M
M
M
M
M
M
M
M
M
M
M
M
M
a
"}
(25,1,1) = {"
a
a
a
a
a
a
a
a
a
a
a
a
a
a
a
a
a
a
a
a
a
a
a
a
a
"}
