//MAP CONVERTED BY dmm2tgm.py THIS HEADER COMMENT PREVENTS RECONVERSION, DO NOT REMOVE
"a" = (
/turf/template_noop,
/area/submap/crystalcore/red/fifteen)
"e" = (
/obj/structure/railing{
	dir = 8
	},
/obj/structure/prop/dominator/red,
/turf/simulated/floor/tiled/old_tile/gray,
/area/submap/crystalcore/red/fifteen)
"g" = (
/obj/structure/railing{
	dir = 4
	},
/obj/structure/prop/dominator/orange,
/turf/simulated/floor/tiled/old_tile/gray,
/area/submap/crystalcore/red/fifteen)
"h" = (
/mob/living/simple_mob/mechanical/cyber_horror/tajaran,
/turf/simulated/floor/tiled/old_tile/gray,
/area/submap/crystalcore/red/fifteen)
"i" = (
/turf/simulated/floor/tiled/old_tile/gray,
/area/submap/crystalcore/red/fifteen)
"k" = (
/obj/structure/closet,
/obj/item/weapon/gun/energy/gun/burst,
/obj/random/material/precious,
/turf/simulated/floor/tiled/old_tile/gray,
/area/submap/crystalcore/red/fifteen)
"l" = (
/turf/simulated/floor/lava,
/area/submap/crystalcore/red/fifteen)
"p" = (
/mob/living/simple_mob/mechanical/cyber_horror/corgi,
/turf/simulated/floor/tiled/old_tile/gray,
/area/submap/crystalcore/red/fifteen)
"t" = (
/turf/simulated/wall/ironphoron,
/area/submap/crystalcore/red/fifteen)
"v" = (
/turf/simulated/wall/iron,
/area/submap/crystalcore/red/fifteen)
"w" = (
/obj/machinery/door/airlock/silver,
/turf/simulated/floor/tiled/old_tile/gray,
/area/submap/crystalcore/red/fifteen)
"A" = (
/obj/structure/railing{
	dir = 8
	},
/turf/simulated/floor/tiled/old_tile/gray,
/area/submap/crystalcore/red/fifteen)
"C" = (
/mob/living/simple_mob/mechanical/cyber_horror/grey,
/turf/simulated/floor/tiled/old_tile/gray,
/area/submap/crystalcore/red/fifteen)
"I" = (
/obj/structure/railing{
	dir = 4
	},
/turf/simulated/floor/tiled/old_tile/gray,
/area/submap/crystalcore/red/fifteen)
"N" = (
/obj/structure/railing{
	dir = 4
	},
/obj/structure/prop/dominator/red,
/turf/simulated/floor/tiled/old_tile/gray,
/area/submap/crystalcore/red/fifteen)
"Q" = (
/obj/structure/closet,
/obj/random/tool/power,
/obj/random/tool/power,
/turf/simulated/floor/tiled/old_tile/gray,
/area/submap/crystalcore/red/fifteen)
"R" = (
/turf/template_noop,
/area/template_noop)
"U" = (
/obj/structure/railing{
	dir = 8
	},
/obj/structure/prop/dominator/orange,
/turf/simulated/floor/tiled/old_tile/gray,
/area/submap/crystalcore/red/fifteen)
"W" = (
/mob/living/simple_mob/mechanical/cyber_horror/ling_cyber_horror,
/turf/simulated/floor/tiled/old_tile/gray,
/area/submap/crystalcore/red/fifteen)

(1,1,1) = {"
R
R
R
R
R
R
R
R
R
R
R
R
R
R
R
R
R
R
R
R
R
R
R
R
R
"}
(2,1,1) = {"
R
a
a
a
a
a
a
a
a
a
a
a
a
a
a
a
a
a
a
a
a
a
a
a
R
"}
(3,1,1) = {"
R
a
a
a
a
a
a
a
a
a
a
a
a
a
a
a
a
a
a
a
a
a
a
a
R
"}
(4,1,1) = {"
R
a
a
a
a
a
a
a
a
a
a
a
a
a
a
a
a
a
a
a
a
a
a
a
R
"}
(5,1,1) = {"
R
a
a
a
a
a
a
a
a
a
a
a
a
a
a
a
a
a
a
a
a
a
a
a
R
"}
(6,1,1) = {"
R
a
a
a
a
a
a
a
a
a
a
a
a
a
a
a
a
a
a
a
a
a
a
a
R
"}
(7,1,1) = {"
R
a
a
a
a
a
a
a
a
a
a
a
a
a
a
a
a
a
a
a
a
a
a
a
R
"}
(8,1,1) = {"
R
a
a
a
a
a
a
a
v
v
v
v
v
v
v
a
a
a
a
a
a
a
a
a
R
"}
(9,1,1) = {"
R
a
a
a
a
v
v
v
v
l
l
l
l
l
v
v
v
v
a
a
a
a
a
a
R
"}
(10,1,1) = {"
R
a
a
a
v
v
l
l
l
l
l
l
l
l
l
l
l
v
v
a
a
a
a
a
R
"}
(11,1,1) = {"
R
a
a
a
v
Q
A
A
U
A
A
e
A
A
U
A
A
k
v
a
a
a
a
a
R
"}
(12,1,1) = {"
R
a
a
v
v
i
i
i
i
i
C
i
p
i
i
i
i
i
v
v
a
a
a
a
R
"}
(13,1,1) = {"
R
a
a
w
i
i
W
i
t
h
i
t
i
h
t
i
W
i
i
w
a
a
a
a
R
"}
(14,1,1) = {"
R
a
a
v
v
i
i
i
i
i
p
i
C
i
i
i
i
i
v
v
a
a
a
a
R
"}
(15,1,1) = {"
R
a
a
a
v
k
I
I
g
I
I
N
I
I
g
I
I
Q
v
a
a
a
a
a
R
"}
(16,1,1) = {"
R
a
a
a
v
v
l
l
l
l
l
l
l
l
l
l
l
v
v
a
a
a
a
a
R
"}
(17,1,1) = {"
R
a
a
a
a
v
v
v
v
l
l
l
l
l
v
v
v
v
a
a
a
a
a
a
R
"}
(18,1,1) = {"
R
a
a
a
a
a
a
a
v
v
v
v
v
v
v
a
a
a
a
a
a
a
a
a
R
"}
(19,1,1) = {"
R
a
a
a
a
a
a
a
a
a
a
a
a
a
a
a
a
a
a
a
a
a
a
a
R
"}
(20,1,1) = {"
R
a
a
a
a
a
a
a
a
a
a
a
a
a
a
a
a
a
a
a
a
a
a
a
R
"}
(21,1,1) = {"
R
a
a
a
a
a
a
a
a
a
a
a
a
a
a
a
a
a
a
a
a
a
a
a
R
"}
(22,1,1) = {"
R
a
a
a
a
a
a
a
a
a
a
a
a
a
a
a
a
a
a
a
a
a
a
a
R
"}
(23,1,1) = {"
R
a
a
a
a
a
a
a
a
a
a
a
a
a
a
a
a
a
a
a
a
a
a
a
R
"}
(24,1,1) = {"
R
a
a
a
a
a
a
a
a
a
a
a
a
a
a
a
a
a
a
a
a
a
a
a
R
"}
(25,1,1) = {"
R
R
R
R
R
R
R
R
R
R
R
R
R
R
R
R
R
R
R
R
R
R
R
R
R
"}
