//MAP CONVERTED BY dmm2tgm.py THIS HEADER COMMENT PREVENTS RECONVERSION, DO NOT REMOVE
"a" = (
/mob/living/simple_mob/mechanical/cyber_horror/corgi,
/turf/simulated/floor/tiled/old_tile/beige,
/area/submap/crystalcore/red/fourteen)
"d" = (
/turf/template_noop,
/area/submap/crystalcore/red/fourteen)
"e" = (
/obj/structure/window/reinforced,
/obj/structure/window/reinforced{
	dir = 1
	},
/obj/structure/window/reinforced{
	dir = 4
	},
/obj/structure/table/rack,
/obj/item/organ/internal/kidneys/replicant,
/turf/simulated/floor/tiled/old_tile/beige,
/area/submap/crystalcore/red/fourteen)
"f" = (
/turf/simulated/wall/iron,
/area/submap/crystalcore/red/fourteen)
"k" = (
/turf/simulated/wall/titanium,
/area/submap/crystalcore/red/fourteen)
"m" = (
/turf/simulated/floor/tiled/old_tile/beige,
/area/submap/crystalcore/red/fourteen)
"p" = (
/obj/structure/droppod_door{
	dir = 4
	},
/turf/simulated/wall/titanium,
/area/submap/crystalcore/red/fourteen)
"s" = (
/obj/structure/window/reinforced,
/obj/structure/window/reinforced{
	dir = 1
	},
/obj/structure/window/reinforced{
	dir = 8
	},
/obj/structure/table/rack,
/obj/item/organ/internal/metamorphgland,
/turf/simulated/floor/tiled/old_tile/beige,
/area/submap/crystalcore/red/fourteen)
"w" = (
/obj/structure/window/reinforced{
	dir = 4
	},
/obj/structure/window/reinforced{
	dir = 8
	},
/obj/structure/window/reinforced,
/obj/structure/table/rack,
/obj/item/weapon/gun/energy/gun/burst,
/turf/simulated/floor/tiled/old_tile/beige,
/area/submap/crystalcore/red/fourteen)
"B" = (
/obj/structure/window/reinforced{
	dir = 4
	},
/obj/structure/window/reinforced{
	dir = 8
	},
/obj/structure/window/reinforced{
	dir = 1
	},
/obj/structure/table/rack,
/obj/item/weapon/gun/energy/gun/burst,
/turf/simulated/floor/tiled/old_tile/beige,
/area/submap/crystalcore/red/fourteen)
"H" = (
/obj/structure/droppod_door{
	dir = 8
	},
/turf/simulated/wall/titanium,
/area/submap/crystalcore/red/fourteen)
"I" = (
/obj/structure/droppod_door{
	dir = 1
	},
/turf/simulated/wall/titanium,
/area/submap/crystalcore/red/fourteen)
"L" = (
/mob/living/simple_mob/mechanical/cyber_horror/cat_cyber_horror,
/turf/simulated/floor/tiled/old_tile/beige,
/area/submap/crystalcore/red/fourteen)
"O" = (
/obj/structure/droppod_door,
/turf/simulated/wall/titanium,
/area/submap/crystalcore/red/fourteen)
"R" = (
/turf/template_noop,
/area/template_noop)

(1,1,1) = {"
R
R
R
R
R
R
R
R
R
R
R
R
R
R
R
R
R
R
R
R
R
R
R
R
R
"}
(2,1,1) = {"
R
d
d
d
d
d
d
d
d
d
d
d
d
d
d
d
d
d
d
d
d
d
d
d
R
"}
(3,1,1) = {"
R
d
d
d
d
d
d
d
d
d
d
d
d
d
d
d
d
d
d
d
d
d
d
d
R
"}
(4,1,1) = {"
R
d
d
d
d
d
d
d
d
d
d
d
d
d
d
d
d
d
d
d
d
d
d
d
R
"}
(5,1,1) = {"
R
d
d
d
d
d
d
d
d
d
d
d
d
d
d
d
d
d
d
d
d
d
d
d
R
"}
(6,1,1) = {"
R
d
d
d
d
d
d
d
d
d
d
d
d
d
d
d
d
d
d
d
d
d
d
d
R
"}
(7,1,1) = {"
R
d
d
d
d
d
d
d
d
d
d
d
d
d
d
d
d
d
d
d
d
d
d
d
R
"}
(8,1,1) = {"
R
d
d
d
d
d
d
d
d
d
d
d
d
d
d
d
d
d
d
d
d
d
d
d
R
"}
(9,1,1) = {"
R
d
d
d
d
d
d
d
d
d
d
d
d
d
d
d
d
d
d
d
d
d
d
d
R
"}
(10,1,1) = {"
R
d
d
d
d
d
d
d
d
d
k
k
H
k
k
d
d
d
d
d
d
d
d
d
R
"}
(11,1,1) = {"
R
d
d
d
d
d
d
d
d
k
k
L
a
L
k
k
d
d
d
d
d
d
d
d
R
"}
(12,1,1) = {"
R
d
d
d
d
d
d
d
d
k
L
m
e
m
L
k
d
d
d
d
d
d
d
d
R
"}
(13,1,1) = {"
R
d
d
d
d
d
d
d
d
I
a
w
f
B
a
O
d
d
d
d
d
d
d
d
R
"}
(14,1,1) = {"
R
d
d
d
d
d
d
d
d
k
L
m
s
m
L
k
d
d
d
d
d
d
d
d
R
"}
(15,1,1) = {"
R
d
d
d
d
d
d
d
d
k
k
L
a
L
k
k
d
d
d
d
d
d
d
d
R
"}
(16,1,1) = {"
R
d
d
d
d
d
d
d
d
d
k
k
p
k
k
d
d
d
d
d
d
d
d
d
R
"}
(17,1,1) = {"
R
d
d
d
d
d
d
d
d
d
d
d
d
d
d
d
d
d
d
d
d
d
d
d
R
"}
(18,1,1) = {"
R
d
d
d
d
d
d
d
d
d
d
d
d
d
d
d
d
d
d
d
d
d
d
d
R
"}
(19,1,1) = {"
R
d
d
d
d
d
d
d
d
d
d
d
d
d
d
d
d
d
d
d
d
d
d
d
R
"}
(20,1,1) = {"
R
d
d
d
d
d
d
d
d
d
d
d
d
d
d
d
d
d
d
d
d
d
d
d
R
"}
(21,1,1) = {"
R
d
d
d
d
d
d
d
d
d
d
d
d
d
d
d
d
d
d
d
d
d
d
d
R
"}
(22,1,1) = {"
R
d
d
d
d
d
d
d
d
d
d
d
d
d
d
d
d
d
d
d
d
d
d
d
R
"}
(23,1,1) = {"
R
d
d
d
d
d
d
d
d
d
d
d
d
d
d
d
d
d
d
d
d
d
d
d
R
"}
(24,1,1) = {"
R
d
d
d
d
d
d
d
d
d
d
d
d
d
d
d
d
d
d
d
d
d
d
d
R
"}
(25,1,1) = {"
R
R
R
R
R
R
R
R
R
R
R
R
R
R
R
R
R
R
R
R
R
R
R
R
R
"}
