//MAP CONVERTED BY dmm2tgm.py THIS HEADER COMMENT PREVENTS RECONVERSION, DO NOT REMOVE
"a" = (
/obj/structure/table/borosilicate,
/obj/item/weapon/ore/verdantium,
/turf/simulated/shuttle/floor/alienplating,
/area/submap/crystalcore/red/four)
"g" = (
/obj/machinery/door/airlock/alien/public,
/turf/simulated/shuttle/floor/alienplating,
/area/submap/crystalcore/red/four)
"h" = (
/mob/living/simple_mob/mechanical/hivebot/tank/armored/anti_bullet,
/turf/simulated/shuttle/floor/alienplating,
/area/submap/crystalcore/red/four)
"t" = (
/obj/structure/table/borosilicate,
/obj/item/weapon/ore/hydrogen,
/turf/simulated/shuttle/floor/alienplating,
/area/submap/crystalcore/red/four)
"y" = (
/obj/structure/loot_pile/surface/alien/security,
/turf/simulated/shuttle/floor/alienplating,
/area/submap/crystalcore/red/four)
"z" = (
/mob/living/simple_mob/mechanical/hivebot/tank/armored/anti_laser,
/turf/simulated/shuttle/floor/alienplating,
/area/submap/crystalcore/red/four)
"A" = (
/turf/simulated/shuttle/floor/alienplating,
/area/submap/crystalcore/red/four)
"B" = (
/mob/living/simple_mob/mechanical/hivebot/swarm,
/turf/simulated/shuttle/floor/alienplating,
/area/submap/crystalcore/red/four)
"D" = (
/obj/structure/table/borosilicate,
/obj/random/tool/alien,
/turf/simulated/shuttle/floor/alienplating,
/area/submap/crystalcore/red/four)
"F" = (
/mob/living/simple_mob/mechanical/hivebot/ranged_damage/siege/fragmentation,
/turf/simulated/shuttle/floor/alienplating,
/area/submap/crystalcore/red/four)
"N" = (
/mob/living/simple_mob/mechanical/hivebot/tank/armored/anti_melee,
/turf/simulated/shuttle/floor/alienplating,
/area/submap/crystalcore/red/four)
"O" = (
/turf/simulated/shuttle/wall/alien,
/area/submap/crystalcore/red/four)
"R" = (
/obj/structure/loot_pile/surface/alien/medical,
/turf/simulated/shuttle/floor/alienplating,
/area/submap/crystalcore/red/four)
"S" = (
/mob/living/simple_mob/mechanical/hivebot/ranged_damage/backline,
/turf/simulated/shuttle/floor/alienplating,
/area/submap/crystalcore/red/four)
"T" = (
/obj/structure/loot_pile/surface/alien/engineering,
/turf/simulated/shuttle/floor/alienplating,
/area/submap/crystalcore/red/four)
"U" = (
/obj/structure/table/borosilicate,
/obj/item/weapon/ore/hydrogen,
/obj/item/weapon/ore/verdantium,
/turf/simulated/shuttle/floor/alienplating,
/area/submap/crystalcore/red/four)
"W" = (
/turf/template_noop,
/area/template_noop)

(1,1,1) = {"
W
W
W
W
W
W
W
W
W
W
W
W
W
W
W
W
W
W
W
W
W
W
W
W
"}
(2,1,1) = {"
W
W
W
W
W
W
W
W
W
W
W
W
W
W
W
W
W
W
W
W
W
W
W
W
"}
(3,1,1) = {"
W
W
W
W
W
W
W
W
W
W
W
W
W
W
W
W
W
W
W
W
W
W
W
W
"}
(4,1,1) = {"
W
W
W
W
W
W
W
W
W
W
W
W
W
W
W
W
W
W
W
W
W
W
W
W
"}
(5,1,1) = {"
W
W
W
W
W
O
O
O
O
O
O
O
O
O
O
W
W
W
W
W
W
W
W
W
"}
(6,1,1) = {"
W
W
W
W
O
O
t
D
a
U
a
U
D
t
O
O
W
W
W
W
W
W
W
W
"}
(7,1,1) = {"
W
W
W
O
O
A
A
A
S
A
A
A
N
A
A
O
O
W
W
W
W
W
W
W
"}
(8,1,1) = {"
W
W
W
O
y
A
A
F
A
A
A
z
A
A
A
A
O
O
W
W
W
W
W
W
"}
(9,1,1) = {"
W
W
W
O
T
A
A
A
S
A
h
A
A
A
A
A
A
O
O
W
W
W
W
W
"}
(10,1,1) = {"
W
W
W
O
O
A
A
A
A
A
A
A
A
A
A
A
A
A
O
O
W
W
W
W
"}
(11,1,1) = {"
W
W
W
W
O
O
O
O
O
O
O
O
O
O
O
O
O
g
O
O
O
W
W
W
"}
(12,1,1) = {"
W
W
W
W
W
O
A
A
B
A
B
A
B
A
B
A
A
A
A
B
O
O
W
W
"}
(13,1,1) = {"
W
W
W
W
W
g
A
A
B
A
B
A
B
A
B
A
A
A
A
A
R
O
O
W
"}
(14,1,1) = {"
W
W
W
W
W
O
A
A
B
A
B
A
B
A
B
A
A
A
A
B
O
O
W
W
"}
(15,1,1) = {"
W
W
W
W
O
O
O
O
O
O
O
O
O
O
O
O
O
g
O
O
O
W
W
W
"}
(16,1,1) = {"
W
W
W
O
O
A
A
A
A
A
A
A
A
A
A
A
A
A
O
O
W
W
W
W
"}
(17,1,1) = {"
W
W
W
O
T
A
A
A
S
A
h
A
A
A
A
A
A
O
O
W
W
W
W
W
"}
(18,1,1) = {"
W
W
W
O
y
A
A
F
A
A
A
z
A
A
A
A
O
O
W
W
W
W
W
W
"}
(19,1,1) = {"
W
W
W
O
O
A
A
A
S
A
A
A
N
A
A
O
O
W
W
W
W
W
W
W
"}
(20,1,1) = {"
W
W
W
W
O
O
t
a
D
U
a
D
U
t
O
O
W
W
W
W
W
W
W
W
"}
(21,1,1) = {"
W
W
W
W
W
O
O
O
O
O
O
O
O
O
O
W
W
W
W
W
W
W
W
W
"}
(22,1,1) = {"
W
W
W
W
W
W
W
W
W
W
W
W
W
W
W
W
W
W
W
W
W
W
W
W
"}
(23,1,1) = {"
W
W
W
W
W
W
W
W
W
W
W
W
W
W
W
W
W
W
W
W
W
W
W
W
"}
(24,1,1) = {"
W
W
W
W
W
W
W
W
W
W
W
W
W
W
W
W
W
W
W
W
W
W
W
W
"}
