//MAP CONVERTED BY dmm2tgm.py THIS HEADER COMMENT PREVENTS RECONVERSION, DO NOT REMOVE
"a" = (
/turf/simulated/floor/outdoors/crystal_planet/redsand,
/area/submap/crystalcore/red/nine)
"g" = (
/mob/living/simple_mob/humanoid/obsidianscale/melee/silver,
/turf/simulated/floor/outdoors/crystal_planet/redsand,
/area/submap/crystalcore/red/nine)
"j" = (
/turf/template_noop,
/area/submap/crystalcore/red/nine)
"u" = (
/obj/structure/table/rack,
/obj/item/weapon/gun/energy/lasershotgun,
/turf/simulated/floor/tiled/techfloor,
/area/submap/crystalcore/red/nine)
"v" = (
/obj/structure/table/rack,
/obj/item/weapon/rig/industrial,
/turf/simulated/floor/tiled/techfloor,
/area/submap/crystalcore/red/nine)
"B" = (
/turf/simulated/wall/titanium,
/area/submap/crystalcore/red/nine)
"E" = (
/mob/living/simple_mob/humanoid/obsidianscale/melee,
/turf/simulated/floor/outdoors/crystal_planet/redsand,
/area/submap/crystalcore/red/nine)
"I" = (
/turf/template_noop,
/area/template_noop)
"J" = (
/turf/simulated/floor/tiled/techfloor,
/area/submap/crystalcore/red/nine)
"N" = (
/mob/living/simple_mob/humanoid/obsidianscale/hacker,
/turf/simulated/floor/outdoors/crystal_planet/redsand,
/area/submap/crystalcore/red/nine)
"V" = (
/mob/living/simple_mob/humanoid/obsidianscale/bouncer,
/turf/simulated/floor/outdoors/crystal_planet/redsand,
/area/submap/crystalcore/red/nine)

(1,1,1) = {"
I
I
I
I
I
I
I
I
I
I
I
I
I
I
I
I
I
I
I
I
I
I
I
I
I
"}
(2,1,1) = {"
I
j
j
j
j
j
j
j
j
j
j
j
j
j
j
j
j
j
j
j
j
j
j
j
I
"}
(3,1,1) = {"
I
j
j
j
j
j
j
j
j
j
j
j
j
j
j
j
j
j
j
j
j
j
j
j
I
"}
(4,1,1) = {"
I
j
j
j
j
j
j
j
j
j
j
j
j
j
j
j
j
j
j
j
j
j
j
j
I
"}
(5,1,1) = {"
I
j
j
j
j
j
j
j
j
j
j
a
a
a
j
j
j
j
j
j
j
j
j
j
I
"}
(6,1,1) = {"
I
j
j
j
j
j
j
j
j
j
a
a
a
a
a
j
j
j
j
j
j
j
j
j
I
"}
(7,1,1) = {"
I
j
j
j
j
j
j
j
j
a
a
a
g
a
a
a
j
j
j
j
j
j
j
j
I
"}
(8,1,1) = {"
I
j
j
j
j
j
j
j
a
a
a
a
a
a
a
a
a
j
j
j
j
j
j
j
I
"}
(9,1,1) = {"
I
j
j
j
j
j
j
a
N
a
a
a
a
a
a
a
V
a
j
j
j
j
j
j
I
"}
(10,1,1) = {"
I
j
j
j
j
j
a
a
a
a
a
B
B
B
a
a
a
a
a
j
j
j
j
j
I
"}
(11,1,1) = {"
I
j
j
j
j
a
a
a
a
a
B
B
J
B
B
a
a
a
a
a
j
j
j
j
I
"}
(12,1,1) = {"
I
j
j
j
a
a
a
a
a
B
B
u
J
v
B
B
a
a
a
a
a
j
j
j
I
"}
(13,1,1) = {"
I
j
j
j
a
a
E
a
a
B
J
J
J
J
J
B
a
a
E
a
a
j
j
j
I
"}
(14,1,1) = {"
I
j
j
j
a
a
a
a
a
B
B
v
J
u
B
B
a
a
a
a
a
j
j
j
I
"}
(15,1,1) = {"
I
j
j
j
j
a
a
a
a
a
B
B
J
B
B
a
a
a
a
a
j
j
j
j
I
"}
(16,1,1) = {"
I
j
j
j
j
j
a
a
a
a
a
B
B
B
a
a
a
a
a
j
j
j
j
j
I
"}
(17,1,1) = {"
I
j
j
j
j
j
j
a
V
a
a
a
a
a
a
a
N
a
j
j
j
j
j
j
I
"}
(18,1,1) = {"
I
j
j
j
j
j
j
j
a
a
a
a
a
a
a
a
a
j
j
j
j
j
j
j
I
"}
(19,1,1) = {"
I
j
j
j
j
j
j
j
j
a
a
a
g
a
a
a
j
j
j
j
j
j
j
j
I
"}
(20,1,1) = {"
I
j
j
j
j
j
j
j
j
j
a
a
a
a
a
j
j
j
j
j
j
j
j
j
I
"}
(21,1,1) = {"
I
j
j
j
j
j
j
j
j
j
j
a
a
a
j
j
j
j
j
j
j
j
j
j
I
"}
(22,1,1) = {"
I
j
j
j
j
j
j
j
j
j
j
j
j
j
j
j
j
j
j
j
j
j
j
j
I
"}
(23,1,1) = {"
I
j
j
j
j
j
j
j
j
j
j
j
j
j
j
j
j
j
j
j
j
j
j
j
I
"}
(24,1,1) = {"
I
j
j
j
j
j
j
j
j
j
j
j
j
j
j
j
j
j
j
j
j
j
j
j
I
"}
(25,1,1) = {"
I
I
I
I
I
I
I
I
I
I
I
I
I
I
I
I
I
I
I
I
I
I
I
I
I
"}
