//MAP CONVERTED BY dmm2tgm.py THIS HEADER COMMENT PREVENTS RECONVERSION, DO NOT REMOVE
"a" = (
/turf/simulated/shuttle/wall/alien,
/area/submap/crystalcore/red/one)
"m" = (
/turf/simulated/shuttle/floor/alienplating,
/area/submap/crystalcore/red/one)
"H" = (
/turf/template_noop,
/area/template_noop)
"I" = (
/obj/structure/loot_pile/surface/alien/security,
/turf/simulated/shuttle/floor/alienplating,
/area/submap/crystalcore/red/one)
"K" = (
/obj/machinery/porta_turret/alien,
/turf/simulated/shuttle/floor/alienplating,
/area/submap/crystalcore/red/one)
"N" = (
/obj/machinery/door/airlock/alien/public,
/turf/simulated/shuttle/floor/alienplating,
/area/submap/crystalcore/red/one)
"S" = (
/obj/structure/loot_pile/surface/alien,
/turf/simulated/shuttle/floor/alienplating,
/area/submap/crystalcore/red/one)
"U" = (
/obj/structure/loot_pile/surface/alien/medical,
/turf/simulated/shuttle/floor/alienplating,
/area/submap/crystalcore/red/one)
"V" = (
/obj/structure/loot_pile/surface/alien/engineering,
/turf/simulated/shuttle/floor/alienplating,
/area/submap/crystalcore/red/one)

(1,1,1) = {"
H
H
H
H
H
H
H
H
H
H
H
H
H
H
H
H
H
H
H
H
H
H
H
H
H
H
H
H
"}
(2,1,1) = {"
H
a
a
a
a
a
a
a
a
a
a
a
a
a
a
a
a
a
a
a
a
a
a
a
a
a
a
H
"}
(3,1,1) = {"
H
a
m
m
m
K
m
m
m
m
a
m
m
m
m
m
m
m
a
m
m
m
m
m
m
m
a
H
"}
(4,1,1) = {"
H
a
m
m
m
a
m
m
m
m
K
m
m
m
a
m
m
m
m
m
m
m
m
m
m
m
a
H
"}
(5,1,1) = {"
H
a
m
m
m
K
m
m
m
m
a
m
m
m
m
m
m
m
a
m
m
m
m
m
m
m
a
H
"}
(6,1,1) = {"
H
a
m
a
m
a
a
a
a
a
a
a
a
a
a
a
a
a
a
a
a
a
a
m
a
a
a
H
"}
(7,1,1) = {"
H
a
m
m
m
a
m
m
m
m
a
m
m
m
m
m
K
a
m
m
m
m
a
m
m
K
a
H
"}
(8,1,1) = {"
H
a
m
m
m
a
m
m
m
a
m
m
m
a
m
m
a
m
m
m
a
m
a
m
m
m
a
H
"}
(9,1,1) = {"
H
a
m
m
m
a
m
m
m
K
m
m
m
K
a
K
m
m
m
a
K
m
a
m
m
m
a
H
"}
(10,1,1) = {"
H
a
m
a
a
a
m
m
m
a
a
a
a
a
a
a
a
a
a
m
m
m
a
K
m
m
a
H
"}
(11,1,1) = {"
H
a
m
m
K
a
m
m
m
a
m
m
m
m
m
m
m
m
a
m
m
m
a
a
a
m
a
H
"}
(12,1,1) = {"
H
a
m
m
m
a
m
m
m
a
m
V
m
S
S
m
V
m
a
m
m
m
a
K
m
m
a
H
"}
(13,1,1) = {"
H
a
a
m
m
a
m
m
m
a
m
I
m
S
S
m
U
m
a
m
m
K
a
m
m
m
a
H
"}
(14,1,1) = {"
H
a
m
m
m
a
m
m
m
a
m
m
m
m
m
m
m
m
a
m
m
a
a
m
m
m
a
H
"}
(15,1,1) = {"
H
a
m
m
K
a
m
m
m
a
m
m
m
m
m
m
m
m
a
m
a
m
a
m
m
m
a
H
"}
(16,1,1) = {"
H
a
m
a
a
a
m
m
m
a
m
I
m
S
S
m
U
m
a
m
m
m
a
m
m
m
a
H
"}
(17,1,1) = {"
H
a
m
m
m
a
m
m
m
N
m
V
m
S
S
m
V
m
a
m
m
m
a
m
m
m
a
H
"}
(18,1,1) = {"
H
a
m
m
m
a
K
K
K
a
m
m
m
m
m
m
m
m
a
m
m
m
a
m
m
K
a
H
"}
(19,1,1) = {"
H
a
m
m
m
a
a
a
a
a
a
a
a
a
a
a
a
a
a
K
m
m
a
m
a
a
a
H
"}
(20,1,1) = {"
H
a
m
m
m
m
m
m
m
m
m
m
m
K
m
m
m
m
m
a
K
m
a
m
m
m
a
H
"}
(21,1,1) = {"
H
a
m
m
m
m
m
m
m
m
m
m
m
m
m
m
m
m
m
m
a
m
a
m
m
m
a
H
"}
(22,1,1) = {"
H
a
K
m
m
m
m
m
m
m
m
m
m
K
m
m
m
m
m
m
m
m
a
m
m
m
a
H
"}
(23,1,1) = {"
H
a
a
a
a
a
a
a
a
a
a
a
a
a
a
a
a
a
a
a
a
a
a
m
m
a
a
H
"}
(24,1,1) = {"
H
H
H
H
H
H
H
H
H
a
m
m
m
m
m
m
m
m
m
m
m
m
m
m
m
m
a
H
"}
(25,1,1) = {"
H
H
H
H
H
H
H
H
H
N
m
m
m
m
a
m
K
m
a
m
m
m
m
m
m
m
a
H
"}
(26,1,1) = {"
H
H
H
H
H
H
H
H
H
a
m
m
m
m
m
m
m
m
m
m
m
m
a
m
m
K
a
H
"}
(27,1,1) = {"
H
H
H
H
H
H
H
H
H
a
a
a
a
a
a
a
a
a
a
a
a
a
a
a
a
a
a
H
"}
(28,1,1) = {"
H
H
H
H
H
H
H
H
H
H
H
H
H
H
H
H
H
H
H
H
H
H
H
H
H
H
H
H
"}
