//MAP CONVERTED BY dmm2tgm.py THIS HEADER COMMENT PREVENTS RECONVERSION, DO NOT REMOVE
"a" = (
/turf/template_noop,
/area/submap/crystalcore/red/sixteen)
"j" = (
/turf/simulated/floor/lava/warm,
/area/submap/crystalcore/red/sixteen)
"u" = (
/obj/structure/catwalk,
/obj/structure/railing{
	dir = 4
	},
/turf/simulated/floor/lava/warm,
/area/submap/crystalcore/red/sixteen)
"J" = (
/obj/structure/catwalk,
/obj/structure/railing{
	dir = 8
	},
/turf/simulated/floor/lava/warm,
/area/submap/crystalcore/red/sixteen)
"P" = (
/obj/structure/catwalk,
/obj/structure/railing{
	dir = 4
	},
/obj/structure/railing{
	dir = 8
	},
/turf/simulated/floor/lava/warm,
/area/submap/crystalcore/red/sixteen)
"Q" = (
/obj/structure/railing{
	dir = 4
	},
/obj/structure/railing{
	dir = 8
	},
/turf/simulated/floor/lava/warm,
/area/submap/crystalcore/red/sixteen)
"R" = (
/turf/simulated/floor/outdoors/crystal_planet/redsand,
/area/submap/crystalcore/red/sixteen)
"W" = (
/turf/template_noop,
/area/template_noop)

(1,1,1) = {"
W
W
W
W
W
W
W
W
W
W
W
W
W
W
W
W
W
W
W
W
W
W
W
W
W
"}
(2,1,1) = {"
W
a
a
a
a
a
a
a
a
a
a
a
j
a
a
a
a
a
a
a
a
a
a
a
W
"}
(3,1,1) = {"
W
a
a
a
a
a
a
a
a
a
a
a
j
a
a
a
a
a
a
a
a
a
a
a
W
"}
(4,1,1) = {"
W
a
a
a
a
a
a
a
a
a
a
j
j
j
a
a
a
a
a
a
a
a
a
a
W
"}
(5,1,1) = {"
W
a
a
a
a
a
a
a
a
a
a
j
j
j
a
a
a
a
a
a
a
a
a
a
W
"}
(6,1,1) = {"
W
a
a
a
a
a
a
a
a
R
j
j
j
j
j
R
a
a
a
a
a
a
a
a
W
"}
(7,1,1) = {"
W
a
a
a
a
a
a
a
R
R
P
P
P
Q
P
R
R
a
a
a
a
a
a
a
W
"}
(8,1,1) = {"
W
a
a
a
a
a
a
a
a
R
j
j
j
j
j
R
a
a
a
a
a
a
a
a
W
"}
(9,1,1) = {"
W
a
a
a
a
a
a
a
a
j
j
j
j
j
j
j
a
a
a
a
a
a
a
a
W
"}
(10,1,1) = {"
W
a
a
a
a
a
a
a
a
j
j
j
j
j
j
j
a
a
a
a
a
a
a
a
W
"}
(11,1,1) = {"
W
a
a
a
a
a
a
a
R
j
j
j
j
j
j
j
R
a
a
a
a
a
a
a
W
"}
(12,1,1) = {"
W
a
a
a
a
a
a
R
R
J
J
J
J
J
J
J
R
R
a
a
a
a
a
a
W
"}
(13,1,1) = {"
W
a
a
a
a
a
a
R
R
u
u
u
u
u
u
u
R
R
a
a
a
a
a
a
W
"}
(14,1,1) = {"
W
a
a
a
a
a
a
a
R
j
j
j
j
j
j
j
R
a
a
a
a
a
a
a
W
"}
(15,1,1) = {"
W
a
a
a
a
a
a
a
a
j
j
j
j
j
j
j
a
a
a
a
a
a
a
a
W
"}
(16,1,1) = {"
W
a
a
a
a
a
a
a
a
j
j
j
j
j
j
j
a
a
a
a
a
a
a
a
W
"}
(17,1,1) = {"
W
a
a
a
a
a
a
a
a
R
j
j
j
j
j
R
a
a
a
a
a
a
a
a
W
"}
(18,1,1) = {"
W
a
a
a
a
a
a
a
R
R
P
Q
P
P
P
R
R
a
a
a
a
a
a
a
W
"}
(19,1,1) = {"
W
a
a
a
a
a
a
a
a
R
j
j
j
j
j
R
a
a
a
a
a
a
a
a
W
"}
(20,1,1) = {"
W
a
a
a
a
a
a
a
a
a
a
j
j
j
a
a
a
a
a
a
a
a
a
a
W
"}
(21,1,1) = {"
W
a
a
a
a
a
a
a
a
a
a
j
j
j
a
a
a
a
a
a
a
a
a
a
W
"}
(22,1,1) = {"
W
a
a
a
a
a
a
a
a
a
a
j
j
j
a
a
a
a
a
a
a
a
a
a
W
"}
(23,1,1) = {"
W
a
a
a
a
a
a
a
a
a
a
a
j
a
a
a
a
a
a
a
a
a
a
a
W
"}
(24,1,1) = {"
W
a
a
a
a
a
a
a
a
a
a
a
j
a
a
a
a
a
a
a
a
a
a
a
W
"}
(25,1,1) = {"
W
W
W
W
W
W
W
W
W
W
W
W
W
W
W
W
W
W
W
W
W
W
W
W
W
"}
