//MAP CONVERTED BY dmm2tgm.py THIS HEADER COMMENT PREVENTS RECONVERSION, DO NOT REMOVE
"a" = (
/turf/template_noop,
/area/submap/crystalcore/red/ten)
"h" = (
/obj/structure/table/gold,
/obj/item/device/radio,
/obj/item/device/radio,
/turf/simulated/floor/tiled/old_tile/purple,
/area/submap/crystalcore/red/ten)
"n" = (
/mob/living/simple_mob/humanoid/obsidianscale/hacker,
/turf/simulated/floor/tiled/old_tile/purple,
/area/submap/crystalcore/red/ten)
"s" = (
/obj/item/weapon/bedsheet,
/obj/structure/bed,
/mob/living/simple_mob/humanoid/obsidianscale/melee,
/turf/simulated/floor/tiled/old_tile/purple,
/area/submap/crystalcore/red/ten)
"w" = (
/mob/living/simple_mob/humanoid/obsidianscale/demo,
/turf/simulated/floor/tiled/old_tile/purple,
/area/submap/crystalcore/red/ten)
"x" = (
/obj/machinery/door/airlock,
/turf/simulated/floor/tiled/old_tile/purple,
/area/submap/crystalcore/red/ten)
"z" = (
/obj/structure/table/gold,
/obj/random/medical/pillbottle,
/turf/simulated/floor/tiled/old_tile/purple,
/area/submap/crystalcore/red/ten)
"A" = (
/obj/structure/table/gold,
/obj/item/weapon/gun/energy/xray,
/turf/simulated/floor/tiled/old_tile/purple,
/area/submap/crystalcore/red/ten)
"C" = (
/obj/structure/catwalk,
/turf/simulated/floor/lava/warm,
/area/submap/crystalcore/red/ten)
"F" = (
/turf/simulated/wall/r_lead,
/area/submap/crystalcore/red/ten)
"I" = (
/obj/item/weapon/bedsheet,
/obj/structure/bed,
/turf/simulated/floor/tiled/old_tile/purple,
/area/submap/crystalcore/red/ten)
"M" = (
/turf/simulated/floor/tiled/old_tile/purple,
/area/submap/crystalcore/red/ten)
"O" = (
/turf/template_noop,
/area/template_noop)
"T" = (
/obj/item/weapon/bedsheet,
/obj/structure/bed,
/mob/living/simple_mob/humanoid/obsidianscale/bouncer,
/turf/simulated/floor/tiled/old_tile/purple,
/area/submap/crystalcore/red/ten)

(1,1,1) = {"
O
O
O
O
O
O
O
O
O
O
O
O
O
O
O
O
O
O
O
O
O
O
O
O
O
"}
(2,1,1) = {"
O
a
a
a
a
a
a
a
a
a
a
a
a
a
a
a
a
a
a
a
a
a
a
a
O
"}
(3,1,1) = {"
O
a
a
a
a
a
a
a
a
a
a
a
a
a
a
a
a
a
a
a
a
a
a
a
O
"}
(4,1,1) = {"
O
a
a
a
a
a
a
a
a
a
a
a
a
a
a
a
a
a
a
a
a
a
a
a
O
"}
(5,1,1) = {"
O
a
a
a
a
a
a
a
a
a
a
a
a
a
a
a
a
a
a
a
a
a
a
a
O
"}
(6,1,1) = {"
O
a
a
a
a
a
a
a
a
a
a
a
a
a
a
a
a
a
a
a
a
a
a
a
O
"}
(7,1,1) = {"
O
a
a
a
a
a
a
a
a
a
a
a
a
a
a
a
a
a
a
a
a
a
a
a
O
"}
(8,1,1) = {"
O
a
a
a
a
a
a
a
a
a
F
F
x
F
F
a
a
a
a
a
a
a
a
a
O
"}
(9,1,1) = {"
O
a
a
a
a
a
a
a
a
a
F
M
M
M
F
a
a
a
a
a
a
a
a
a
O
"}
(10,1,1) = {"
O
a
a
a
a
a
a
a
a
F
F
M
M
M
F
F
a
a
a
a
a
a
a
a
O
"}
(11,1,1) = {"
O
a
a
a
a
F
F
F
F
F
A
M
M
M
h
F
F
F
F
F
a
a
a
a
O
"}
(12,1,1) = {"
O
a
a
a
F
F
T
I
I
F
M
n
C
M
M
F
s
I
I
F
F
a
a
a
O
"}
(13,1,1) = {"
O
a
a
a
F
z
M
M
M
x
M
C
C
C
M
x
M
M
M
z
F
a
a
a
O
"}
(14,1,1) = {"
O
a
a
a
F
F
I
I
s
F
M
M
C
w
M
F
I
I
T
F
F
a
a
a
O
"}
(15,1,1) = {"
O
a
a
a
a
F
F
F
F
F
h
M
M
M
A
F
F
F
F
F
a
a
a
a
O
"}
(16,1,1) = {"
O
a
a
a
a
a
a
a
a
F
F
M
M
M
F
F
a
a
a
a
a
a
a
a
O
"}
(17,1,1) = {"
O
a
a
a
a
a
a
a
a
a
F
M
M
M
F
a
a
a
a
a
a
a
a
a
O
"}
(18,1,1) = {"
O
a
a
a
a
a
a
a
a
a
F
F
x
F
F
a
a
a
a
a
a
a
a
a
O
"}
(19,1,1) = {"
O
a
a
a
a
a
a
a
a
a
a
a
a
a
a
a
a
a
a
a
a
a
a
a
O
"}
(20,1,1) = {"
O
a
a
a
a
a
a
a
a
a
a
a
a
a
a
a
a
a
a
a
a
a
a
a
O
"}
(21,1,1) = {"
O
a
a
a
a
a
a
a
a
a
a
a
a
a
a
a
a
a
a
a
a
a
a
a
O
"}
(22,1,1) = {"
O
a
a
a
a
a
a
a
a
a
a
a
a
a
a
a
a
a
a
a
a
a
a
a
O
"}
(23,1,1) = {"
O
a
a
a
a
a
a
a
a
a
a
a
a
a
a
a
a
a
a
a
a
a
a
a
O
"}
(24,1,1) = {"
O
a
a
a
a
a
a
a
a
a
a
a
a
a
a
a
a
a
a
a
a
a
a
a
O
"}
(25,1,1) = {"
O
O
O
O
O
O
O
O
O
O
O
O
O
O
O
O
O
O
O
O
O
O
O
O
O
"}
