//MAP CONVERTED BY dmm2tgm.py THIS HEADER COMMENT PREVENTS RECONVERSION, DO NOT REMOVE
"a" = (
/turf/template_noop,
/area/submap/crystalcore/red/thirteen)
"f" = (
/obj/structure/toilet{
	dir = 1
	},
/turf/simulated/floor/tiled/old_tile/beige,
/area/submap/crystalcore/red/thirteen)
"g" = (
/obj/structure/table/steel,
/obj/item/organ/internal/brain,
/turf/simulated/floor/tiled/old_tile/beige,
/area/submap/crystalcore/red/thirteen)
"m" = (
/obj/item/mecha_parts/mecha_equipment/runningboard,
/obj/structure/table/steel,
/turf/simulated/floor/tiled/old_tile/beige,
/area/submap/crystalcore/red/thirteen)
"n" = (
/obj/structure/sink{
	dir = 8;
	pixel_x = -16
	},
/turf/simulated/floor/tiled/old_tile/beige,
/area/submap/crystalcore/red/thirteen)
"o" = (
/obj/item/mecha_parts/mecha_equipment/tool/powertool/inflatables,
/obj/structure/table/steel,
/turf/simulated/floor/tiled/old_tile/beige,
/area/submap/crystalcore/red/thirteen)
"q" = (
/mob/living/simple_mob/mechanical/cyber_horror/ling_cyber_horror,
/turf/simulated/floor/tiled/old_tile/beige,
/area/submap/crystalcore/red/thirteen)
"r" = (
/obj/item/mecha_parts/mecha_equipment/storage,
/obj/structure/table/steel,
/turf/simulated/floor/tiled/old_tile/beige,
/area/submap/crystalcore/red/thirteen)
"t" = (
/obj/structure/closet/coffin,
/turf/simulated/floor/tiled/old_tile/beige,
/area/submap/crystalcore/red/thirteen)
"w" = (
/mob/living/simple_mob/mechanical/cyber_horror/vox,
/turf/simulated/floor/tiled/old_tile/beige,
/area/submap/crystalcore/red/thirteen)
"x" = (
/obj/item/mecha_parts/mecha_equipment/crisis_drone/rad,
/obj/structure/table/steel,
/turf/simulated/floor/tiled/old_tile/beige,
/area/submap/crystalcore/red/thirteen)
"y" = (
/obj/machinery/recharge_station,
/turf/simulated/floor/tiled/old_tile/beige,
/area/submap/crystalcore/red/thirteen)
"C" = (
/obj/machinery/door/airlock/silver,
/turf/simulated/floor/tiled/old_tile/beige,
/area/submap/crystalcore/red/thirteen)
"F" = (
/mob/living/simple_mob/mechanical/cyber_horror/tajaran,
/turf/simulated/floor/tiled/old_tile/beige,
/area/submap/crystalcore/red/thirteen)
"K" = (
/obj/structure/sink{
	dir = 4;
	pixel_x = 16
	},
/turf/simulated/floor/tiled/old_tile/beige,
/area/submap/crystalcore/red/thirteen)
"N" = (
/turf/simulated/floor/tiled/old_tile/beige,
/area/submap/crystalcore/red/thirteen)
"O" = (
/turf/simulated/wall/iron,
/area/submap/crystalcore/red/thirteen)
"S" = (
/turf/simulated/floor/outdoors/crystal_planet/redsand,
/area/submap/crystalcore/red/thirteen)
"X" = (
/obj/structure/frame,
/turf/simulated/floor/tiled/old_tile/beige,
/area/submap/crystalcore/red/thirteen)
"Y" = (
/turf/template_noop,
/area/template_noop)

(1,1,1) = {"
Y
Y
Y
Y
Y
Y
Y
Y
Y
Y
Y
Y
Y
Y
Y
Y
Y
Y
Y
Y
Y
Y
Y
Y
Y
"}
(2,1,1) = {"
Y
a
a
a
a
a
a
a
a
a
a
a
a
a
a
a
a
a
a
a
a
a
a
a
Y
"}
(3,1,1) = {"
Y
a
a
a
a
a
a
a
a
a
a
a
a
a
a
a
a
a
a
a
a
a
a
a
Y
"}
(4,1,1) = {"
Y
a
a
a
a
a
a
a
a
a
a
a
a
a
a
a
a
a
a
a
a
a
a
a
Y
"}
(5,1,1) = {"
Y
a
a
a
a
a
a
a
a
a
a
a
a
a
a
a
a
a
a
a
a
a
a
a
Y
"}
(6,1,1) = {"
Y
a
a
a
a
a
a
a
a
a
O
O
O
O
O
a
a
a
a
a
a
a
a
a
Y
"}
(7,1,1) = {"
Y
a
a
a
a
a
a
a
a
O
O
X
g
X
O
O
a
a
a
a
a
a
a
a
Y
"}
(8,1,1) = {"
Y
a
a
a
a
a
a
a
a
O
o
N
N
N
m
O
a
a
a
a
a
a
a
a
Y
"}
(9,1,1) = {"
Y
a
a
a
a
a
a
a
a
O
x
N
w
N
r
O
a
a
a
a
a
a
a
a
Y
"}
(10,1,1) = {"
Y
a
a
a
a
a
O
O
O
O
O
N
N
N
O
O
O
O
O
a
a
a
a
a
Y
"}
(11,1,1) = {"
Y
a
a
a
a
O
O
t
t
O
O
O
N
O
O
O
n
O
O
O
a
a
a
a
Y
"}
(12,1,1) = {"
Y
a
a
a
a
O
t
N
N
N
O
N
N
N
O
N
N
C
y
O
a
a
a
a
Y
"}
(13,1,1) = {"
Y
a
a
a
a
O
t
N
F
N
N
N
q
N
N
F
N
O
O
O
a
a
a
a
Y
"}
(14,1,1) = {"
Y
a
a
a
a
O
t
N
N
N
O
N
N
N
O
N
N
C
f
O
a
a
a
a
Y
"}
(15,1,1) = {"
Y
a
a
a
a
O
O
t
t
O
O
O
C
O
O
O
K
O
O
O
a
a
a
a
Y
"}
(16,1,1) = {"
Y
a
a
a
a
a
O
O
O
O
O
S
S
S
O
O
O
O
O
a
a
a
a
a
Y
"}
(17,1,1) = {"
Y
a
a
a
a
a
a
a
a
O
S
S
S
S
S
O
a
a
a
a
a
a
a
a
Y
"}
(18,1,1) = {"
Y
a
a
a
a
a
a
a
a
a
S
S
S
S
S
a
a
a
a
a
a
a
a
a
Y
"}
(19,1,1) = {"
Y
a
a
a
a
a
a
a
a
a
a
S
S
S
a
a
a
a
a
a
a
a
a
a
Y
"}
(20,1,1) = {"
Y
a
a
a
a
a
a
a
a
a
a
a
a
a
a
a
a
a
a
a
a
a
a
a
Y
"}
(21,1,1) = {"
Y
a
a
a
a
a
a
a
a
a
a
a
a
a
a
a
a
a
a
a
a
a
a
a
Y
"}
(22,1,1) = {"
Y
a
a
a
a
a
a
a
a
a
a
a
a
a
a
a
a
a
a
a
a
a
a
a
Y
"}
(23,1,1) = {"
Y
a
a
a
a
a
a
a
a
a
a
a
a
a
a
a
a
a
a
a
a
a
a
a
Y
"}
(24,1,1) = {"
Y
a
a
a
a
a
a
a
a
a
a
a
a
a
a
a
a
a
a
a
a
a
a
a
Y
"}
(25,1,1) = {"
Y
Y
Y
Y
Y
Y
Y
Y
Y
Y
Y
Y
Y
Y
Y
Y
Y
Y
Y
Y
Y
Y
Y
Y
Y
"}
