//MAP CONVERTED BY dmm2tgm.py THIS HEADER COMMENT PREVENTS RECONVERSION, DO NOT REMOVE
"a" = (
/turf/template_noop,
/area/template_noop)
"k" = (
/obj/structure/loot_pile/surface/alien/engineering,
/turf/simulated/shuttle/floor/alienplating,
/area/submap/crystalcore/red/three)
"l" = (
/turf/simulated/shuttle/floor/alienplating,
/area/submap/crystalcore/red/three)
"s" = (
/obj/structure/loot_pile/surface/alien/medical,
/turf/simulated/shuttle/floor/alienplating,
/area/submap/crystalcore/red/three)
"y" = (
/mob/living/simple_mob/mechanical/hivebot/swarm,
/turf/simulated/shuttle/floor/alienplating,
/area/submap/crystalcore/red/three)
"A" = (
/turf/simulated/shuttle/wall/alien,
/area/submap/crystalcore/red/three)
"D" = (
/obj/structure/loot_pile/surface/alien/security,
/turf/simulated/shuttle/floor/alienplating,
/area/submap/crystalcore/red/three)
"O" = (
/mob/living/simple_mob/mechanical/hivebot/precusor/lobber,
/turf/simulated/shuttle/floor/alienplating,
/area/submap/crystalcore/red/three)
"Q" = (
/obj/machinery/door/airlock/alien/public,
/turf/simulated/shuttle/floor/alienplating,
/area/submap/crystalcore/red/three)
"S" = (
/obj/structure/loot_pile/surface/alien/end,
/turf/simulated/shuttle/floor/alienplating,
/area/submap/crystalcore/red/three)

(1,1,1) = {"
a
a
a
a
a
a
a
a
a
a
a
a
a
a
a
a
a
a
a
"}
(2,1,1) = {"
a
a
a
a
a
a
a
a
a
a
a
a
a
a
a
a
a
a
a
"}
(3,1,1) = {"
a
a
a
A
A
Q
A
A
a
a
a
A
A
Q
A
A
a
a
a
"}
(4,1,1) = {"
a
a
A
A
l
l
l
A
A
A
A
A
l
l
l
A
A
a
a
"}
(5,1,1) = {"
a
a
A
l
y
y
y
l
Q
l
Q
l
y
y
y
l
A
a
a
"}
(6,1,1) = {"
a
a
Q
l
y
y
y
l
A
l
A
l
y
y
y
l
Q
a
a
"}
(7,1,1) = {"
a
a
A
l
y
y
y
l
A
l
A
l
y
y
y
l
A
a
a
"}
(8,1,1) = {"
a
a
A
A
l
l
l
A
A
l
A
A
l
l
l
A
A
a
a
"}
(9,1,1) = {"
a
a
a
A
Q
A
A
A
D
l
S
A
A
A
Q
A
a
a
a
"}
(10,1,1) = {"
a
a
a
A
l
l
l
l
l
O
l
l
l
l
l
A
a
a
a
"}
(11,1,1) = {"
a
a
a
A
Q
A
A
A
k
l
s
A
A
A
Q
A
a
a
a
"}
(12,1,1) = {"
a
a
A
A
l
l
l
A
A
l
A
A
l
l
l
A
A
a
a
"}
(13,1,1) = {"
a
a
A
l
y
y
y
l
A
l
A
l
y
y
y
l
A
a
a
"}
(14,1,1) = {"
a
a
Q
l
y
y
y
l
A
l
A
l
y
y
y
l
Q
a
a
"}
(15,1,1) = {"
a
a
A
l
y
y
y
l
Q
l
Q
l
y
y
y
l
A
a
a
"}
(16,1,1) = {"
a
a
A
A
l
l
l
A
A
A
A
A
l
l
l
A
A
a
a
"}
(17,1,1) = {"
a
a
a
A
A
Q
A
A
a
a
a
A
A
Q
A
A
a
a
a
"}
(18,1,1) = {"
a
a
a
a
a
a
a
a
a
a
a
a
a
a
a
a
a
a
a
"}
(19,1,1) = {"
a
a
a
a
a
a
a
a
a
a
a
a
a
a
a
a
a
a
a
"}
