//MAP CONVERTED BY dmm2tgm.py THIS HEADER COMMENT PREVENTS RECONVERSION, DO NOT REMOVE
"a" = (
/turf/template_noop,
/area/template_noop)
"c" = (
/obj/structure/table/marble,
/obj/fruitspawner/icechili,
/turf/simulated/floor/wmarble,
/area/submap/crystalcore/red/twelve)
"d" = (
/obj/structure/table/marble,
/obj/fruitspawner/bluespacetomato,
/turf/simulated/floor/wmarble,
/area/submap/crystalcore/red/twelve)
"f" = (
/obj/structure/table/marble,
/turf/simulated/floor/wmarble,
/area/submap/crystalcore/red/twelve)
"j" = (
/obj/machinery/door/airlock/silver,
/turf/simulated/floor/wmarble,
/area/submap/crystalcore/red/twelve)
"l" = (
/mob/living/simple_mob/mechanical/cyber_horror/tajaran,
/turf/simulated/floor/wmarble,
/area/submap/crystalcore/red/twelve)
"m" = (
/obj/structure/table/marble,
/obj/fruitspawner/bloodtomato,
/turf/simulated/floor/bmarble,
/area/submap/crystalcore/red/twelve)
"n" = (
/turf/template_noop,
/area/submap/crystalcore/red/twelve)
"s" = (
/obj/structure/table/marble,
/obj/fruitspawner/mold,
/turf/simulated/floor/bmarble,
/area/submap/crystalcore/red/twelve)
"u" = (
/mob/living/simple_mob/mechanical/cyber_horror/ling_cyber_horror,
/turf/simulated/floor/wmarble,
/area/submap/crystalcore/red/twelve)
"v" = (
/obj/machinery/portable_atmospherics/hydroponics,
/turf/simulated/floor/bmarble,
/area/submap/crystalcore/red/twelve)
"w" = (
/obj/structure/table/marble,
/obj/fruitspawner/redcap,
/turf/simulated/floor/bmarble,
/area/submap/crystalcore/red/twelve)
"x" = (
/mob/living/simple_mob/mechanical/cyber_horror/cat_cyber_horror,
/turf/simulated/floor/wmarble,
/area/submap/crystalcore/red/twelve)
"z" = (
/obj/structure/table/marble,
/obj/fruitspawner/spineapple,
/turf/simulated/floor/wmarble,
/area/submap/crystalcore/red/twelve)
"B" = (
/obj/structure/table/marble,
/obj/fruitspawner/bloodrose,
/turf/simulated/floor/wmarble,
/area/submap/crystalcore/red/twelve)
"D" = (
/obj/structure/table/marble,
/obj/fruitspawner/destroyingangel,
/turf/simulated/floor/wmarble,
/area/submap/crystalcore/red/twelve)
"F" = (
/mob/living/simple_mob/mechanical/cyber_horror/grey,
/turf/simulated/floor/wmarble,
/area/submap/crystalcore/red/twelve)
"G" = (
/obj/structure/table/marble,
/obj/fruitspawner/greengrapes,
/turf/simulated/floor/wmarble,
/area/submap/crystalcore/red/twelve)
"H" = (
/turf/simulated/wall/iron,
/area/submap/crystalcore/red/twelve)
"I" = (
/turf/simulated/floor/outdoors/crystal_planet/redsand,
/area/submap/crystalcore/red/twelve)
"J" = (
/obj/structure/table/marble,
/turf/simulated/floor/bmarble,
/area/submap/crystalcore/red/twelve)
"K" = (
/obj/structure/table/marble,
/obj/fruitspawner/telriis,
/turf/simulated/floor/wmarble,
/area/submap/crystalcore/red/twelve)
"N" = (
/turf/simulated/floor/bmarble,
/area/submap/crystalcore/red/twelve)
"O" = (
/obj/structure/table/marble,
/obj/fruitspawner/bluetomato,
/turf/simulated/floor/bmarble,
/area/submap/crystalcore/red/twelve)
"R" = (
/obj/machinery/portable_atmospherics/hydroponics,
/turf/simulated/floor/wmarble,
/area/submap/crystalcore/red/twelve)
"T" = (
/obj/structure/grille,
/obj/structure/window/basic/full,
/turf/simulated/floor/plating,
/area/submap/crystalcore/red/twelve)
"V" = (
/obj/structure/table/marble,
/obj/fruitspawner/berry,
/turf/simulated/floor/wmarble,
/area/submap/crystalcore/red/twelve)
"W" = (
/obj/structure/window/basic/full,
/obj/structure/grille,
/turf/simulated/floor/plating,
/area/submap/crystalcore/red/twelve)
"X" = (
/obj/machinery/door/airlock/silver,
/turf/simulated/floor/bmarble,
/area/submap/crystalcore/red/twelve)
"Y" = (
/mob/living/simple_mob/mechanical/cyber_horror/vox,
/turf/simulated/floor/bmarble,
/area/submap/crystalcore/red/twelve)
"Z" = (
/turf/simulated/floor/wmarble,
/area/submap/crystalcore/red/twelve)

(1,1,1) = {"
a
a
a
a
a
a
a
a
a
a
a
a
a
a
a
a
a
a
a
a
a
a
a
a
a
"}
(2,1,1) = {"
a
n
n
n
n
n
n
n
n
n
H
H
H
H
H
n
n
n
n
n
n
n
n
n
a
"}
(3,1,1) = {"
a
n
n
n
n
n
n
n
n
H
H
R
v
R
H
H
n
n
n
n
n
n
n
n
a
"}
(4,1,1) = {"
a
n
n
n
n
n
n
n
n
T
V
N
F
N
f
T
n
n
n
n
n
n
n
n
a
"}
(5,1,1) = {"
a
n
n
n
n
n
n
n
n
T
J
Z
N
Z
w
T
n
n
n
n
n
n
n
n
a
"}
(6,1,1) = {"
a
n
n
n
n
n
n
n
n
H
z
N
u
N
G
H
n
n
n
n
n
n
n
n
a
"}
(7,1,1) = {"
a
n
n
n
n
n
n
n
I
H
H
H
X
H
H
H
I
n
n
n
n
n
n
n
a
"}
(8,1,1) = {"
a
n
n
n
n
n
n
I
I
I
I
W
Z
W
I
I
I
I
n
n
n
n
n
n
a
"}
(9,1,1) = {"
a
n
n
n
n
n
I
I
I
I
I
W
N
W
I
I
I
I
I
n
n
n
n
n
a
"}
(10,1,1) = {"
a
n
H
W
W
H
H
I
I
I
H
H
Z
H
H
I
I
I
H
H
W
W
H
n
a
"}
(11,1,1) = {"
a
H
H
d
J
D
H
I
I
H
H
Z
N
Z
H
H
I
I
H
B
O
f
H
H
a
"}
(12,1,1) = {"
a
H
R
N
Z
N
H
W
W
H
l
N
Z
N
l
H
W
W
H
N
Z
N
R
H
a
"}
(13,1,1) = {"
a
H
v
F
N
x
X
Z
N
Z
N
Z
H
Z
N
Z
N
Z
X
x
N
F
v
H
a
"}
(14,1,1) = {"
a
H
R
N
Z
N
H
W
W
H
Z
N
Z
N
Z
H
W
W
H
N
Z
N
R
H
a
"}
(15,1,1) = {"
a
H
H
f
m
c
H
I
I
H
H
Z
Y
Z
H
H
I
I
H
f
s
K
H
H
a
"}
(16,1,1) = {"
a
n
H
W
W
H
H
I
I
I
H
H
Z
H
H
I
I
I
H
H
W
W
H
n
a
"}
(17,1,1) = {"
a
n
n
n
n
n
I
I
I
I
I
W
N
W
I
I
I
I
I
n
n
n
n
n
a
"}
(18,1,1) = {"
a
n
n
n
n
n
n
I
I
I
I
W
Z
W
I
I
I
I
n
n
n
n
n
n
a
"}
(19,1,1) = {"
a
n
n
n
n
n
n
n
I
I
I
W
N
W
I
I
I
n
n
n
n
n
n
n
a
"}
(20,1,1) = {"
a
n
n
n
n
n
n
n
n
I
I
H
j
H
I
I
n
n
n
n
n
n
n
n
a
"}
(21,1,1) = {"
a
n
n
n
n
n
n
n
n
n
I
I
I
I
I
n
n
n
n
n
n
n
n
n
a
"}
(22,1,1) = {"
a
n
n
n
n
n
n
n
n
n
n
I
I
I
n
n
n
n
n
n
n
n
n
n
a
"}
(23,1,1) = {"
a
n
n
n
n
n
n
n
n
n
n
n
n
n
n
n
n
n
n
n
n
n
n
n
a
"}
(24,1,1) = {"
a
n
n
n
n
n
n
n
n
n
n
n
n
n
n
n
n
n
n
n
n
n
n
n
a
"}
(25,1,1) = {"
a
a
a
a
a
a
a
a
a
a
a
a
a
a
a
a
a
a
a
a
a
a
a
a
a
"}
