//MAP CONVERTED BY dmm2tgm.py THIS HEADER COMMENT PREVENTS RECONVERSION, DO NOT REMOVE
"a" = (
/turf/template_noop,
/area/submap/crystalcore/dark/eight)
"b" = (
/mob/living/simple_mob/humanoid/eclipse/tropical/anomalist,
/turf/simulated/floor/concrete,
/area/submap/crystalcore/dark/eight)
"f" = (
/obj/structure/railing,
/obj/structure/table/steel,
/obj/item/weapon/ore/uranium,
/obj/item/weapon/ore/coal,
/obj/item/weapon/ore/verdantium,
/turf/simulated/floor/concrete,
/area/submap/crystalcore/dark/eight)
"j" = (
/mob/living/simple_mob/humanoid/eclipse/tropical/assasian,
/turf/simulated/floor/concrete,
/area/submap/crystalcore/dark/eight)
"k" = (
/obj/structure/closet/crate,
/obj/random/material,
/obj/random/material/refined,
/turf/simulated/floor/concrete,
/area/submap/crystalcore/dark/eight)
"o" = (
/obj/structure/closet/crate,
/obj/random/material,
/obj/random/material/refined,
/obj/item/weapon/reagent_containers/chem_disp_cartridge/imidazoline,
/turf/simulated/floor/concrete,
/area/submap/crystalcore/dark/eight)
"p" = (
/obj/structure/closet/crate,
/obj/random/material,
/obj/random/material/precious,
/turf/simulated/floor/concrete,
/area/submap/crystalcore/dark/eight)
"q" = (
/turf/template_noop,
/area/template_noop)
"r" = (
/turf/simulated/floor/concrete,
/area/submap/crystalcore/dark/eight)
"s" = (
/obj/structure/railing,
/obj/structure/table/steel,
/obj/item/weapon/ore/uranium,
/obj/item/weapon/ore/diamond,
/obj/item/weapon/ore/coal,
/obj/item/weapon/ore/phoron,
/turf/simulated/floor/concrete,
/area/submap/crystalcore/dark/eight)
"t" = (
/obj/structure/bed,
/obj/item/weapon/bedsheet,
/turf/simulated/floor/concrete,
/area/submap/crystalcore/dark/eight)
"u" = (
/turf/simulated/floor/outdoors/crystal_planet/darksand,
/area/submap/crystalcore/dark/eight)
"w" = (
/obj/structure/railing,
/obj/structure/table/steel,
/obj/item/weapon/ore/iron,
/obj/item/weapon/ore/diamond,
/turf/simulated/floor/concrete,
/area/submap/crystalcore/dark/eight)
"x" = (
/obj/structure/railing,
/obj/structure/table/steel,
/obj/item/weapon/ore/silver,
/obj/item/weapon/ore/gold,
/obj/item/weapon/ore/phoron,
/turf/simulated/floor/concrete,
/area/submap/crystalcore/dark/eight)
"y" = (
/obj/structure/railing,
/obj/structure/table/steel,
/obj/item/weapon/ore/iron,
/obj/item/weapon/paper{
	info = "Ores have been bountiful, as well as ore worms, letting out gather resources very quickly.";
	name = "Research Notes"
	},
/turf/simulated/floor/concrete,
/area/submap/crystalcore/dark/eight)
"E" = (
/obj/machinery/door/airlock/silver,
/turf/template_noop,
/area/submap/crystalcore/dark/eight)
"I" = (
/obj/machinery/mining/drill/loaded,
/turf/simulated/floor/concrete,
/area/submap/crystalcore/dark/eight)
"K" = (
/turf/simulated/floor/lava,
/area/submap/crystalcore/dark/eight)
"L" = (
/obj/structure/railing,
/obj/structure/table/steel,
/obj/item/weapon/ore/silver,
/obj/item/weapon/ore/iron,
/obj/item/weapon/ore/verdantium,
/turf/simulated/floor/concrete,
/area/submap/crystalcore/dark/eight)
"N" = (
/obj/machinery/mining/brace,
/turf/simulated/floor/concrete,
/area/submap/crystalcore/dark/eight)
"O" = (
/obj/machinery/door/airlock/silver,
/turf/simulated/floor/concrete,
/area/submap/crystalcore/dark/eight)
"Q" = (
/obj/structure/railing,
/obj/structure/table/steel,
/obj/item/weapon/ore/hydrogen,
/obj/item/weapon/ore/gold,
/obj/item/weapon/ore/phoron,
/turf/simulated/floor/concrete,
/area/submap/crystalcore/dark/eight)
"R" = (
/obj/structure/railing,
/obj/structure/table/steel,
/obj/item/weapon/ore/uranium,
/obj/item/weapon/ore/diamond,
/turf/simulated/floor/concrete,
/area/submap/crystalcore/dark/eight)
"S" = (
/mob/living/simple_mob/humanoid/eclipse/tropical/diver,
/turf/simulated/floor/concrete,
/area/submap/crystalcore/dark/eight)
"T" = (
/turf/simulated/wall/concrete,
/area/submap/crystalcore/dark/eight)
"U" = (
/obj/structure/railing,
/obj/structure/table/steel,
/obj/item/weapon/ore/silver,
/obj/item/weapon/ore/hydrogen,
/obj/item/weapon/ore/gold,
/obj/item/weapon/ore/verdantium,
/turf/simulated/floor/concrete,
/area/submap/crystalcore/dark/eight)
"W" = (
/obj/structure/railing,
/obj/structure/table/steel,
/obj/item/weapon/ore/hydrogen,
/obj/item/weapon/ore/coal,
/turf/simulated/floor/concrete,
/area/submap/crystalcore/dark/eight)
"X" = (
/mob/living/simple_mob/humanoid/eclipse/tropical/driller,
/turf/simulated/floor/concrete,
/area/submap/crystalcore/dark/eight)
"Y" = (
/obj/structure/closet/crate,
/obj/random/material,
/obj/random/material/refined,
/obj/item/weapon/reagent_containers/chem_disp_cartridge/doctorsdelight,
/turf/simulated/floor/concrete,
/area/submap/crystalcore/dark/eight)
"Z" = (
/mob/living/simple_mob/humanoid/eclipse/tropical/tiderhunter,
/turf/simulated/floor/concrete,
/area/submap/crystalcore/dark/eight)

(1,1,1) = {"
q
q
q
q
q
q
q
q
q
q
q
q
q
q
q
q
q
q
q
q
q
q
q
q
q
q
q
q
q
q
"}
(2,1,1) = {"
q
a
a
a
a
a
a
a
a
a
a
a
a
a
a
a
a
a
a
a
a
a
a
a
a
a
a
a
a
q
"}
(3,1,1) = {"
q
a
a
a
a
a
a
a
a
a
a
a
a
a
a
a
a
a
a
a
a
a
a
a
a
a
a
a
a
q
"}
(4,1,1) = {"
q
a
a
a
a
a
a
a
a
a
a
a
a
T
T
T
T
T
T
T
T
T
T
T
T
a
a
a
a
q
"}
(5,1,1) = {"
q
a
a
a
a
a
a
a
a
a
a
a
a
T
t
t
t
t
t
t
t
t
t
t
T
a
a
a
a
q
"}
(6,1,1) = {"
q
a
a
a
a
a
a
a
a
a
a
a
a
T
r
r
Z
r
r
r
r
r
r
r
T
a
a
a
a
q
"}
(7,1,1) = {"
q
a
a
a
a
a
a
a
a
a
a
a
a
T
t
t
t
t
t
r
r
t
t
t
T
a
a
a
a
q
"}
(8,1,1) = {"
q
a
a
a
a
a
a
a
a
a
a
a
a
T
r
r
r
r
r
r
r
r
j
r
T
a
a
a
a
q
"}
(9,1,1) = {"
q
a
a
a
a
a
a
a
a
a
a
a
a
T
t
t
t
t
t
r
r
t
t
t
T
a
a
a
a
q
"}
(10,1,1) = {"
q
a
a
a
a
a
a
a
a
a
a
a
a
T
T
T
T
T
T
O
O
T
T
T
T
T
T
a
a
q
"}
(11,1,1) = {"
q
a
a
a
a
a
a
a
a
a
a
a
a
a
T
N
I
N
r
r
r
r
w
K
K
K
T
a
a
q
"}
(12,1,1) = {"
q
a
a
a
a
a
a
a
a
a
a
a
a
u
T
r
r
r
r
r
r
r
y
K
K
K
T
a
a
q
"}
(13,1,1) = {"
q
a
a
a
a
a
a
a
a
a
a
a
u
u
T
r
r
r
X
r
r
r
L
K
K
K
T
a
a
q
"}
(14,1,1) = {"
q
a
a
a
a
a
a
a
a
a
a
u
u
u
T
N
I
N
r
r
r
r
x
K
K
K
T
a
a
q
"}
(15,1,1) = {"
q
a
a
a
a
a
a
a
a
a
a
u
u
u
E
r
r
r
r
r
b
r
U
K
K
K
T
a
a
q
"}
(16,1,1) = {"
q
a
a
a
a
a
a
a
a
a
a
u
u
u
E
r
r
r
r
r
b
r
Q
K
K
K
T
a
a
q
"}
(17,1,1) = {"
q
a
a
a
a
a
a
a
a
a
a
u
u
u
T
N
I
N
r
r
r
r
W
K
K
K
T
a
a
q
"}
(18,1,1) = {"
q
a
a
a
a
a
a
a
a
a
a
a
u
u
T
r
r
r
X
r
r
r
f
K
K
K
T
a
a
q
"}
(19,1,1) = {"
q
a
a
a
a
a
a
a
a
a
a
a
a
u
T
r
r
r
r
r
r
r
s
K
K
K
T
a
a
q
"}
(20,1,1) = {"
q
a
a
a
a
a
a
a
a
a
a
a
a
a
T
N
I
N
r
r
r
r
R
K
K
K
T
a
a
q
"}
(21,1,1) = {"
q
a
a
a
a
a
a
a
a
a
a
a
a
T
T
T
T
T
T
O
O
T
T
T
T
T
T
a
a
q
"}
(22,1,1) = {"
q
a
a
a
a
a
a
a
a
a
a
a
a
T
k
r
o
r
k
r
r
k
r
k
T
a
a
a
a
q
"}
(23,1,1) = {"
q
a
a
a
a
a
a
a
a
a
a
a
a
T
r
r
r
r
r
r
r
S
r
r
T
a
a
a
a
q
"}
(24,1,1) = {"
q
a
a
a
a
a
a
a
a
a
a
a
a
T
p
r
p
r
p
r
r
p
r
p
T
a
a
a
a
q
"}
(25,1,1) = {"
q
a
a
a
a
a
a
a
a
a
a
a
a
T
r
r
r
r
S
r
r
r
r
r
T
a
a
a
a
q
"}
(26,1,1) = {"
q
a
a
a
a
a
a
a
a
a
a
a
a
T
k
r
k
r
k
r
r
k
r
Y
T
a
a
a
a
q
"}
(27,1,1) = {"
q
a
a
a
a
a
a
a
a
a
a
a
a
T
T
T
T
T
T
T
T
T
T
T
T
a
a
a
a
q
"}
(28,1,1) = {"
q
a
a
a
a
a
a
a
a
a
a
a
a
a
a
a
a
a
a
a
a
a
a
a
a
a
a
a
a
q
"}
(29,1,1) = {"
q
a
a
a
a
a
a
a
a
a
a
a
a
a
a
a
a
a
a
a
a
a
a
a
a
a
a
a
a
q
"}
(30,1,1) = {"
q
q
q
q
q
q
q
q
q
q
q
q
q
q
q
q
q
q
q
q
q
q
q
q
q
q
q
q
q
q
"}
