//MAP CONVERTED BY dmm2tgm.py THIS HEADER COMMENT PREVENTS RECONVERSION, DO NOT REMOVE
"a" = (
/turf/template_noop,
/area/submap/crystalcore/dark/eleven)
"d" = (
/obj/structure/alien/wall,
/turf/simulated/mineral/darkcrystal,
/area/submap/crystalcore/dark/eleven)
"f" = (
/obj/item/weapon/storage/vore_egg/xenomorph,
/obj/effect/alien/weeds,
/obj/item/organ/internal/immunehub/replicant,
/turf/simulated/floor/outdoors/crystal_planet/darksand,
/area/submap/crystalcore/dark/eleven)
"l" = (
/obj/effect/alien/weeds,
/turf/simulated/floor/outdoors/crystal_planet/darksand,
/area/submap/crystalcore/dark/eleven)
"m" = (
/turf/simulated/mineral/darkcrystal,
/area/submap/crystalcore/dark/eleven)
"r" = (
/obj/item/weapon/storage/vore_egg/xenomorph,
/obj/effect/alien/weeds,
/obj/item/organ/internal/kidneys/replicant,
/turf/simulated/floor/outdoors/crystal_planet/darksand,
/area/submap/crystalcore/dark/eleven)
"s" = (
/obj/effect/alien/weeds,
/mob/living/simple_mob/animal/space/alien/drone,
/turf/simulated/floor/outdoors/crystal_planet/darksand,
/area/submap/crystalcore/dark/eleven)
"v" = (
/obj/effect/alien/weeds/node,
/turf/simulated/floor/outdoors/crystal_planet/darksand,
/area/submap/crystalcore/dark/eleven)
"w" = (
/obj/item/weapon/storage/vore_egg/xenomorph,
/obj/effect/alien/weeds,
/obj/item/weapon/rig/hazard,
/turf/simulated/floor/outdoors/crystal_planet/darksand,
/area/submap/crystalcore/dark/eleven)
"A" = (
/turf/template_noop,
/area/template_noop)
"B" = (
/obj/item/weapon/storage/vore_egg/xenomorph,
/obj/effect/alien/weeds,
/obj/item/organ/internal/augment/armmounted/shoulder/blade,
/turf/simulated/floor/outdoors/crystal_planet/darksand,
/area/submap/crystalcore/dark/eleven)
"E" = (
/obj/effect/alien/weeds/node,
/mob/living/simple_mob/animal/space/alien/queen/empress,
/turf/simulated/floor/outdoors/crystal_planet/darksand,
/area/submap/crystalcore/dark/eleven)
"L" = (
/obj/item/weapon/storage/vore_egg/xenomorph,
/obj/effect/alien/weeds,
/obj/item/stolenpackage,
/turf/simulated/floor/outdoors/crystal_planet/darksand,
/area/submap/crystalcore/dark/eleven)
"O" = (
/obj/effect/alien/weeds,
/mob/living/simple_mob/animal/space/alien,
/turf/simulated/floor/outdoors/crystal_planet/darksand,
/area/submap/crystalcore/dark/eleven)
"V" = (
/obj/effect/alien/weeds,
/mob/living/simple_mob/animal/space/alien/sentinel/praetorian,
/turf/simulated/floor/outdoors/crystal_planet/darksand,
/area/submap/crystalcore/dark/eleven)

(1,1,1) = {"
A
A
A
A
A
A
A
A
A
A
A
A
A
A
A
A
A
A
A
A
A
A
A
A
A
A
A
A
A
A
"}
(2,1,1) = {"
A
a
a
a
a
a
a
a
a
a
a
a
a
a
a
a
a
a
a
a
a
a
a
a
a
a
a
a
a
A
"}
(3,1,1) = {"
A
a
a
a
a
a
a
a
m
m
m
a
a
a
a
a
a
a
a
a
a
a
a
a
a
a
a
a
a
A
"}
(4,1,1) = {"
A
a
a
a
a
a
m
m
m
m
m
m
a
a
a
a
a
a
a
a
a
a
a
a
a
a
a
a
a
A
"}
(5,1,1) = {"
A
a
a
a
a
m
m
m
d
d
d
a
a
a
a
a
a
a
a
a
a
a
a
a
a
a
a
a
a
A
"}
(6,1,1) = {"
A
a
a
a
m
m
d
d
d
l
l
l
a
a
a
a
a
a
a
a
a
a
a
a
a
a
a
a
a
A
"}
(7,1,1) = {"
A
a
a
m
m
d
d
l
l
s
l
l
l
a
a
a
a
a
a
a
a
a
a
a
a
a
a
a
a
A
"}
(8,1,1) = {"
A
a
a
m
d
d
l
l
l
l
s
l
l
d
m
m
m
m
a
a
a
a
a
a
a
a
a
a
a
A
"}
(9,1,1) = {"
A
a
m
d
d
l
l
l
l
l
l
d
d
d
m
m
m
m
m
m
a
a
a
a
a
a
a
a
a
A
"}
(10,1,1) = {"
A
m
m
d
l
l
l
O
l
l
d
d
d
d
d
d
d
m
m
m
m
a
a
a
a
a
a
a
a
A
"}
(11,1,1) = {"
A
m
d
d
l
l
v
l
d
d
d
d
d
r
w
B
d
d
m
m
m
m
m
a
a
a
a
a
a
A
"}
(12,1,1) = {"
A
m
d
l
l
l
l
l
d
m
m
d
L
l
l
l
l
d
d
m
m
m
m
a
a
a
a
a
a
A
"}
(13,1,1) = {"
A
m
d
l
l
l
l
d
d
m
m
d
f
l
l
l
l
l
d
d
m
m
m
m
a
a
a
a
a
A
"}
(14,1,1) = {"
A
m
d
l
l
l
l
d
m
m
m
d
w
l
l
E
l
V
l
d
d
m
m
m
m
a
a
a
a
A
"}
(15,1,1) = {"
A
m
d
l
l
l
l
d
m
m
m
d
d
l
l
l
l
l
l
l
d
d
m
m
m
m
a
a
a
A
"}
(16,1,1) = {"
A
m
d
l
l
l
s
d
d
m
m
m
d
l
l
V
l
l
l
l
l
d
d
m
m
m
a
a
a
A
"}
(17,1,1) = {"
A
m
d
l
l
l
l
l
d
d
m
m
d
d
l
l
l
l
l
l
l
l
d
m
m
m
m
a
a
A
"}
(18,1,1) = {"
A
m
d
s
l
d
d
l
l
d
m
m
m
d
d
d
l
l
l
d
d
l
d
d
m
m
m
a
a
A
"}
(19,1,1) = {"
A
m
d
d
l
d
d
d
l
d
d
m
m
m
m
d
d
l
d
d
d
l
l
d
m
m
m
a
a
A
"}
(20,1,1) = {"
A
m
m
d
l
l
d
d
l
l
d
d
m
m
m
m
d
l
d
d
d
d
l
d
m
m
m
a
a
A
"}
(21,1,1) = {"
A
m
m
d
d
l
l
l
l
O
l
d
d
m
m
d
d
s
l
d
d
d
l
d
m
m
m
a
a
A
"}
(22,1,1) = {"
A
m
m
m
d
d
d
l
l
v
l
l
d
d
d
d
l
l
l
d
d
l
l
d
m
m
m
a
a
A
"}
(23,1,1) = {"
A
a
m
m
m
m
d
d
l
l
l
l
O
l
l
l
l
l
l
l
l
O
d
d
m
m
a
a
a
A
"}
(24,1,1) = {"
A
a
a
m
m
m
m
d
d
l
l
l
d
d
d
l
l
v
l
l
l
d
d
m
m
m
a
a
a
A
"}
(25,1,1) = {"
A
a
a
m
m
m
m
m
d
d
l
s
d
d
d
l
l
l
l
l
d
d
m
m
m
m
a
a
a
A
"}
(26,1,1) = {"
A
a
a
a
m
m
m
m
m
d
d
l
l
l
l
l
l
d
d
d
d
m
m
m
m
a
a
a
a
A
"}
(27,1,1) = {"
A
a
a
a
a
m
m
m
m
m
d
d
d
d
d
d
d
d
m
m
m
m
m
m
a
a
a
a
a
A
"}
(28,1,1) = {"
A
a
a
a
a
a
a
m
m
m
m
m
m
m
m
m
m
m
m
m
m
m
m
a
a
a
a
a
a
A
"}
(29,1,1) = {"
A
a
a
a
a
a
a
a
a
m
m
m
m
m
m
m
m
m
m
m
m
m
a
a
a
a
a
a
a
A
"}
(30,1,1) = {"
A
A
A
A
A
A
A
A
A
A
A
A
A
A
A
A
A
A
A
A
A
A
A
A
A
A
A
A
A
A
"}
