//MAP CONVERTED BY dmm2tgm.py THIS HEADER COMMENT PREVENTS RECONVERSION, DO NOT REMOVE
"a" = (
/obj/effect/alien/weeds,
/turf/simulated/floor/outdoors/crystal_planet/darksand,
/area/submap/crystalcore/dark/fifteen)
"g" = (
/obj/effect/alien/weeds,
/mob/living/simple_mob/animal/space/alien/sentinel,
/turf/simulated/floor/outdoors/crystal_planet/darksand,
/area/submap/crystalcore/dark/fifteen)
"m" = (
/obj/structure/alien/wall,
/turf/template_noop,
/area/submap/crystalcore/dark/fifteen)
"r" = (
/turf/template_noop,
/area/submap/crystalcore/dark/fifteen)
"B" = (
/obj/effect/alien/weeds,
/mob/living/simple_mob/animal/space/alien/sentinel/praetorian,
/turf/simulated/floor/outdoors/crystal_planet/darksand,
/area/submap/crystalcore/dark/fifteen)
"C" = (
/obj/effect/alien/weeds,
/mob/living/simple_mob/animal/space/alien/queen/empress,
/turf/simulated/floor/outdoors/crystal_planet/darksand,
/area/submap/crystalcore/dark/fifteen)
"F" = (
/obj/item/weapon/storage/vore_egg/xenomorph,
/obj/item/weapon/rig/hazard,
/obj/effect/alien/weeds,
/turf/simulated/floor/outdoors/crystal_planet/darksand,
/area/submap/crystalcore/dark/fifteen)
"I" = (
/obj/structure/alien/wall,
/turf/simulated/floor/outdoors/crystal_planet/darksand,
/area/submap/crystalcore/dark/fifteen)
"K" = (
/turf/template_noop,
/area/template_noop)
"P" = (
/obj/effect/alien/weeds,
/mob/living/simple_mob/animal/space/alien/drone,
/turf/simulated/floor/outdoors/crystal_planet/darksand,
/area/submap/crystalcore/dark/fifteen)
"T" = (
/obj/item/weapon/storage/vore_egg/xenomorph,
/obj/item/organ/internal/augment/armmounted/dartbow,
/obj/effect/alien/weeds,
/turf/simulated/floor/outdoors/crystal_planet/darksand,
/area/submap/crystalcore/dark/fifteen)
"U" = (
/obj/item/weapon/storage/vore_egg/xenomorph,
/obj/item/organ/internal/augment/armmounted/shoulder/multiple/medical,
/obj/effect/alien/weeds,
/turf/simulated/floor/outdoors/crystal_planet/darksand,
/area/submap/crystalcore/dark/fifteen)

(1,1,1) = {"
K
K
K
K
K
K
K
K
K
K
K
K
K
K
K
K
K
K
K
K
K
K
K
K
K
K
K
K
K
K
"}
(2,1,1) = {"
K
r
r
r
r
r
m
m
m
m
m
m
m
m
m
m
m
m
r
r
r
r
r
r
r
r
r
r
r
K
"}
(3,1,1) = {"
K
r
r
r
r
m
m
a
a
a
m
m
a
a
a
a
a
m
m
m
r
r
r
r
r
r
r
r
r
K
"}
(4,1,1) = {"
K
r
r
r
m
m
g
a
a
a
a
a
a
I
I
a
a
a
a
m
m
r
r
r
r
r
r
r
r
K
"}
(5,1,1) = {"
K
r
r
m
m
a
a
I
a
a
a
a
I
I
I
I
a
a
a
a
m
r
r
r
r
r
r
r
r
K
"}
(6,1,1) = {"
K
r
r
m
a
a
I
I
a
a
m
a
a
a
a
I
I
a
a
a
m
m
r
r
r
r
r
r
r
K
"}
(7,1,1) = {"
K
r
m
m
a
a
a
a
P
m
m
m
m
m
a
a
a
a
a
B
a
m
r
r
r
r
r
r
r
K
"}
(8,1,1) = {"
K
m
m
a
a
a
a
a
m
m
r
r
r
m
m
a
a
a
a
a
a
m
m
r
r
r
r
r
r
K
"}
(9,1,1) = {"
K
m
a
a
a
I
I
a
m
r
r
r
r
r
m
m
a
C
a
a
a
F
m
r
r
r
r
r
r
K
"}
(10,1,1) = {"
K
m
a
a
I
I
I
a
m
r
r
r
r
r
r
m
m
a
a
a
a
U
m
r
r
r
r
r
r
K
"}
(11,1,1) = {"
K
m
a
a
I
I
a
a
m
m
m
r
r
r
r
r
m
m
a
a
a
m
m
r
r
r
r
r
r
K
"}
(12,1,1) = {"
K
m
m
g
a
a
a
a
a
a
m
m
m
r
r
r
r
m
m
m
m
m
r
r
r
r
r
r
r
K
"}
(13,1,1) = {"
K
r
m
a
a
a
a
a
a
g
a
a
m
m
m
m
r
r
r
r
r
r
r
r
r
r
r
r
r
K
"}
(14,1,1) = {"
K
r
m
m
a
a
a
I
I
a
a
a
a
a
a
m
r
r
r
r
r
r
r
r
r
r
r
r
r
K
"}
(15,1,1) = {"
K
r
r
m
m
a
I
I
I
I
a
a
a
a
a
a
r
r
r
r
r
r
r
r
r
r
r
r
r
K
"}
(16,1,1) = {"
K
r
r
m
m
a
a
I
I
a
a
a
a
a
a
a
r
r
r
r
r
r
r
r
r
r
r
r
r
K
"}
(17,1,1) = {"
K
r
m
m
a
a
a
a
a
g
a
a
a
a
a
m
r
r
r
r
r
r
r
r
r
r
r
r
r
K
"}
(18,1,1) = {"
K
r
m
a
P
a
I
a
a
a
m
m
m
m
m
m
r
m
m
m
m
r
r
r
r
r
r
r
r
K
"}
(19,1,1) = {"
K
r
m
a
a
I
I
a
a
m
m
r
r
r
r
r
m
m
a
a
m
m
r
r
r
r
r
r
r
K
"}
(20,1,1) = {"
K
r
m
a
a
I
I
a
a
m
r
r
r
r
r
m
m
a
B
a
a
m
m
r
r
r
r
r
r
K
"}
(21,1,1) = {"
K
r
m
a
a
I
a
a
a
m
r
r
r
r
m
m
a
a
a
a
a
T
m
r
r
r
r
r
r
K
"}
(22,1,1) = {"
K
r
m
m
a
a
a
a
P
m
m
r
r
m
m
a
a
a
a
a
C
F
m
r
r
r
r
r
r
K
"}
(23,1,1) = {"
K
r
r
m
a
a
a
I
a
a
m
m
m
m
a
a
a
a
a
a
a
m
m
r
r
r
r
r
r
K
"}
(24,1,1) = {"
K
r
r
m
a
a
I
I
a
a
a
m
m
a
a
a
I
I
a
a
a
m
r
r
r
r
r
r
r
K
"}
(25,1,1) = {"
K
r
r
m
m
g
a
I
I
a
a
a
g
a
a
I
I
a
a
a
m
m
r
r
r
r
r
r
r
K
"}
(26,1,1) = {"
K
r
r
r
m
m
a
a
a
I
a
a
a
a
I
I
a
a
a
m
m
r
r
r
r
r
r
r
r
K
"}
(27,1,1) = {"
K
r
r
r
r
m
m
a
a
a
a
P
a
a
a
a
a
a
m
m
r
r
r
r
r
r
r
r
r
K
"}
(28,1,1) = {"
K
r
r
r
r
r
m
m
a
a
m
m
a
a
a
a
m
m
m
r
r
r
r
r
r
r
r
r
r
K
"}
(29,1,1) = {"
K
r
r
r
r
r
r
m
m
m
m
m
m
m
m
m
m
r
r
r
r
r
r
r
r
r
r
r
r
K
"}
(30,1,1) = {"
K
K
K
K
K
K
K
K
K
K
K
K
K
K
K
K
K
K
K
K
K
K
K
K
K
K
K
K
K
K
"}
