//MAP CONVERTED BY dmm2tgm.py THIS HEADER COMMENT PREVENTS RECONVERSION, DO NOT REMOVE
"a" = (
/turf/simulated/floor/flock,
/area/submap/crystalcore/dark/five)
"i" = (
/obj/structure/loot_pile/surface/alien/end,
/turf/simulated/floor/flock,
/area/submap/crystalcore/dark/five)
"o" = (
/turf/simulated/shuttle/wall/flock,
/area/submap/crystalcore/dark/five)
"z" = (
/obj/effect/forcefield/mime,
/turf/simulated/floor/flock,
/area/submap/crystalcore/dark/five)
"C" = (
/turf/template_noop,
/area/template_noop)
"N" = (
/obj/structure/simple_door/flock,
/turf/simulated/floor/flock,
/area/submap/crystalcore/dark/five)

(1,1,1) = {"
C
C
C
C
C
C
C
C
C
C
C
C
C
C
C
C
C
C
C
C
C
C
C
C
C
C
C
C
C
C
"}
(2,1,1) = {"
C
o
o
N
o
o
o
o
o
o
o
o
o
o
o
o
o
o
o
o
o
o
o
o
o
o
N
o
o
C
"}
(3,1,1) = {"
C
o
a
a
a
a
a
a
z
a
z
a
a
a
a
a
z
a
a
a
a
a
z
a
a
a
a
a
o
C
"}
(4,1,1) = {"
C
N
a
z
a
z
z
a
z
a
a
a
z
a
z
a
z
a
z
a
z
z
a
a
z
a
z
a
N
C
"}
(5,1,1) = {"
C
o
a
z
a
a
a
a
z
z
z
a
a
z
z
a
z
a
z
a
a
a
z
a
a
a
a
a
o
C
"}
(6,1,1) = {"
C
o
a
z
a
z
a
a
a
a
a
a
z
a
a
a
a
a
z
a
z
a
a
a
z
z
z
z
o
C
"}
(7,1,1) = {"
C
o
a
z
a
z
z
a
z
z
a
z
z
a
z
z
a
z
a
a
z
a
z
a
a
a
a
a
o
C
"}
(8,1,1) = {"
C
o
a
z
a
z
a
a
a
a
a
a
a
a
a
a
a
a
z
z
a
a
z
z
z
a
z
a
o
C
"}
(9,1,1) = {"
C
o
a
a
a
a
a
z
z
a
z
a
z
z
z
z
z
a
z
a
a
a
a
a
a
z
a
a
o
C
"}
(10,1,1) = {"
C
o
z
z
z
z
a
a
a
a
z
a
a
z
a
a
a
a
z
a
z
a
z
a
a
z
a
z
o
C
"}
(11,1,1) = {"
C
o
a
a
a
a
z
z
a
z
z
z
a
a
a
z
z
z
z
a
z
z
z
z
a
a
a
a
o
C
"}
(12,1,1) = {"
C
o
a
z
z
a
a
a
a
a
a
a
a
z
a
a
a
a
a
a
a
z
a
a
a
z
z
z
o
C
"}
(13,1,1) = {"
C
o
a
z
a
a
z
a
z
z
z
a
z
z
z
a
z
z
z
z
a
a
a
z
a
a
a
a
o
C
"}
(14,1,1) = {"
C
o
a
z
a
z
z
a
a
a
a
a
a
z
i
z
a
a
a
z
z
z
a
z
z
a
z
a
o
C
"}
(15,1,1) = {"
C
o
a
z
a
a
z
z
z
z
a
z
a
a
a
i
z
z
a
a
a
a
a
z
a
a
z
a
o
C
"}
(16,1,1) = {"
C
o
a
z
a
a
a
a
a
a
a
z
a
z
i
z
a
a
z
z
a
z
z
z
z
z
z
a
o
C
"}
(17,1,1) = {"
C
o
a
a
z
z
a
z
z
z
a
z
a
a
z
a
z
a
a
a
a
a
a
a
a
a
a
a
o
C
"}
(18,1,1) = {"
C
o
z
a
a
a
z
a
a
a
a
a
z
a
z
a
a
z
a
z
z
a
z
z
z
z
z
a
o
C
"}
(19,1,1) = {"
C
o
z
z
a
z
z
a
z
z
a
a
a
a
a
z
a
a
a
a
a
a
a
a
a
a
z
a
o
C
"}
(20,1,1) = {"
C
o
a
a
a
z
a
a
z
a
a
a
z
z
a
z
a
z
z
z
z
z
z
a
z
a
z
a
o
C
"}
(21,1,1) = {"
C
o
a
z
a
z
z
a
z
a
z
a
z
a
a
a
a
z
a
a
a
a
a
z
z
a
a
a
o
C
"}
(22,1,1) = {"
C
o
z
z
a
z
a
a
a
a
z
a
a
a
z
z
a
z
a
z
z
a
z
a
z
z
z
a
o
C
"}
(23,1,1) = {"
C
o
a
a
a
a
z
z
a
z
z
a
z
a
z
a
a
a
z
a
z
a
z
a
a
a
a
a
o
C
"}
(24,1,1) = {"
C
o
a
z
z
a
a
a
a
a
a
a
z
a
a
a
z
a
z
a
a
a
z
z
z
z
z
a
o
C
"}
(25,1,1) = {"
C
o
a
a
z
z
a
z
a
z
a
z
a
z
a
z
z
a
a
a
z
a
z
a
a
a
z
a
o
C
"}
(26,1,1) = {"
C
o
z
a
z
a
a
z
a
z
z
a
a
a
a
a
a
a
z
a
a
a
a
a
z
a
a
a
o
C
"}
(27,1,1) = {"
C
N
a
a
z
z
z
z
a
z
a
a
z
z
a
z
z
a
a
a
z
z
z
z
z
a
z
a
N
C
"}
(28,1,1) = {"
C
o
z
a
a
a
a
a
a
z
a
z
a
a
a
a
a
a
z
a
a
a
a
a
a
a
a
a
o
C
"}
(29,1,1) = {"
C
o
o
N
o
o
o
o
o
o
o
o
o
o
o
o
o
o
o
o
o
o
o
o
o
o
N
o
o
C
"}
(30,1,1) = {"
C
C
C
C
C
C
C
C
C
C
C
C
C
C
C
C
C
C
C
C
C
C
C
C
C
C
C
C
C
C
"}
