//MAP CONVERTED BY dmm2tgm.py THIS HEADER COMMENT PREVENTS RECONVERSION, DO NOT REMOVE
"a" = (
/turf/simulated/floor/outdoors/crystal_planet/darksand,
/area/submap/crystalcore/dark/four)
"f" = (
/turf/simulated/shuttle/wall,
/area/submap/crystalcore/dark/four)
"i" = (
/turf/simulated/shuttle/floor,
/area/submap/crystalcore/dark/four)
"k" = (
/obj/machinery/door/airlock/external/bolted,
/turf/simulated/shuttle/floor,
/area/submap/crystalcore/dark/four)
"l" = (
/turf/template_noop,
/area/submap/crystalcore/dark/four)
"n" = (
/turf/simulated/shuttle/floor/white,
/area/submap/crystalcore/dark/four)
"H" = (
/turf/template_noop,
/area/template_noop)
"O" = (
/obj/structure/window/reinforced{
	dir = 8
	},
/obj/structure/bed/chair/bay{
	dir = 4
	},
/turf/simulated/shuttle/floor/white,
/area/submap/crystalcore/dark/four)
"Q" = (
/obj/structure/ghost_pod/manual/corgi,
/turf/simulated/shuttle/floor,
/area/submap/crystalcore/dark/four)

(1,1,1) = {"
H
H
H
H
H
H
H
H
H
H
H
H
H
H
H
H
H
H
H
H
H
H
H
H
H
H
H
H
H
H
"}
(2,1,1) = {"
H
l
l
l
a
a
a
a
a
a
a
a
a
a
a
a
a
a
a
a
a
a
a
a
a
a
a
l
l
H
"}
(3,1,1) = {"
H
l
l
l
a
a
a
a
a
a
a
a
a
a
a
a
a
a
a
a
a
a
a
a
a
a
l
l
l
H
"}
(4,1,1) = {"
H
l
l
l
l
a
a
a
a
a
a
a
a
a
a
a
a
a
a
a
a
a
a
a
a
l
l
l
l
H
"}
(5,1,1) = {"
H
l
l
l
l
a
a
a
a
a
a
a
a
a
a
a
a
a
a
a
a
a
a
a
a
l
l
l
l
H
"}
(6,1,1) = {"
H
l
l
l
l
l
a
a
a
a
a
a
a
a
a
a
a
a
a
a
a
a
a
a
l
l
l
l
l
H
"}
(7,1,1) = {"
H
l
l
l
l
l
a
a
a
a
a
a
a
a
a
a
a
a
a
a
a
a
a
l
l
l
l
l
l
H
"}
(8,1,1) = {"
H
l
l
l
l
l
a
a
a
a
a
a
a
a
a
a
a
a
a
a
a
a
a
l
l
l
l
l
l
H
"}
(9,1,1) = {"
H
l
l
l
l
l
l
a
a
a
a
a
a
a
a
a
a
a
a
a
a
a
a
l
l
l
l
l
l
H
"}
(10,1,1) = {"
H
l
l
l
l
l
l
a
a
a
a
a
a
a
a
a
a
a
a
a
a
a
l
l
l
l
l
l
l
H
"}
(11,1,1) = {"
H
l
l
l
l
l
l
a
a
a
a
a
a
a
a
a
a
a
a
a
a
a
l
l
l
l
l
l
l
H
"}
(12,1,1) = {"
H
l
l
l
l
l
l
a
a
a
a
a
a
a
a
a
a
a
a
a
a
l
l
l
l
l
l
l
l
H
"}
(13,1,1) = {"
H
l
l
l
l
l
l
a
a
a
a
a
a
a
a
a
a
a
a
a
a
l
l
l
l
l
l
l
l
H
"}
(14,1,1) = {"
H
l
l
l
l
l
l
l
a
a
a
a
a
a
a
a
a
a
a
a
a
l
l
l
l
l
l
l
l
H
"}
(15,1,1) = {"
H
l
l
l
l
l
l
l
a
a
a
a
a
a
a
a
a
a
a
a
a
l
l
l
l
l
l
l
l
H
"}
(16,1,1) = {"
H
l
l
l
l
l
l
l
l
f
f
f
f
f
k
f
f
f
f
f
l
l
l
l
l
l
l
l
l
H
"}
(17,1,1) = {"
H
l
l
l
l
l
l
l
l
f
O
O
O
i
i
i
O
O
O
f
l
l
l
l
l
l
l
l
l
H
"}
(18,1,1) = {"
H
l
l
l
l
l
l
l
l
f
n
n
n
i
i
i
n
n
n
f
l
l
l
l
l
l
l
l
l
H
"}
(19,1,1) = {"
H
l
l
l
l
l
l
l
l
f
O
O
O
i
i
i
O
O
O
f
l
l
l
l
l
l
l
l
l
H
"}
(20,1,1) = {"
H
l
l
l
l
l
l
l
l
f
n
n
n
i
i
i
n
n
n
f
l
l
l
l
l
l
l
l
l
H
"}
(21,1,1) = {"
H
l
l
l
l
l
l
l
l
f
O
O
O
i
i
i
O
O
O
f
l
l
l
l
l
l
l
l
l
H
"}
(22,1,1) = {"
H
l
l
l
l
l
l
l
l
f
n
n
n
i
i
i
n
n
n
f
l
l
l
l
l
l
l
l
l
H
"}
(23,1,1) = {"
H
l
l
l
l
l
l
l
l
f
O
O
O
i
i
i
O
O
O
f
l
l
l
l
l
l
l
l
l
H
"}
(24,1,1) = {"
H
l
l
l
l
l
l
l
l
f
n
n
n
i
i
i
n
n
n
f
l
l
l
l
l
l
l
l
l
H
"}
(25,1,1) = {"
H
l
l
l
l
l
l
l
l
f
O
O
O
i
i
i
O
O
O
f
l
l
l
l
l
l
l
l
l
H
"}
(26,1,1) = {"
H
l
l
l
l
l
l
l
l
f
n
n
n
i
i
i
n
n
n
f
l
l
l
l
l
l
l
l
l
H
"}
(27,1,1) = {"
H
l
l
l
l
l
l
l
l
f
f
n
n
i
Q
i
n
n
f
f
l
l
l
l
l
l
l
l
l
H
"}
(28,1,1) = {"
H
l
l
l
l
l
l
l
l
l
f
f
n
i
i
i
n
f
f
l
l
l
l
l
l
l
l
l
l
H
"}
(29,1,1) = {"
H
l
l
l
l
l
l
l
l
l
l
f
f
f
f
f
f
f
l
l
l
l
l
l
l
l
l
l
l
H
"}
(30,1,1) = {"
H
H
H
H
H
H
H
H
H
H
H
H
H
H
H
H
H
H
H
H
H
H
H
H
H
H
H
H
H
H
"}
