//MAP CONVERTED BY dmm2tgm.py THIS HEADER COMMENT PREVENTS RECONVERSION, DO NOT REMOVE
"a" = (
/turf/template_noop,
/area/submap/crystalcore/dark/lorearea_four)
"b" = (
/obj/structure/table/woodentable,
/turf/simulated/floor/tiled/old_tile/white,
/area/submap/crystalcore/dark/lorearea_four)
"f" = (
/turf/template_noop,
/area/template_noop)
"n" = (
/obj/item/weapon/bedsheet,
/obj/structure/bed,
/turf/simulated/floor/tiled/old_tile/white,
/area/submap/crystalcore/dark/lorearea_four)
"t" = (
/turf/simulated/floor/tiled/old_tile/blue,
/area/submap/crystalcore/dark/lorearea_four)
"u" = (
/obj/structure/table/woodentable,
/obj/item/weapon/paper{
	info = "Oh you look fun. Remind me to play with you sometime.";
	name = "Heya"
	},
/turf/simulated/floor/tiled/old_tile/white,
/area/submap/crystalcore/dark/lorearea_four)
"w" = (
/obj/structure/closet/wardrobe,
/obj/random/maintenance/cargo,
/obj/random/maintenance/engineering,
/obj/random/maintenance/medical,
/obj/random/maintenance/research,
/obj/random/maintenance/security,
/obj/item/weapon/paper{
	info = "We have one beyond the stars. We are no longer deep beneath our sea, but something further. Something so divine! Sparkling crystaline beauty. A crystaline coean, all ours to discovered! The others see fear, and horror. They call me crazy. But they shall see when we venture further within to it's waiting grasp.";
	name = "Note"
	},
/turf/simulated/floor/tiled/old_tile/white,
/area/submap/crystalcore/dark/lorearea_four)
"z" = (
/obj/machinery/door/airlock,
/turf/simulated/floor/tiled/old_tile/blue,
/area/submap/crystalcore/dark/lorearea_four)
"A" = (
/turf/simulated/floor/tiled/old_tile/white,
/area/submap/crystalcore/dark/lorearea_four)
"B" = (
/turf/simulated/wall/rplastitanium,
/area/submap/crystalcore/dark/lorearea_four)
"E" = (
/obj/structure/closet/wardrobe,
/obj/random/maintenance/cargo,
/obj/random/maintenance/engineering,
/obj/random/maintenance/medical,
/obj/random/maintenance/research,
/obj/random/maintenance/security,
/turf/simulated/floor/tiled/old_tile/white,
/area/submap/crystalcore/dark/lorearea_four)
"F" = (
/obj/structure/closet/wardrobe,
/obj/random/maintenance/cargo,
/obj/random/maintenance/engineering,
/obj/random/maintenance/medical,
/obj/random/maintenance/research,
/obj/random/maintenance/security,
/obj/item/prop/datadisc/powerstorage,
/turf/simulated/floor/tiled/old_tile/white,
/area/submap/crystalcore/dark/lorearea_four)
"X" = (
/obj/structure/closet/wardrobe,
/obj/random/maintenance/cargo,
/obj/random/maintenance/engineering,
/obj/random/maintenance/medical,
/obj/random/maintenance/research,
/obj/random/maintenance/security,
/obj/item/weapon/paper{
	info = "Our crew is dropping like flies. Either becoming insane, 'accidents', or just vanishing. Me and some others are trying to gather whatever supplies we can and hoping to escape on one of the minature subs. We recocken we can scournge barrely enough power and resources to get back up. But if we don't, and you are seeing this. Leave, go home, before you fall in as well.";
	name = "Note"
	},
/turf/simulated/floor/tiled/old_tile/white,
/area/submap/crystalcore/dark/lorearea_four)

(1,1,1) = {"
f
f
f
f
f
f
f
f
f
f
f
f
f
f
f
f
f
f
f
f
f
f
f
f
f
f
f
f
f
f
"}
(2,1,1) = {"
f
a
a
a
a
a
a
a
a
a
a
a
a
a
a
a
a
a
a
a
a
a
a
a
a
a
a
a
a
f
"}
(3,1,1) = {"
f
a
a
a
a
a
a
a
a
B
B
B
B
B
B
z
z
B
B
B
B
B
B
a
a
a
a
a
a
f
"}
(4,1,1) = {"
f
a
a
a
a
a
a
a
a
B
n
b
A
A
z
t
t
z
A
A
b
n
B
a
a
a
a
a
a
f
"}
(5,1,1) = {"
f
a
a
a
a
a
a
a
a
B
A
b
A
A
B
t
t
B
A
A
b
A
B
a
a
a
a
a
a
f
"}
(6,1,1) = {"
f
a
a
a
a
a
a
a
a
B
A
A
A
A
B
t
t
B
A
A
A
A
B
a
a
a
a
a
a
f
"}
(7,1,1) = {"
f
a
a
a
a
a
a
a
a
B
A
A
A
E
B
t
t
B
w
A
A
A
B
a
a
a
a
a
a
f
"}
(8,1,1) = {"
f
a
a
a
a
a
a
a
a
B
B
B
B
B
B
t
t
B
B
B
B
B
B
a
a
a
a
a
a
f
"}
(9,1,1) = {"
f
a
a
a
a
a
a
a
a
B
n
b
A
A
z
t
t
z
A
A
b
n
B
a
a
a
a
a
a
f
"}
(10,1,1) = {"
f
a
a
a
a
a
a
a
a
B
A
u
A
A
B
t
t
B
A
A
b
A
B
a
a
a
a
a
a
f
"}
(11,1,1) = {"
f
a
a
a
a
a
a
a
a
B
A
A
A
A
B
t
t
B
A
A
A
A
B
a
a
a
a
a
a
f
"}
(12,1,1) = {"
f
a
a
a
a
a
a
a
a
B
A
A
A
E
B
t
t
B
E
A
A
A
B
a
a
a
a
a
a
f
"}
(13,1,1) = {"
f
a
a
a
a
a
a
a
a
B
B
B
B
B
B
t
t
B
B
B
B
B
B
a
a
a
a
a
a
f
"}
(14,1,1) = {"
f
a
a
a
a
a
a
a
a
B
n
b
A
A
z
t
t
z
A
A
b
n
B
a
a
a
a
a
a
f
"}
(15,1,1) = {"
f
a
a
a
a
a
a
a
a
B
A
b
A
A
B
t
t
B
A
A
b
A
B
a
a
a
a
a
a
f
"}
(16,1,1) = {"
f
a
a
a
a
a
a
a
a
B
A
A
A
A
B
t
t
B
A
A
A
A
B
a
a
a
a
a
a
f
"}
(17,1,1) = {"
f
a
a
a
a
a
a
a
a
B
A
A
A
E
B
t
t
B
F
A
A
A
B
a
a
a
a
a
a
f
"}
(18,1,1) = {"
f
a
a
a
a
a
a
a
a
B
B
B
B
B
B
t
t
B
B
B
B
B
B
a
a
a
a
a
a
f
"}
(19,1,1) = {"
f
a
a
a
a
a
a
a
a
B
n
b
A
A
z
t
t
z
A
A
b
n
B
a
a
a
a
a
a
f
"}
(20,1,1) = {"
f
a
a
a
a
a
a
a
a
B
A
b
A
A
B
t
t
B
A
A
b
A
B
a
a
a
a
a
a
f
"}
(21,1,1) = {"
f
a
a
a
a
a
a
a
a
B
A
A
A
A
B
t
t
B
A
A
A
A
B
a
a
a
a
a
a
f
"}
(22,1,1) = {"
f
a
a
a
a
a
a
a
a
B
A
A
A
X
B
t
t
B
E
A
A
A
B
a
a
a
a
a
a
f
"}
(23,1,1) = {"
f
a
a
a
a
a
a
a
a
B
B
B
B
B
B
t
t
B
B
B
B
B
B
a
a
a
a
a
a
f
"}
(24,1,1) = {"
f
a
a
a
a
a
a
a
a
B
n
b
A
A
z
t
t
z
A
A
b
n
B
a
a
a
a
a
a
f
"}
(25,1,1) = {"
f
a
a
a
a
a
a
a
a
B
A
b
A
A
B
t
t
B
A
A
b
A
B
a
a
a
a
a
a
f
"}
(26,1,1) = {"
f
a
a
a
a
a
a
a
a
B
A
A
A
A
B
t
t
B
A
A
A
A
B
a
a
a
a
a
a
f
"}
(27,1,1) = {"
f
a
a
a
a
a
a
a
a
B
A
A
A
E
B
t
t
B
E
A
A
A
B
a
a
a
a
a
a
f
"}
(28,1,1) = {"
f
a
a
a
a
a
a
a
a
B
B
B
B
B
B
z
z
B
B
B
B
B
B
a
a
a
a
a
a
f
"}
(29,1,1) = {"
f
a
a
a
a
a
a
a
a
a
a
a
a
a
a
a
a
a
a
a
a
a
a
a
a
a
a
a
a
f
"}
(30,1,1) = {"
f
f
f
f
f
f
f
f
f
f
f
f
f
f
f
f
f
f
f
f
f
f
f
f
f
f
f
f
f
f
"}
