//MAP CONVERTED BY dmm2tgm.py THIS HEADER COMMENT PREVENTS RECONVERSION, DO NOT REMOVE
"a" = (
/turf/template_noop,
/area/submap/crystalcore/dark/lorearea_three)
"b" = (
/obj/structure/table/reinforced,
/obj/item/prop/datadisc/bluespace,
/turf/simulated/floor/tiled/old_tile/purple,
/area/submap/crystalcore/dark/lorearea_three)
"c" = (
/obj/machinery/door/airlock,
/turf/simulated/floor/tiled/old_tile/purple,
/area/submap/crystalcore/dark/lorearea_three)
"d" = (
/obj/structure/table/reinforced,
/obj/random/material,
/obj/random/material,
/turf/simulated/floor/tiled/old_tile/purple,
/area/submap/crystalcore/dark/lorearea_three)
"e" = (
/obj/machinery/r_n_d/circuit_imprinter,
/obj/structure/window/plastitanium,
/turf/simulated/floor/tiled/old_tile/purple,
/area/submap/crystalcore/dark/lorearea_three)
"g" = (
/obj/machinery/robotic_fabricator,
/obj/structure/window/plastitanium{
	dir = 4
	},
/obj/structure/window/plastitanium{
	dir = 1
	},
/turf/simulated/floor/tiled/old_tile/purple,
/area/submap/crystalcore/dark/lorearea_three)
"j" = (
/obj/structure/table/reinforced,
/obj/item/weapon/paper{
	info = "This weighs heavy on my mind. Each passing hour, things begin to look bleaker, but the captain refuses to turn back, and well, I don't blame them. Death by unfound horrors, or death by the company up above. But I wish we were honest with the rest of the crew. Our depth keeps jumping vastly, varying or just being not possible. From 20k to 300, then down to 15, and oh hear is an apaprent 250. Something is screwing with our equipment, and I hear the hull creaking. I just hope whatever is out there takes me sooner rather then later.";
	name = "Research Notes"
	},
/turf/simulated/floor/tiled/old_tile/purple,
/area/submap/crystalcore/dark/lorearea_three)
"l" = (
/obj/machinery/autolathe,
/obj/structure/window/plastitanium{
	dir = 1
	},
/turf/simulated/floor/tiled/old_tile/purple,
/area/submap/crystalcore/dark/lorearea_three)
"p" = (
/obj/machinery/mecha_part_fabricator/pros,
/obj/structure/window/plastitanium{
	dir = 4
	},
/obj/structure/window/plastitanium,
/turf/simulated/floor/tiled/old_tile/purple,
/area/submap/crystalcore/dark/lorearea_three)
"q" = (
/turf/template_noop,
/area/template_noop)
"s" = (
/obj/item/weapon/storage/backpack/satchel/roboticist,
/obj/structure/table/reinforced,
/turf/simulated/floor/tiled/old_tile/purple,
/area/submap/crystalcore/dark/lorearea_three)
"A" = (
/obj/item/weapon/storage/backpack/roboticist,
/obj/structure/table/reinforced,
/turf/simulated/floor/tiled/old_tile/purple,
/area/submap/crystalcore/dark/lorearea_three)
"C" = (
/turf/simulated/wall/rplastitanium,
/area/submap/crystalcore/dark/lorearea_three)
"D" = (
/turf/simulated/floor/tiled/old_tile/purple,
/area/submap/crystalcore/dark/lorearea_three)
"N" = (
/mob/living/simple_mob/vore/aggressive/corrupthound,
/turf/simulated/floor/tiled/old_tile/purple,
/area/submap/crystalcore/dark/lorearea_three)
"P" = (
/obj/machinery/r_n_d/destructive_analyzer,
/obj/structure/window/plastitanium{
	dir = 8
	},
/obj/structure/window/plastitanium,
/turf/simulated/floor/tiled/old_tile/purple,
/area/submap/crystalcore/dark/lorearea_three)
"U" = (
/obj/structure/frame/computer,
/obj/structure/window/plastitanium{
	dir = 8
	},
/turf/simulated/floor/tiled/old_tile/purple,
/area/submap/crystalcore/dark/lorearea_three)
"V" = (
/obj/structure/table/reinforced,
/obj/random/material/refined,
/turf/simulated/floor/tiled/old_tile/purple,
/area/submap/crystalcore/dark/lorearea_three)
"X" = (
/obj/machinery/r_n_d/protolathe,
/obj/structure/window/plastitanium{
	dir = 8
	},
/obj/structure/window/plastitanium{
	dir = 1
	},
/turf/simulated/floor/tiled/old_tile/purple,
/area/submap/crystalcore/dark/lorearea_three)

(1,1,1) = {"
q
q
q
q
q
q
q
q
q
q
q
q
q
q
q
q
q
q
q
q
q
q
q
q
q
q
q
q
q
q
"}
(2,1,1) = {"
q
a
a
a
a
a
a
a
a
a
a
a
a
a
a
a
a
a
a
a
a
a
a
a
a
a
a
a
a
q
"}
(3,1,1) = {"
q
a
a
a
a
a
a
a
a
a
a
a
a
a
a
a
a
a
a
a
a
a
a
a
a
a
a
a
a
q
"}
(4,1,1) = {"
q
a
a
a
a
a
a
a
a
a
a
a
a
a
a
a
a
a
a
a
a
a
a
a
a
a
a
a
a
q
"}
(5,1,1) = {"
q
a
a
a
a
a
a
a
a
a
a
a
a
a
a
a
a
a
a
a
a
a
a
a
a
a
a
a
a
q
"}
(6,1,1) = {"
q
a
a
a
a
a
a
a
a
a
a
a
a
a
a
a
a
a
a
a
a
a
a
a
a
a
a
a
a
q
"}
(7,1,1) = {"
q
a
a
a
a
a
a
a
C
C
C
C
C
C
C
c
C
C
C
C
C
C
C
a
a
a
a
a
a
q
"}
(8,1,1) = {"
q
a
a
a
a
a
a
a
C
D
D
D
D
D
D
D
D
D
D
D
D
D
C
a
a
a
a
a
a
q
"}
(9,1,1) = {"
q
a
a
a
a
a
a
a
C
D
D
D
D
D
D
D
D
D
D
D
D
D
C
a
a
a
a
a
a
q
"}
(10,1,1) = {"
q
a
a
a
a
a
a
a
C
D
D
C
C
C
C
c
C
C
C
C
D
D
C
a
a
a
a
a
a
q
"}
(11,1,1) = {"
q
a
a
a
a
a
a
a
c
D
D
C
A
D
D
D
D
D
V
C
D
N
c
a
a
a
a
a
a
q
"}
(12,1,1) = {"
q
a
a
a
a
a
a
a
C
D
D
C
d
D
X
U
P
D
A
C
D
D
C
a
a
a
a
a
a
q
"}
(13,1,1) = {"
q
a
a
a
a
a
a
a
C
D
D
C
V
N
D
D
D
D
d
C
D
D
C
a
a
a
a
a
a
q
"}
(14,1,1) = {"
q
a
a
a
a
a
a
a
C
N
D
C
V
D
l
D
e
D
b
C
D
D
C
a
a
a
a
a
a
q
"}
(15,1,1) = {"
q
a
a
a
a
a
a
a
C
D
D
C
d
D
g
D
p
D
s
C
D
D
C
a
a
a
a
a
a
q
"}
(16,1,1) = {"
q
a
a
a
a
a
a
a
C
D
D
C
j
D
D
D
D
N
V
C
D
D
C
a
a
a
a
a
a
q
"}
(17,1,1) = {"
q
a
a
a
a
a
a
a
C
D
D
C
s
D
D
D
D
D
d
C
D
D
C
a
a
a
a
a
a
q
"}
(18,1,1) = {"
q
a
a
a
a
a
a
a
C
D
D
C
C
C
C
C
C
C
C
C
D
D
C
a
a
a
a
a
a
q
"}
(19,1,1) = {"
q
a
a
a
a
a
a
a
C
D
D
D
D
D
D
D
D
D
D
D
D
D
C
a
a
a
a
a
a
q
"}
(20,1,1) = {"
q
a
a
a
a
a
a
a
c
D
D
D
D
D
D
N
D
D
D
D
D
D
c
a
a
a
a
a
a
q
"}
(21,1,1) = {"
q
a
a
a
a
a
a
a
C
D
D
D
D
D
D
D
D
D
D
D
D
D
C
a
a
a
a
a
a
q
"}
(22,1,1) = {"
q
a
a
a
a
a
a
a
C
C
C
C
C
C
C
c
C
C
C
C
C
C
C
a
a
a
a
a
a
q
"}
(23,1,1) = {"
q
a
a
a
a
a
a
a
a
a
a
a
a
a
a
a
a
a
a
a
a
a
a
a
a
a
a
a
a
q
"}
(24,1,1) = {"
q
a
a
a
a
a
a
a
a
a
a
a
a
a
a
a
a
a
a
a
a
a
a
a
a
a
a
a
a
q
"}
(25,1,1) = {"
q
a
a
a
a
a
a
a
a
a
a
a
a
a
a
a
a
a
a
a
a
a
a
a
a
a
a
a
a
q
"}
(26,1,1) = {"
q
a
a
a
a
a
a
a
a
a
a
a
a
a
a
a
a
a
a
a
a
a
a
a
a
a
a
a
a
q
"}
(27,1,1) = {"
q
a
a
a
a
a
a
a
a
a
a
a
a
a
a
a
a
a
a
a
a
a
a
a
a
a
a
a
a
q
"}
(28,1,1) = {"
q
a
a
a
a
a
a
a
a
a
a
a
a
a
a
a
a
a
a
a
a
a
a
a
a
a
a
a
a
q
"}
(29,1,1) = {"
q
a
a
a
a
a
a
a
a
a
a
a
a
a
a
a
a
a
a
a
a
a
a
a
a
a
a
a
a
q
"}
(30,1,1) = {"
q
q
q
q
q
q
q
q
q
q
q
q
q
q
q
q
q
q
q
q
q
q
q
q
q
q
q
q
q
q
"}
