//MAP CONVERTED BY dmm2tgm.py THIS HEADER COMMENT PREVENTS RECONVERSION, DO NOT REMOVE
"a" = (
/turf/template_noop,
/area/submap/crystalcore/dark/lorearea_one)
"f" = (
/obj/structure/table/steel,
/obj/item/weapon/reagent_containers/glass/bucket,
/turf/simulated/floor/tiled/old_tile/green,
/area/submap/crystalcore/dark/lorearea_one)
"m" = (
/obj/structure/table/steel,
/obj/item/weapon/material/knife/machete/hatchet,
/turf/simulated/floor/tiled/old_tile/green,
/area/submap/crystalcore/dark/lorearea_one)
"r" = (
/obj/structure/table/steel,
/obj/item/weapon/paper{
	info = "Artifical lighting has kept up in place of the sun. We have tested the useage of the sunroof, outside of one blip whilst we slept, the data confirms sunlight does not reach us down here. Despite the focus on artifical lighting, all our flora is showing signs of excelerated growth. Further testing to be had.";
	name = "Research Notes"
	},
/turf/simulated/floor/tiled/old_tile/green,
/area/submap/crystalcore/dark/lorearea_one)
"A" = (
/turf/template_noop,
/area/template_noop)
"B" = (
/obj/structure/table/steel,
/obj/item/prop/datadisc/biotech,
/turf/simulated/floor/tiled/old_tile/green,
/area/submap/crystalcore/dark/lorearea_one)
"C" = (
/turf/simulated/floor/tiled/old_tile/green,
/area/submap/crystalcore/dark/lorearea_one)
"E" = (
/mob/living/simple_mob/vore/pitcher_plant,
/turf/simulated/floor/tiled/old_tile/green,
/area/submap/crystalcore/dark/lorearea_one)
"G" = (
/obj/structure/table/steel,
/obj/item/weapon/reagent_containers/food/snacks/pitcher_fruit,
/obj/item/weapon/reagent_containers/food/snacks/pitcher_fruit,
/turf/simulated/floor/tiled/old_tile/green,
/area/submap/crystalcore/dark/lorearea_one)
"L" = (
/obj/machinery/door/airlock,
/turf/simulated/floor/tiled/old_tile/green,
/area/submap/crystalcore/dark/lorearea_one)
"P" = (
/obj/machinery/biogenerator,
/turf/simulated/floor/tiled/old_tile/green,
/area/submap/crystalcore/dark/lorearea_one)
"S" = (
/turf/simulated/wall/rplastitanium,
/area/submap/crystalcore/dark/lorearea_one)
"T" = (
/obj/machinery/portable_atmospherics/hydroponics,
/obj/item/seeds/random,
/turf/simulated/floor/tiled/old_tile/green,
/area/submap/crystalcore/dark/lorearea_one)
"Y" = (
/obj/machinery/portable_atmospherics/hydroponics,
/turf/simulated/floor/tiled/old_tile/green,
/area/submap/crystalcore/dark/lorearea_one)
"Z" = (
/obj/structure/table/steel,
/obj/item/weapon/material/minihoe,
/turf/simulated/floor/tiled/old_tile/green,
/area/submap/crystalcore/dark/lorearea_one)

(1,1,1) = {"
A
A
A
A
A
A
A
A
A
A
A
A
A
A
A
A
A
A
A
A
A
A
A
A
A
A
A
A
A
A
"}
(2,1,1) = {"
A
a
a
a
a
a
a
a
a
a
a
a
a
a
a
a
a
a
a
a
a
a
a
a
a
a
a
a
a
A
"}
(3,1,1) = {"
A
a
a
a
a
a
a
a
a
a
a
a
a
a
a
a
a
a
a
a
a
a
a
a
a
a
a
a
a
A
"}
(4,1,1) = {"
A
a
a
a
a
a
a
a
a
a
a
a
a
a
a
a
a
a
a
a
a
a
a
a
a
a
a
a
a
A
"}
(5,1,1) = {"
A
a
a
a
a
a
a
a
a
a
a
a
S
S
S
S
S
S
S
a
a
a
a
a
a
a
a
a
a
A
"}
(6,1,1) = {"
A
a
a
a
a
a
a
a
a
a
a
a
L
C
C
C
C
C
L
a
a
a
a
a
a
a
a
a
a
A
"}
(7,1,1) = {"
A
a
a
a
a
a
a
a
a
a
a
a
L
C
C
C
C
E
L
a
a
a
a
a
a
a
a
a
a
A
"}
(8,1,1) = {"
A
a
a
a
a
a
a
a
a
a
a
a
S
S
S
L
S
S
S
a
a
a
a
a
a
a
a
a
a
A
"}
(9,1,1) = {"
A
a
a
a
a
a
a
a
a
a
a
S
S
C
C
C
C
C
S
S
a
a
a
a
a
a
a
a
a
A
"}
(10,1,1) = {"
A
a
a
a
a
a
a
a
a
a
S
S
Y
C
C
E
C
C
Y
S
S
a
a
a
a
a
a
a
a
A
"}
(11,1,1) = {"
A
a
a
a
a
a
a
a
a
S
S
Y
C
C
C
C
C
C
C
Y
S
S
a
a
a
a
a
a
a
A
"}
(12,1,1) = {"
A
a
a
a
a
a
a
a
S
S
T
E
C
C
C
C
C
C
C
C
T
S
S
a
a
a
a
a
a
A
"}
(13,1,1) = {"
A
a
a
a
a
a
a
a
S
T
C
C
C
C
G
S
f
C
C
E
C
T
S
a
a
a
a
a
a
A
"}
(14,1,1) = {"
A
a
a
a
a
a
a
a
S
T
C
C
C
m
S
S
S
Z
C
C
C
T
S
a
a
a
a
a
a
A
"}
(15,1,1) = {"
A
a
a
a
a
a
a
a
S
T
C
C
C
S
S
S
S
S
C
C
C
T
S
a
a
a
a
a
a
A
"}
(16,1,1) = {"
A
a
a
a
a
a
a
a
S
T
E
C
C
r
S
S
S
P
C
C
C
T
S
a
a
a
a
a
a
A
"}
(17,1,1) = {"
A
a
a
a
a
a
a
a
S
T
C
C
C
C
G
S
B
C
C
C
C
T
S
a
a
a
a
a
a
A
"}
(18,1,1) = {"
A
a
a
a
a
a
a
a
S
S
T
C
C
E
C
C
C
E
C
C
T
S
S
a
a
a
a
a
a
A
"}
(19,1,1) = {"
A
a
a
a
a
a
a
a
a
S
S
Y
C
C
C
C
C
C
C
Y
S
S
a
a
a
a
a
a
a
A
"}
(20,1,1) = {"
A
a
a
a
a
a
a
a
a
a
S
S
Y
C
C
C
C
C
Y
S
S
a
a
a
a
a
a
a
a
A
"}
(21,1,1) = {"
A
a
a
a
a
a
a
a
a
a
a
S
S
C
C
C
E
C
S
S
a
a
a
a
a
a
a
a
a
A
"}
(22,1,1) = {"
A
a
a
a
a
a
a
a
a
a
a
a
S
S
S
L
S
S
S
a
a
a
a
a
a
a
a
a
a
A
"}
(23,1,1) = {"
A
a
a
a
a
a
a
a
a
a
a
a
L
C
E
C
C
C
L
a
a
a
a
a
a
a
a
a
a
A
"}
(24,1,1) = {"
A
a
a
a
a
a
a
a
a
a
a
a
L
C
C
C
C
C
L
a
a
a
a
a
a
a
a
a
a
A
"}
(25,1,1) = {"
A
a
a
a
a
a
a
a
a
a
a
a
S
S
S
S
S
S
S
a
a
a
a
a
a
a
a
a
a
A
"}
(26,1,1) = {"
A
a
a
a
a
a
a
a
a
a
a
a
a
a
a
a
a
a
a
a
a
a
a
a
a
a
a
a
a
A
"}
(27,1,1) = {"
A
a
a
a
a
a
a
a
a
a
a
a
a
a
a
a
a
a
a
a
a
a
a
a
a
a
a
a
a
A
"}
(28,1,1) = {"
A
a
a
a
a
a
a
a
a
a
a
a
a
a
a
a
a
a
a
a
a
a
a
a
a
a
a
a
a
A
"}
(29,1,1) = {"
A
a
a
a
a
a
a
a
a
a
a
a
a
a
a
a
a
a
a
a
a
a
a
a
a
a
a
a
a
A
"}
(30,1,1) = {"
A
A
A
A
A
A
A
A
A
A
A
A
A
A
A
A
A
A
A
A
A
A
A
A
A
A
A
A
A
A
"}
