//MAP CONVERTED BY dmm2tgm.py THIS HEADER COMMENT PREVENTS RECONVERSION, DO NOT REMOVE
"a" = (
/turf/simulated/floor/concrete,
/area/submap/crystalcore/dark/nine)
"g" = (
/mob/living/simple_mob/humanoid/eclipse/tropical/tiderhunter,
/turf/simulated/floor/concrete,
/area/submap/crystalcore/dark/nine)
"i" = (
/obj/structure/table/standard,
/turf/simulated/floor/concrete,
/area/submap/crystalcore/dark/nine)
"j" = (
/mob/living/simple_mob/humanoid/eclipse/tropical/diver,
/turf/simulated/floor/concrete,
/area/submap/crystalcore/dark/nine)
"l" = (
/mob/living/simple_mob/humanoid/eclipse/tropical/assasian,
/turf/simulated/floor/concrete,
/area/submap/crystalcore/dark/nine)
"o" = (
/obj/structure/closet/crate,
/obj/random/medical/pillbottle,
/obj/random/medical/pillbottle,
/obj/item/weapon/reagent_containers/chem_disp_cartridge/manhattan_proj,
/obj/item/weapon/reagent_containers/chem_disp_cartridge/sleeptox,
/turf/simulated/floor/concrete,
/area/submap/crystalcore/dark/nine)
"p" = (
/turf/template_noop,
/area/template_noop)
"v" = (
/obj/structure/bed,
/obj/item/weapon/bedsheet,
/turf/simulated/floor/concrete,
/area/submap/crystalcore/dark/nine)
"w" = (
/obj/structure/closet/crate,
/obj/item/weapon/archaeological_find,
/obj/item/weapon/archaeological_find,
/obj/item/weapon/archaeological_find,
/obj/item/weapon/archaeological_find,
/obj/item/weapon/archaeological_find,
/turf/simulated/floor/concrete,
/area/submap/crystalcore/dark/nine)
"y" = (
/obj/machinery/door/airlock/silver,
/turf/simulated/floor/concrete,
/area/submap/crystalcore/dark/nine)
"z" = (
/obj/structure/table/steel,
/obj/item/device/multitool,
/obj/random/tool/power,
/turf/simulated/floor/concrete,
/area/submap/crystalcore/dark/nine)
"H" = (
/obj/structure/table/standard,
/obj/random/meat,
/obj/random/meat,
/obj/random/meat,
/obj/random/meat,
/obj/random/meat,
/obj/random/meat,
/obj/random/meat,
/turf/simulated/floor/concrete,
/area/submap/crystalcore/dark/nine)
"M" = (
/obj/structure/table/steel,
/obj/item/weapon/archaeological_find,
/obj/item/weapon/archaeological_find,
/turf/simulated/floor/concrete,
/area/submap/crystalcore/dark/nine)
"N" = (
/mob/living/simple_mob/humanoid/eclipse/tropical/driller,
/turf/simulated/floor/concrete,
/area/submap/crystalcore/dark/nine)
"O" = (
/turf/simulated/wall/concrete,
/area/submap/crystalcore/dark/nine)
"R" = (
/obj/structure/table/steel,
/obj/random/tool/power,
/obj/item/weapon/paper{
	info = "Similiar to our other research points, the point between realms is weak. However, despite traces of the familiar dark and red realm readings, the biggest source appears to be something else. We have been unable to getdeem much further, but we are currently theorizing what is beyond this rift is the reasoning for the aquatic nature of many creatures within this caverns.";
	name = "Research Notes"
	},
/turf/simulated/floor/concrete,
/area/submap/crystalcore/dark/nine)
"S" = (
/turf/template_noop,
/area/submap/crystalcore/dark/nine)
"T" = (
/obj/structure/table/standard,
/obj/item/weapon/surgical/scalpel/laser3,
/turf/simulated/floor/concrete,
/area/submap/crystalcore/dark/nine)
"V" = (
/obj/structure/table/standard,
/obj/random/meat,
/turf/simulated/floor/concrete,
/area/submap/crystalcore/dark/nine)
"X" = (
/mob/living/simple_mob/humanoid/eclipse/tropical/anomalist,
/turf/simulated/floor/concrete,
/area/submap/crystalcore/dark/nine)
"Y" = (
/obj/structure/table/steel,
/obj/random/tool/power,
/turf/simulated/floor/concrete,
/area/submap/crystalcore/dark/nine)

(1,1,1) = {"
p
p
p
p
p
p
p
p
p
p
p
p
p
p
p
p
p
p
p
p
p
p
p
p
p
p
p
p
p
p
"}
(2,1,1) = {"
p
S
S
S
S
S
S
S
S
S
S
S
S
S
S
S
S
S
S
S
S
S
S
S
S
S
S
S
S
p
"}
(3,1,1) = {"
p
S
S
S
S
S
S
S
S
S
S
S
S
O
y
y
O
S
S
S
S
S
S
S
S
S
S
S
S
p
"}
(4,1,1) = {"
p
S
S
S
S
S
S
S
S
S
S
S
S
O
a
a
O
S
S
S
S
S
S
S
S
S
S
S
S
p
"}
(5,1,1) = {"
p
S
S
S
S
S
S
S
S
S
S
S
S
O
a
a
O
S
S
S
S
S
S
S
S
S
S
S
S
p
"}
(6,1,1) = {"
p
S
S
S
S
S
S
S
S
S
S
S
S
O
a
a
O
S
S
S
S
S
S
S
S
S
S
S
S
p
"}
(7,1,1) = {"
p
S
S
S
S
S
S
S
S
S
S
S
S
O
a
a
O
S
S
S
S
S
S
S
S
S
S
S
S
p
"}
(8,1,1) = {"
p
S
S
S
S
S
S
S
S
S
S
S
S
O
a
a
O
S
S
S
S
S
S
S
S
S
S
S
S
p
"}
(9,1,1) = {"
p
S
S
S
S
S
S
S
S
S
S
S
S
O
a
a
O
S
S
S
S
S
S
S
S
S
S
S
S
p
"}
(10,1,1) = {"
p
S
S
S
S
S
S
S
S
S
S
S
O
O
a
a
O
O
S
S
S
S
S
S
S
S
S
S
S
p
"}
(11,1,1) = {"
p
S
S
S
S
S
S
S
S
S
O
O
O
O
N
N
O
O
O
O
S
S
S
S
S
S
S
S
S
p
"}
(12,1,1) = {"
p
S
S
S
S
S
S
S
O
O
O
O
O
O
a
a
O
O
O
O
O
O
S
S
S
S
S
S
S
p
"}
(13,1,1) = {"
p
S
S
S
S
S
O
O
O
a
a
g
a
O
a
a
O
a
a
a
a
O
O
O
S
S
S
S
S
p
"}
(14,1,1) = {"
p
S
S
S
S
O
O
a
a
a
a
a
a
O
a
a
O
a
a
a
j
a
a
O
O
S
S
S
S
p
"}
(15,1,1) = {"
p
S
S
S
S
O
a
Y
a
a
z
a
a
O
a
a
O
a
a
H
H
H
a
a
O
S
S
S
S
p
"}
(16,1,1) = {"
p
S
S
S
O
O
a
M
a
X
M
a
a
y
a
a
y
a
a
a
a
a
a
a
O
O
S
S
S
p
"}
(17,1,1) = {"
p
S
S
S
O
a
a
z
a
a
Y
a
a
O
a
a
O
a
a
a
a
a
a
a
i
O
S
S
S
p
"}
(18,1,1) = {"
p
S
S
S
O
a
a
a
a
a
a
a
a
O
a
a
O
a
a
H
H
H
a
l
T
O
S
S
S
p
"}
(19,1,1) = {"
p
S
S
S
O
a
a
a
a
a
a
a
O
O
y
y
O
O
a
a
j
a
a
a
V
O
S
S
S
p
"}
(20,1,1) = {"
p
S
S
S
O
O
a
R
M
z
a
O
O
a
a
a
a
O
O
a
a
a
a
a
O
O
S
S
S
p
"}
(21,1,1) = {"
p
S
S
S
S
O
a
a
X
a
O
O
v
a
a
a
a
v
O
O
a
a
a
a
O
S
S
S
S
p
"}
(22,1,1) = {"
p
S
S
S
S
O
O
a
a
O
O
a
j
a
v
v
a
j
a
O
O
a
a
O
O
S
S
S
S
p
"}
(23,1,1) = {"
p
S
S
S
S
S
O
O
w
O
v
a
v
a
a
a
a
v
a
v
O
o
O
O
S
S
S
S
S
p
"}
(24,1,1) = {"
p
S
S
S
S
S
S
O
O
O
v
a
v
g
v
v
N
v
a
v
O
O
O
S
S
S
S
S
S
p
"}
(25,1,1) = {"
p
S
S
S
S
S
S
S
S
O
O
O
v
a
a
a
a
v
O
O
O
S
S
S
S
S
S
S
S
p
"}
(26,1,1) = {"
p
S
S
S
S
S
S
S
S
S
S
O
O
O
v
v
O
O
O
S
S
S
S
S
S
S
S
S
S
p
"}
(27,1,1) = {"
p
S
S
S
S
S
S
S
S
S
S
S
S
O
O
O
O
S
S
S
S
S
S
S
S
S
S
S
S
p
"}
(28,1,1) = {"
p
S
S
S
S
S
S
S
S
S
S
S
S
S
S
S
S
S
S
S
S
S
S
S
S
S
S
S
S
p
"}
(29,1,1) = {"
p
S
S
S
S
S
S
S
S
S
S
S
S
S
S
S
S
S
S
S
S
S
S
S
S
S
S
S
S
p
"}
(30,1,1) = {"
p
p
p
p
p
p
p
p
p
p
p
p
p
p
p
p
p
p
p
p
p
p
p
p
p
p
p
p
p
p
"}
