//MAP CONVERTED BY dmm2tgm.py THIS HEADER COMMENT PREVENTS RECONVERSION, DO NOT REMOVE
"a" = (
/turf/template_noop,
/area/submap/crystalcore/dark/seven)
"b" = (
/turf/simulated/floor/outdoors/crystal_planet/darksand,
/area/submap/crystalcore/dark/seven)
"f" = (
/obj/structure/table/steel_reinforced,
/obj/random/tool/power,
/turf/simulated/floor/concrete,
/area/submap/crystalcore/dark/seven)
"g" = (
/obj/machinery/optable,
/turf/simulated/floor/concrete,
/area/submap/crystalcore/dark/seven)
"h" = (
/turf/simulated/wall/concrete,
/area/submap/crystalcore/dark/seven)
"j" = (
/obj/structure/table/reinforced,
/obj/item/weapon/pickaxe/diamonddrill,
/turf/simulated/floor/concrete,
/area/submap/crystalcore/dark/seven)
"k" = (
/obj/structure/table/reinforced,
/obj/item/weapon/reagent_containers/chem_disp_cartridge/acidspit,
/turf/simulated/floor/concrete,
/area/submap/crystalcore/dark/seven)
"n" = (
/mob/living/simple_mob/humanoid/eclipse/tropical/assasian,
/turf/simulated/floor/concrete,
/area/submap/crystalcore/dark/seven)
"p" = (
/turf/template_noop,
/area/template_noop)
"u" = (
/mob/living/simple_mob/humanoid/eclipse/tropical/tiderhunter,
/turf/simulated/floor/concrete,
/area/submap/crystalcore/dark/seven)
"y" = (
/obj/machinery/oxygen_pump/mobile/anesthetic,
/turf/simulated/floor/concrete,
/area/submap/crystalcore/dark/seven)
"z" = (
/obj/structure/table/steel_reinforced,
/obj/random/material,
/turf/simulated/floor/concrete,
/area/submap/crystalcore/dark/seven)
"D" = (
/obj/machinery/door/airlock/silver,
/turf/simulated/floor/concrete,
/area/submap/crystalcore/dark/seven)
"G" = (
/obj/structure/anomaly_container,
/obj/machinery/artifact,
/turf/simulated/floor/concrete,
/area/submap/crystalcore/dark/seven)
"H" = (
/obj/structure/table/reinforced,
/obj/item/weapon/gun/energy/locked/phasegun/pistol,
/turf/simulated/floor/concrete,
/area/submap/crystalcore/dark/seven)
"I" = (
/mob/living/simple_mob/humanoid/eclipse/tropical/anomalist,
/turf/simulated/floor/concrete,
/area/submap/crystalcore/dark/seven)
"L" = (
/obj/structure/table/reinforced,
/obj/item/weapon/gun/energy/locked/phasegun/pistol,
/obj/item/weapon/paper{
	info = "High amounts of ruins have been located within the walls. There are also many ruins of past operations, and signs of civilizations. Most if not all is bristling with the same energy the wildlife appears to feast upon. Collecting further artifacts for testing.";
	name = "Research Notes"
	},
/turf/simulated/floor/concrete,
/area/submap/crystalcore/dark/seven)
"M" = (
/obj/structure/table/reinforced,
/obj/item/weapon/storage/firstaid/surgery,
/turf/simulated/floor/concrete,
/area/submap/crystalcore/dark/seven)
"N" = (
/obj/structure/table/reinforced,
/obj/random/medical/pillbottle,
/obj/item/weapon/reagent_containers/chem_disp_cartridge/corophizine,
/turf/simulated/floor/concrete,
/area/submap/crystalcore/dark/seven)
"R" = (
/obj/structure/table/reinforced,
/obj/random/medical/pillbottle,
/turf/simulated/floor/concrete,
/area/submap/crystalcore/dark/seven)
"S" = (
/obj/structure/bed,
/obj/item/weapon/bedsheet,
/turf/simulated/floor/concrete,
/area/submap/crystalcore/dark/seven)
"T" = (
/obj/structure/table/reinforced,
/obj/item/weapon/pickaxe/excavationdrill,
/turf/simulated/floor/concrete,
/area/submap/crystalcore/dark/seven)
"V" = (
/mob/living/simple_mob/humanoid/eclipse/tropical/driller,
/turf/simulated/floor/concrete,
/area/submap/crystalcore/dark/seven)
"X" = (
/turf/simulated/floor/concrete,
/area/submap/crystalcore/dark/seven)
"Y" = (
/mob/living/simple_mob/humanoid/eclipse/tropical/diver,
/turf/simulated/floor/concrete,
/area/submap/crystalcore/dark/seven)
"Z" = (
/obj/item/weapon/bedsheet,
/obj/structure/bed,
/turf/simulated/floor/concrete,
/area/submap/crystalcore/dark/seven)

(1,1,1) = {"
p
p
p
p
p
p
p
p
p
p
p
p
p
p
p
p
p
p
p
p
p
p
p
p
p
p
p
p
p
p
"}
(2,1,1) = {"
p
a
a
a
a
a
a
a
a
a
a
a
a
h
h
h
h
a
a
a
a
a
a
a
a
a
a
a
a
p
"}
(3,1,1) = {"
p
a
a
a
a
a
a
a
a
a
a
a
h
h
f
f
h
h
a
a
a
a
a
a
a
a
a
a
a
p
"}
(4,1,1) = {"
p
a
a
a
a
a
a
a
a
a
a
h
h
z
X
X
z
h
h
a
a
a
a
a
a
a
a
a
a
p
"}
(5,1,1) = {"
p
a
a
a
a
a
h
h
h
h
h
h
z
X
X
X
X
z
h
h
h
h
h
h
a
a
a
a
a
p
"}
(6,1,1) = {"
p
a
a
a
a
h
h
X
X
X
h
X
X
X
X
X
X
X
X
h
R
k
N
h
h
a
a
a
a
p
"}
(7,1,1) = {"
p
a
a
a
h
h
X
X
X
X
D
X
X
n
X
X
X
X
X
D
X
X
X
V
h
h
a
a
a
p
"}
(8,1,1) = {"
p
a
a
a
h
S
Y
X
X
X
h
X
X
X
X
X
X
X
X
h
X
X
X
X
M
h
a
a
a
p
"}
(9,1,1) = {"
p
a
a
a
h
S
X
S
X
S
h
h
h
h
D
D
h
h
h
h
X
X
X
X
g
h
a
a
a
p
"}
(10,1,1) = {"
p
a
a
a
h
S
X
S
X
S
h
h
h
X
X
X
X
h
h
h
X
X
X
X
y
h
a
a
a
p
"}
(11,1,1) = {"
p
a
a
a
h
S
X
S
Y
S
h
h
X
X
X
X
X
X
h
h
X
V
X
X
y
h
a
a
a
p
"}
(12,1,1) = {"
p
a
a
a
h
S
X
S
X
h
h
X
X
X
X
X
X
X
X
h
h
X
X
X
g
h
a
a
a
p
"}
(13,1,1) = {"
p
a
a
a
h
S
X
S
h
h
X
X
X
X
X
X
X
V
X
X
h
h
X
X
M
h
a
a
a
p
"}
(14,1,1) = {"
p
a
a
a
h
h
h
h
h
X
X
X
X
X
h
h
X
X
X
X
X
h
h
h
h
h
a
a
a
p
"}
(15,1,1) = {"
p
a
a
b
b
b
b
b
D
X
X
X
X
h
h
h
h
X
X
X
X
D
b
b
b
b
b
a
a
p
"}
(16,1,1) = {"
p
a
a
b
b
b
b
b
D
X
X
X
X
h
h
h
h
X
X
X
X
D
b
b
b
b
b
a
a
p
"}
(17,1,1) = {"
p
a
a
a
h
h
h
h
h
X
X
X
X
X
h
h
X
X
X
X
X
h
h
h
h
h
a
a
a
p
"}
(18,1,1) = {"
p
a
a
a
h
G
G
G
h
h
X
X
Y
X
X
X
X
X
X
X
h
h
Z
X
Z
h
a
a
a
p
"}
(19,1,1) = {"
p
a
a
a
h
X
X
X
X
h
h
X
X
X
X
X
X
X
X
h
h
X
Z
X
Z
h
a
a
a
p
"}
(20,1,1) = {"
p
a
a
a
h
X
X
X
X
I
h
h
X
X
X
X
X
X
h
h
Z
u
Z
X
Z
h
a
a
a
p
"}
(21,1,1) = {"
p
a
a
a
h
X
T
j
H
X
h
h
h
X
X
X
X
h
h
h
Z
X
Z
X
Z
h
a
a
a
p
"}
(22,1,1) = {"
p
a
a
a
h
X
j
L
T
X
h
h
h
h
D
D
h
h
h
h
Z
X
Z
n
Z
h
a
a
a
p
"}
(23,1,1) = {"
p
a
a
a
h
I
X
X
X
X
h
X
X
X
X
X
X
X
X
h
X
X
X
X
Z
h
a
a
a
p
"}
(24,1,1) = {"
p
a
a
a
h
h
X
X
X
X
D
X
X
u
X
X
X
X
X
D
X
X
X
X
h
h
a
a
a
p
"}
(25,1,1) = {"
p
a
a
a
a
h
h
X
X
X
h
X
X
X
X
X
X
X
X
h
X
X
X
h
h
a
a
a
a
p
"}
(26,1,1) = {"
p
a
a
a
a
a
h
h
h
h
h
h
z
X
X
X
X
z
h
h
h
h
h
h
a
a
a
a
a
p
"}
(27,1,1) = {"
p
a
a
a
a
a
a
a
a
a
a
h
h
z
X
X
z
h
h
a
a
a
a
a
a
a
a
a
a
p
"}
(28,1,1) = {"
p
a
a
a
a
a
a
a
a
a
a
a
h
h
f
f
h
h
a
a
a
a
a
a
a
a
a
a
a
p
"}
(29,1,1) = {"
p
a
a
a
a
a
a
a
a
a
a
a
a
h
h
h
h
a
a
a
a
a
a
a
a
a
a
a
a
p
"}
(30,1,1) = {"
p
p
p
p
p
p
p
p
p
p
p
p
p
p
p
p
p
p
p
p
p
p
p
p
p
p
p
p
p
p
"}
