//MAP CONVERTED BY dmm2tgm.py THIS HEADER COMMENT PREVENTS RECONVERSION, DO NOT REMOVE
"a" = (
/turf/template_noop,
/area/submap/crystalcore/dark/six)
"c" = (
/mob/living/simple_mob/humanoid/eclipse/tropical/driller,
/turf/simulated/floor/concrete,
/area/submap/crystalcore/dark/six)
"e" = (
/obj/structure/grille,
/obj/structure/window/plastitanium{
	dir = 8
	},
/obj/structure/window/plastitanium{
	dir = 4
	},
/obj/structure/window/plastitanium{
	dir = 1
	},
/turf/simulated/floor/concrete,
/area/submap/crystalcore/dark/six)
"f" = (
/obj/structure/table/standard,
/obj/item/weapon/reagent_containers/chem_disp_cartridge/biomass,
/turf/simulated/floor/concrete,
/area/submap/crystalcore/dark/six)
"i" = (
/mob/living/simple_mob/humanoid/eclipse/tropical/diver,
/turf/simulated/floor/concrete,
/area/submap/crystalcore/dark/six)
"j" = (
/turf/simulated/floor/concrete,
/area/submap/crystalcore/dark/six)
"k" = (
/turf/simulated/wall/concrete,
/area/submap/crystalcore/dark/six)
"m" = (
/obj/structure/table/steel,
/obj/random/maintenance/foodstuff,
/obj/random/maintenance/foodstuff,
/obj/random/maintenance/foodstuff,
/turf/simulated/floor/concrete,
/area/submap/crystalcore/dark/six)
"n" = (
/mob/living/simple_mob/humanoid/eclipse/tropical/assasian,
/turf/simulated/floor/concrete,
/area/submap/crystalcore/dark/six)
"u" = (
/obj/structure/grille,
/obj/structure/window/plastitanium{
	dir = 8
	},
/obj/structure/window/plastitanium{
	dir = 4
	},
/turf/simulated/floor/concrete,
/area/submap/crystalcore/dark/six)
"w" = (
/obj/structure/table/standard,
/obj/random/medical/pillbottle,
/turf/simulated/floor/concrete,
/area/submap/crystalcore/dark/six)
"y" = (
/turf/simulated/floor/outdoors/crystal_planet/darksand,
/area/submap/crystalcore/dark/six)
"z" = (
/obj/structure/table/standard,
/obj/random/firstaid,
/turf/simulated/floor/concrete,
/area/submap/crystalcore/dark/six)
"A" = (
/obj/structure/table/standard,
/turf/simulated/floor/concrete,
/area/submap/crystalcore/dark/six)
"C" = (
/obj/structure/table/steel,
/obj/item/slime_extract/rainbow,
/obj/random/maintenance/research,
/turf/simulated/floor/concrete,
/area/submap/crystalcore/dark/six)
"D" = (
/obj/structure/table/steel,
/obj/item/slime_extract/red,
/obj/random/maintenance/research,
/turf/simulated/floor/concrete,
/area/submap/crystalcore/dark/six)
"F" = (
/obj/structure/grille,
/obj/structure/window/plastitanium,
/obj/structure/window/plastitanium{
	dir = 4
	},
/obj/structure/window/plastitanium{
	dir = 8
	},
/turf/simulated/floor/concrete,
/area/submap/crystalcore/dark/six)
"G" = (
/mob/living/simple_mob/humanoid/eclipse/tropical/anomalist,
/turf/simulated/floor/concrete,
/area/submap/crystalcore/dark/six)
"I" = (
/obj/structure/grille,
/obj/structure/window/plastitanium{
	dir = 4
	},
/obj/structure/window/plastitanium{
	dir = 8
	},
/turf/simulated/floor/concrete,
/area/submap/crystalcore/dark/six)
"J" = (
/obj/structure/table/steel,
/obj/random/maintenance/research,
/obj/item/weapon/paper{
	info = "The creatures within the cavern appear to take the apperance of sea life. All of them have trace readings of anomalous energy. We predict that they are feasting off of extra dimensional enery leaking through here. Studies upon the barrier between dimensions are handled by other facilities. Currently attempting to utilize the effects of two cavern sea creatures.";
	name = "Research Notes"
	},
/turf/simulated/floor/concrete,
/area/submap/crystalcore/dark/six)
"K" = (
/obj/machinery/door/airlock/silver,
/turf/simulated/floor/concrete,
/area/submap/crystalcore/dark/six)
"L" = (
/mob/living/simple_mob/animal/crystalcore/hypnofish{
	faction = "eclipse"
	},
/turf/simulated/floor/concrete,
/area/submap/crystalcore/dark/six)
"M" = (
/turf/template_noop,
/area/template_noop)
"N" = (
/obj/structure/table/steel,
/obj/random/maintenance/research,
/turf/simulated/floor/concrete,
/area/submap/crystalcore/dark/six)
"Q" = (
/obj/structure/table/standard,
/obj/item/weapon/reagent_containers/chem_disp_cartridge/cherryjelly,
/turf/simulated/floor/concrete,
/area/submap/crystalcore/dark/six)
"R" = (
/obj/item/weapon/stool,
/turf/simulated/floor/concrete,
/area/submap/crystalcore/dark/six)
"S" = (
/obj/structure/table/steel,
/obj/item/slime_extract/pink,
/obj/random/maintenance/research,
/turf/simulated/floor/concrete,
/area/submap/crystalcore/dark/six)
"U" = (
/obj/structure/table/steel,
/obj/item/slime_extract/grey,
/obj/random/maintenance/research,
/turf/simulated/floor/concrete,
/area/submap/crystalcore/dark/six)
"X" = (
/mob/living/simple_mob/animal/crystalcore/blobfish{
	faction = "eclipse"
	},
/turf/simulated/floor/concrete,
/area/submap/crystalcore/dark/six)
"Y" = (
/mob/living/simple_mob/humanoid/eclipse/tropical/tiderhunter,
/turf/simulated/floor/concrete,
/area/submap/crystalcore/dark/six)

(1,1,1) = {"
M
M
M
M
M
M
M
M
M
M
M
M
M
M
M
M
M
M
M
M
M
M
M
M
M
M
M
M
M
M
"}
(2,1,1) = {"
M
a
a
a
a
a
a
a
a
a
a
a
k
k
k
k
k
k
k
a
a
a
a
a
a
a
a
a
a
M
"}
(3,1,1) = {"
M
a
a
a
a
a
a
a
a
a
k
k
k
w
f
A
Q
w
k
k
k
a
a
a
a
a
a
a
a
M
"}
(4,1,1) = {"
M
a
a
a
a
a
a
a
a
k
k
j
j
i
j
j
j
i
j
j
k
k
a
a
a
a
a
a
a
M
"}
(5,1,1) = {"
M
a
a
a
a
a
a
a
a
k
w
j
j
j
j
j
j
j
j
j
z
k
a
a
a
a
a
a
a
M
"}
(6,1,1) = {"
M
a
a
a
a
a
a
a
a
k
z
n
j
j
j
j
j
j
j
n
w
k
a
a
a
a
a
a
a
M
"}
(7,1,1) = {"
M
a
a
a
a
a
a
a
a
k
w
j
j
j
j
j
j
j
j
j
w
k
a
a
a
a
a
a
a
M
"}
(8,1,1) = {"
M
a
a
a
k
k
k
k
k
k
k
k
k
k
K
k
K
k
k
k
k
k
k
k
k
k
k
a
a
M
"}
(9,1,1) = {"
M
a
a
a
k
j
j
j
j
j
j
k
j
j
j
j
j
j
j
k
j
j
j
j
j
j
k
a
a
M
"}
(10,1,1) = {"
M
a
a
a
k
j
N
j
j
N
j
k
j
j
R
j
R
c
j
k
j
j
j
j
j
j
k
a
a
M
"}
(11,1,1) = {"
M
a
a
a
k
j
S
j
j
N
Y
k
j
R
m
m
m
R
j
k
j
U
N
D
N
j
k
a
a
M
"}
(12,1,1) = {"
M
a
a
a
k
j
J
j
j
U
j
K
j
j
m
m
m
j
j
K
j
j
Y
j
j
j
k
a
a
M
"}
(13,1,1) = {"
M
a
a
a
k
j
N
j
j
N
j
k
j
R
m
m
m
R
j
k
j
j
j
j
j
j
k
a
a
M
"}
(14,1,1) = {"
M
a
a
a
k
j
U
j
j
N
j
k
j
c
R
j
R
j
j
k
j
j
j
G
j
j
k
a
a
M
"}
(15,1,1) = {"
M
a
a
a
k
j
N
j
j
C
j
k
j
j
j
j
j
j
j
k
j
N
S
N
U
j
k
a
a
M
"}
(16,1,1) = {"
M
a
a
a
k
j
N
G
j
N
j
k
k
k
k
K
k
k
k
k
j
j
j
j
j
j
k
a
a
M
"}
(17,1,1) = {"
M
a
a
a
k
j
j
j
j
j
j
k
y
y
y
y
y
y
y
k
j
j
j
j
j
j
k
a
a
M
"}
(18,1,1) = {"
M
a
a
a
k
K
e
u
u
u
u
k
y
y
y
y
y
y
y
k
I
I
I
I
F
K
k
a
a
M
"}
(19,1,1) = {"
M
a
a
a
k
j
j
j
j
j
j
k
y
y
y
y
y
y
y
k
j
j
j
j
j
j
k
a
a
M
"}
(20,1,1) = {"
M
a
a
a
k
j
j
j
j
j
j
k
y
y
y
y
y
y
y
k
j
j
L
j
j
j
k
a
a
M
"}
(21,1,1) = {"
M
a
a
a
k
j
j
j
X
j
j
k
y
y
y
y
y
y
y
k
j
j
j
j
j
j
k
a
a
M
"}
(22,1,1) = {"
M
a
a
a
k
k
j
j
j
j
k
k
y
y
y
y
y
y
y
k
k
j
j
j
j
k
k
a
a
M
"}
(23,1,1) = {"
M
a
a
a
a
k
k
k
k
k
k
a
a
y
y
y
y
y
a
a
k
k
k
k
k
k
a
a
a
M
"}
(24,1,1) = {"
M
a
a
a
a
a
a
a
a
a
a
a
a
a
y
y
y
a
a
a
a
a
a
a
a
a
a
a
a
M
"}
(25,1,1) = {"
M
a
a
a
a
a
a
a
a
a
a
a
a
a
a
a
a
a
a
a
a
a
a
a
a
a
a
a
a
M
"}
(26,1,1) = {"
M
a
a
a
a
a
a
a
a
a
a
a
a
a
a
a
a
a
a
a
a
a
a
a
a
a
a
a
a
M
"}
(27,1,1) = {"
M
a
a
a
a
a
a
a
a
a
a
a
a
a
a
a
a
a
a
a
a
a
a
a
a
a
a
a
a
M
"}
(28,1,1) = {"
M
a
a
a
a
a
a
a
a
a
a
a
a
a
a
a
a
a
a
a
a
a
a
a
a
a
a
a
a
M
"}
(29,1,1) = {"
M
a
a
a
a
a
a
a
a
a
a
a
a
a
a
a
a
a
a
a
a
a
a
a
a
a
a
a
a
M
"}
(30,1,1) = {"
M
M
M
M
M
M
M
M
M
M
M
M
M
M
M
M
M
M
M
M
M
M
M
M
M
M
M
M
M
M
"}
