//MAP CONVERTED BY dmm2tgm.py THIS HEADER COMMENT PREVENTS RECONVERSION, DO NOT REMOVE
"a" = (
/turf/simulated/wall/concrete,
/area/submap/crystalcore/dark/ten)
"b" = (
/obj/structure/table/marble,
/turf/simulated/floor/concrete,
/area/submap/crystalcore/dark/ten)
"d" = (
/obj/structure/table/marble,
/obj/random/medical/pillbottle,
/turf/simulated/floor/concrete,
/area/submap/crystalcore/dark/ten)
"f" = (
/turf/template_noop,
/area/template_noop)
"j" = (
/obj/structure/table/marble,
/obj/item/weapon/reagent_containers/blood/BPlus,
/obj/random/firstaid,
/turf/simulated/floor/concrete,
/area/submap/crystalcore/dark/ten)
"k" = (
/turf/simulated/floor/concrete,
/area/submap/crystalcore/dark/ten)
"l" = (
/mob/living/simple_mob/humanoid/eclipse/tropical/assasian,
/turf/simulated/floor/concrete,
/area/submap/crystalcore/dark/ten)
"o" = (
/obj/structure/curtain/open/shower/medical,
/turf/simulated/floor/concrete,
/area/submap/crystalcore/dark/ten)
"p" = (
/obj/structure/table/marble,
/obj/item/weapon/reagent_containers/blood/BPlus,
/turf/simulated/floor/concrete,
/area/submap/crystalcore/dark/ten)
"q" = (
/obj/machinery/door/airlock/silver,
/turf/simulated/floor/concrete,
/area/submap/crystalcore/dark/ten)
"r" = (
/mob/living/simple_mob/humanoid/eclipse/head/medical,
/turf/simulated/floor/concrete,
/area/submap/crystalcore/dark/ten)
"s" = (
/obj/structure/table/marble,
/obj/item/weapon/reagent_containers/blood/BMinus,
/obj/random/medical/pillbottle,
/turf/simulated/floor/concrete,
/area/submap/crystalcore/dark/ten)
"u" = (
/obj/structure/table/marble,
/obj/item/weapon/reagent_containers/blood/OPlus,
/obj/random/medical/pillbottle,
/turf/simulated/floor/concrete,
/area/submap/crystalcore/dark/ten)
"v" = (
/obj/structure/table/marble,
/obj/item/weapon/reagent_containers/blood/OPlus,
/obj/item/weapon/reagent_containers/chem_disp_cartridge/oxycodone,
/turf/simulated/floor/concrete,
/area/submap/crystalcore/dark/ten)
"w" = (
/obj/structure/table/marble,
/obj/item/weapon/reagent_containers/blood/APlus,
/obj/item/weapon/storage/firstaid/surgery,
/turf/simulated/floor/concrete,
/area/submap/crystalcore/dark/ten)
"x" = (
/mob/living/simple_mob/humanoid/eclipse/tropical/tiderhunter,
/turf/simulated/floor/concrete,
/area/submap/crystalcore/dark/ten)
"B" = (
/mob/living/simple_mob/humanoid/eclipse/tropical/diver,
/turf/simulated/floor/concrete,
/area/submap/crystalcore/dark/ten)
"C" = (
/obj/machinery/oxygen_pump/mobile/anesthetic,
/turf/simulated/floor/concrete,
/area/submap/crystalcore/dark/ten)
"E" = (
/turf/template_noop,
/area/submap/crystalcore/dark/ten)
"G" = (
/obj/structure/table/marble,
/obj/random/firstaid,
/turf/simulated/floor/concrete,
/area/submap/crystalcore/dark/ten)
"K" = (
/obj/random/plushie,
/obj/structure/bed/double,
/obj/item/weapon/bedsheet/bluedouble,
/turf/simulated/floor/concrete,
/area/submap/crystalcore/dark/ten)
"M" = (
/obj/structure/table/marble,
/obj/item/weapon/reagent_containers/blood/AMinus,
/turf/simulated/floor/concrete,
/area/submap/crystalcore/dark/ten)
"N" = (
/obj/structure/bed/double,
/obj/random/plushie,
/obj/item/weapon/bedsheet/bluedouble,
/turf/simulated/floor/concrete,
/area/submap/crystalcore/dark/ten)
"P" = (
/obj/structure/table/marble,
/obj/item/weapon/reagent_containers/blood/OMinus,
/obj/random/firstaid,
/turf/simulated/floor/concrete,
/area/submap/crystalcore/dark/ten)
"S" = (
/obj/structure/table/marble,
/obj/item/weapon/reagent_containers/blood/OMinus,
/obj/item/weapon/reagent_containers/chem_disp_cartridge/melonliquor,
/turf/simulated/floor/concrete,
/area/submap/crystalcore/dark/ten)
"X" = (
/obj/structure/table/marble,
/obj/item/weapon/reagent_containers/blood/AMinus,
/obj/random/medical/pillbottle,
/turf/simulated/floor/concrete,
/area/submap/crystalcore/dark/ten)
"Y" = (
/mob/living/simple_mob/humanoid/eclipse/tropical/anomalist,
/turf/simulated/floor/concrete,
/area/submap/crystalcore/dark/ten)
"Z" = (
/obj/machinery/optable,
/turf/simulated/floor/concrete,
/area/submap/crystalcore/dark/ten)

(1,1,1) = {"
f
f
f
f
f
f
f
f
f
f
f
f
f
f
f
f
f
f
f
f
f
f
f
f
f
f
f
f
f
f
"}
(2,1,1) = {"
f
E
E
E
E
E
E
E
E
E
E
E
E
E
E
E
E
E
E
E
E
E
E
E
E
E
E
E
E
f
"}
(3,1,1) = {"
f
E
E
E
E
E
E
E
E
E
E
E
E
E
E
E
E
E
E
E
E
E
E
E
E
E
E
E
E
f
"}
(4,1,1) = {"
f
E
E
E
E
E
E
E
E
E
E
E
E
E
E
E
E
E
E
E
E
E
E
E
E
E
E
E
E
f
"}
(5,1,1) = {"
f
E
E
E
E
E
E
E
E
E
E
E
E
E
E
E
E
E
E
E
E
E
E
E
E
E
E
E
E
f
"}
(6,1,1) = {"
f
E
E
E
E
E
E
E
E
E
E
E
E
E
E
E
E
E
E
E
E
E
E
E
E
E
E
E
E
f
"}
(7,1,1) = {"
f
E
E
E
E
E
a
a
a
a
a
a
a
a
a
a
a
a
a
a
a
a
a
a
E
E
E
E
E
f
"}
(8,1,1) = {"
f
E
E
E
E
E
a
N
k
o
k
N
N
k
o
k
N
a
Z
C
o
C
Z
a
E
E
E
E
E
f
"}
(9,1,1) = {"
f
E
E
E
E
E
a
k
k
o
k
k
k
k
o
k
k
a
Y
k
o
k
l
a
E
E
E
E
E
f
"}
(10,1,1) = {"
f
E
E
E
E
E
a
o
o
o
o
o
o
o
o
o
o
a
b
k
o
k
b
a
E
E
E
E
E
f
"}
(11,1,1) = {"
f
E
E
E
E
E
a
k
k
o
k
k
k
k
k
k
k
a
o
o
o
o
o
a
E
E
E
E
E
f
"}
(12,1,1) = {"
f
E
E
E
E
E
a
K
k
o
k
k
k
k
k
k
k
a
k
k
k
k
k
a
E
E
E
E
E
f
"}
(13,1,1) = {"
f
E
E
E
E
E
a
k
k
o
k
b
k
d
b
k
k
a
k
k
k
k
k
a
E
E
E
E
E
f
"}
(14,1,1) = {"
f
E
E
E
E
E
a
o
o
o
k
b
k
k
b
k
k
a
a
a
q
a
a
a
E
E
E
E
E
f
"}
(15,1,1) = {"
f
E
E
E
E
E
a
K
k
o
k
b
k
k
b
k
k
q
k
k
k
k
k
q
E
E
E
E
E
f
"}
(16,1,1) = {"
f
E
E
E
E
E
a
K
k
o
k
b
k
r
b
k
k
q
k
k
k
k
k
q
E
E
E
E
E
f
"}
(17,1,1) = {"
f
E
E
E
E
E
a
o
o
o
k
b
k
k
b
k
k
a
a
a
q
a
a
a
E
E
E
E
E
f
"}
(18,1,1) = {"
f
E
E
E
E
E
a
k
k
o
k
b
k
G
b
k
k
a
S
k
k
k
X
a
E
E
E
E
E
f
"}
(19,1,1) = {"
f
E
E
E
E
E
a
K
k
o
k
k
k
k
k
k
k
a
s
k
k
k
p
a
E
E
E
E
E
f
"}
(20,1,1) = {"
f
E
E
E
E
E
a
k
k
o
k
k
k
k
k
k
k
a
w
k
k
k
P
a
E
E
E
E
E
f
"}
(21,1,1) = {"
f
E
E
E
E
E
a
o
o
o
o
o
o
o
o
o
o
a
j
B
k
x
w
a
E
E
E
E
E
f
"}
(22,1,1) = {"
f
E
E
E
E
E
a
k
k
o
k
k
k
k
o
k
k
a
M
k
k
k
s
a
E
E
E
E
E
f
"}
(23,1,1) = {"
f
E
E
E
E
E
a
N
k
o
k
N
N
k
o
k
N
a
u
k
k
k
v
a
E
E
E
E
E
f
"}
(24,1,1) = {"
f
E
E
E
E
E
a
a
a
a
a
a
a
a
a
a
a
a
a
a
a
a
a
a
E
E
E
E
E
f
"}
(25,1,1) = {"
f
E
E
E
E
E
E
E
E
E
E
E
E
E
E
E
E
E
E
E
E
E
E
E
E
E
E
E
E
f
"}
(26,1,1) = {"
f
E
E
E
E
E
E
E
E
E
E
E
E
E
E
E
E
E
E
E
E
E
E
E
E
E
E
E
E
f
"}
(27,1,1) = {"
f
E
E
E
E
E
E
E
E
E
E
E
E
E
E
E
E
E
E
E
E
E
E
E
E
E
E
E
E
f
"}
(28,1,1) = {"
f
E
E
E
E
E
E
E
E
E
E
E
E
E
E
E
E
E
E
E
E
E
E
E
E
E
E
E
E
f
"}
(29,1,1) = {"
f
E
E
E
E
E
E
E
E
E
E
E
E
E
E
E
E
E
E
E
E
E
E
E
E
E
E
E
E
f
"}
(30,1,1) = {"
f
f
f
f
f
f
f
f
f
f
f
f
f
f
f
f
f
f
f
f
f
f
f
f
f
f
f
f
f
f
"}
