//MAP CONVERTED BY dmm2tgm.py THIS HEADER COMMENT PREVENTS RECONVERSION, DO NOT REMOVE
"a" = (
/turf/template_noop,
/area/submap/crystalcore/dark/three)
"g" = (
/turf/simulated/mineral/light,
/area/template_noop)
"j" = (
/obj/structure/table/darkglass,
/obj/item/weapon/paper{
	info = "The magma manpulatior is in place and functioning. Operation progress minimal.";
	name = "Operation"
	},
/turf/simulated/shuttle/floor/alien/blue,
/area/submap/crystalcore/dark/three)
"r" = (
/turf/simulated/floor/lava,
/area/submap/crystalcore/dark/three)
"v" = (
/obj/structure/table/darkglass,
/turf/simulated/shuttle/floor/alien/blue,
/area/submap/crystalcore/dark/three)
"x" = (
/turf/simulated/shuttle/wall/alien/blue,
/area/submap/crystalcore/dark/three)
"y" = (
/obj/item/device/perfect_tele/alien,
/obj/structure/table/darkglass,
/turf/simulated/shuttle/floor/alien/blue,
/area/submap/crystalcore/dark/three)
"B" = (
/turf/simulated/shuttle/floor/alien/blue,
/area/submap/crystalcore/dark/three)
"D" = (
/turf/simulated/mineral/light,
/area/submap/crystalcore/dark/three)
"J" = (
/turf/template_noop,
/area/template_noop)
"P" = (
/obj/machinery/door/airlock/alien/blue,
/turf/simulated/shuttle/floor/alien/blue,
/area/submap/crystalcore/dark/three)
"Z" = (
/obj/machinery/porta_turret/alien,
/turf/simulated/shuttle/floor/alien/blue,
/area/submap/crystalcore/dark/three)

(1,1,1) = {"
J
J
J
J
J
J
g
g
g
g
g
g
g
g
g
g
g
g
g
g
g
g
g
g
J
J
J
J
J
J
"}
(2,1,1) = {"
J
a
a
a
a
D
D
r
r
r
r
r
r
r
r
r
r
r
r
r
r
r
r
D
D
a
a
a
a
J
"}
(3,1,1) = {"
J
a
a
a
D
D
r
r
r
r
r
r
r
r
r
r
r
r
r
r
r
r
r
r
D
D
a
a
a
J
"}
(4,1,1) = {"
J
a
a
D
D
r
r
r
r
r
r
r
r
r
r
r
r
r
r
r
r
r
r
r
r
D
D
a
a
J
"}
(5,1,1) = {"
J
a
D
D
r
r
r
r
r
r
r
r
r
r
r
r
r
r
r
r
r
r
r
r
r
r
D
D
a
J
"}
(6,1,1) = {"
J
D
D
r
r
r
r
r
r
r
r
r
r
r
r
r
r
r
r
r
r
r
r
r
r
r
r
D
D
J
"}
(7,1,1) = {"
g
D
r
r
r
r
r
r
r
r
r
r
r
r
r
r
r
r
r
r
r
r
r
r
r
r
r
r
D
g
"}
(8,1,1) = {"
g
r
r
r
r
r
r
r
r
r
r
r
x
x
x
x
x
x
r
r
r
r
r
r
r
r
r
r
r
g
"}
(9,1,1) = {"
g
r
r
r
r
r
r
r
r
r
r
x
x
Z
B
B
Z
x
x
r
r
r
r
r
r
r
r
r
r
g
"}
(10,1,1) = {"
g
r
r
r
r
r
r
r
r
r
x
x
B
B
B
B
B
B
x
x
r
r
r
r
r
r
r
r
r
g
"}
(11,1,1) = {"
g
r
r
r
r
r
r
r
r
x
x
B
B
B
B
B
B
B
B
x
x
r
r
r
r
r
r
r
r
g
"}
(12,1,1) = {"
g
r
r
r
r
r
r
r
x
x
B
B
B
x
x
x
x
B
B
B
x
x
r
r
r
r
r
r
r
g
"}
(13,1,1) = {"
g
r
r
r
r
r
r
x
x
B
B
B
x
x
v
y
x
x
B
B
B
x
x
r
r
r
r
r
r
g
"}
(14,1,1) = {"
g
r
r
r
r
r
r
x
Z
B
B
x
x
Z
B
B
Z
x
x
B
B
B
x
r
r
r
r
r
r
g
"}
(15,1,1) = {"
g
r
r
r
r
r
r
x
B
B
B
P
B
B
B
B
B
v
x
B
B
B
P
r
r
r
r
r
r
g
"}
(16,1,1) = {"
g
r
r
r
r
r
r
x
B
B
B
P
B
B
B
B
B
j
x
B
B
B
P
r
r
r
r
r
r
g
"}
(17,1,1) = {"
g
r
r
r
r
r
r
x
Z
B
B
x
x
Z
B
B
Z
x
x
B
B
B
x
r
r
r
r
r
r
g
"}
(18,1,1) = {"
g
r
r
r
r
r
r
x
x
B
B
B
x
x
v
y
x
x
B
B
B
x
x
r
r
r
r
r
r
g
"}
(19,1,1) = {"
g
r
r
r
r
r
r
r
x
x
B
B
B
x
x
x
x
B
B
B
x
x
r
r
r
r
r
r
r
g
"}
(20,1,1) = {"
g
r
r
r
r
r
r
r
r
x
x
B
B
B
B
B
B
B
B
x
x
r
r
r
r
r
r
r
r
g
"}
(21,1,1) = {"
g
r
r
r
r
r
r
r
r
r
x
x
B
B
B
B
B
B
x
x
r
r
r
r
r
r
r
r
r
g
"}
(22,1,1) = {"
g
r
r
r
r
r
r
r
r
r
r
x
x
Z
B
B
Z
x
x
r
r
r
r
r
r
r
r
r
r
g
"}
(23,1,1) = {"
g
r
r
r
r
r
r
r
r
r
r
r
x
x
x
x
x
x
r
r
r
r
r
r
r
r
r
r
r
g
"}
(24,1,1) = {"
g
D
r
r
r
r
r
r
r
r
r
r
r
r
r
r
r
r
r
r
r
r
r
r
r
r
r
r
D
g
"}
(25,1,1) = {"
J
D
D
r
r
r
r
r
r
r
r
r
r
r
r
r
r
r
r
r
r
r
r
r
r
r
r
D
D
J
"}
(26,1,1) = {"
J
a
D
D
r
r
r
r
r
r
r
r
r
r
r
r
r
r
r
r
r
r
r
r
r
r
D
D
a
J
"}
(27,1,1) = {"
J
a
a
D
D
r
r
r
r
r
r
r
r
r
r
r
r
r
r
r
r
r
r
r
r
D
D
a
a
J
"}
(28,1,1) = {"
J
a
a
a
D
D
r
r
r
r
r
r
r
r
r
r
r
r
r
r
r
r
r
r
D
D
a
a
a
J
"}
(29,1,1) = {"
J
a
a
a
a
D
D
r
r
r
r
r
r
r
r
r
r
r
r
r
r
r
r
D
D
a
a
a
a
J
"}
(30,1,1) = {"
J
J
J
J
J
J
g
g
g
g
g
g
g
g
g
g
g
g
g
g
g
g
g
g
J
J
J
J
J
J
"}
