//MAP CONVERTED BY dmm2tgm.py THIS HEADER COMMENT PREVENTS RECONVERSION, DO NOT REMOVE
"a" = (
/obj/effect/alien/weeds,
/turf/simulated/floor/outdoors/crystal_planet/darksand,
/area/submap/crystalcore/dark/twelve)
"d" = (
/obj/effect/alien/weeds,
/mob/living/simple_mob/animal/space/alien/sentinel/praetorian,
/turf/simulated/floor/outdoors/crystal_planet/darksand,
/area/submap/crystalcore/dark/twelve)
"i" = (
/obj/item/weapon/storage/vore_egg/xenomorph,
/obj/effect/alien/weeds/node,
/obj/item/organ/internal/augment/armmounted/hand/sword,
/turf/simulated/floor/outdoors/crystal_planet/darksand,
/area/submap/crystalcore/dark/twelve)
"k" = (
/obj/effect/alien/weeds,
/mob/living/simple_mob/animal/space/alien/queen/empress/mother,
/turf/simulated/floor/outdoors/crystal_planet/darksand,
/area/submap/crystalcore/dark/twelve)
"o" = (
/obj/effect/alien/weeds/node,
/turf/simulated/floor/outdoors/crystal_planet/darksand,
/area/submap/crystalcore/dark/twelve)
"t" = (
/obj/structure/alien/wall,
/turf/simulated/mineral/darkcrystal,
/area/submap/crystalcore/dark/twelve)
"y" = (
/obj/item/weapon/storage/vore_egg/xenomorph,
/obj/effect/alien/weeds/node,
/obj/item/weapon/rig/hazard,
/turf/simulated/floor/outdoors/crystal_planet/darksand,
/area/submap/crystalcore/dark/twelve)
"E" = (
/obj/effect/alien/weeds,
/mob/living/simple_mob/animal/space/alien,
/turf/simulated/floor/outdoors/crystal_planet/darksand,
/area/submap/crystalcore/dark/twelve)
"J" = (
/turf/template_noop,
/area/template_noop)
"L" = (
/obj/effect/alien/weeds,
/obj/structure/alien/wall,
/turf/simulated/floor/outdoors/crystal_planet/darksand,
/area/submap/crystalcore/dark/twelve)
"P" = (
/turf/template_noop,
/area/submap/crystalcore/dark/twelve)
"S" = (
/obj/item/weapon/storage/vore_egg/xenomorph,
/obj/effect/alien/weeds/node,
/obj/item/organ/internal/augment/bioaugment/sprint_enhance,
/turf/simulated/floor/outdoors/crystal_planet/darksand,
/area/submap/crystalcore/dark/twelve)

(1,1,1) = {"
J
J
J
J
J
J
J
J
J
J
J
J
J
J
J
J
J
J
J
J
J
J
J
J
J
J
J
J
J
J
"}
(2,1,1) = {"
J
P
P
P
P
P
P
P
P
P
P
P
P
P
P
P
P
P
P
P
P
P
P
P
P
P
P
P
P
J
"}
(3,1,1) = {"
J
P
P
P
P
P
P
P
P
P
P
P
P
P
P
P
P
P
P
P
P
P
P
P
P
P
P
P
P
J
"}
(4,1,1) = {"
J
P
P
P
P
P
P
P
P
P
P
P
t
P
P
P
P
t
P
P
P
P
P
P
P
P
P
P
P
J
"}
(5,1,1) = {"
J
P
P
P
P
P
P
P
P
P
P
t
t
a
a
a
a
t
t
P
P
P
P
P
P
P
P
P
P
J
"}
(6,1,1) = {"
J
P
P
P
P
P
P
P
P
P
t
t
a
a
a
a
a
a
t
t
P
P
P
P
P
P
P
P
P
J
"}
(7,1,1) = {"
J
P
P
P
P
P
P
P
P
t
t
E
a
a
a
a
a
a
a
t
t
P
P
P
P
P
P
P
P
J
"}
(8,1,1) = {"
J
P
P
P
P
P
P
P
t
t
a
a
E
a
a
a
a
a
E
a
t
t
P
P
P
P
P
P
P
J
"}
(9,1,1) = {"
J
P
P
P
P
P
P
t
t
a
a
a
a
L
L
L
L
E
a
a
a
t
t
P
P
P
P
P
P
J
"}
(10,1,1) = {"
J
P
P
P
P
P
t
t
a
a
a
a
L
L
a
a
L
L
a
a
a
a
t
t
P
P
P
P
P
J
"}
(11,1,1) = {"
J
P
P
P
P
t
t
a
a
a
a
a
L
a
a
a
a
L
a
a
a
a
a
t
t
P
P
P
P
J
"}
(12,1,1) = {"
J
P
P
P
t
t
E
a
a
a
a
o
a
a
a
a
a
a
o
a
a
a
E
a
t
t
P
P
P
J
"}
(13,1,1) = {"
J
P
P
t
t
a
a
E
a
L
L
a
a
L
k
a
L
a
a
L
L
E
a
a
a
t
t
P
P
J
"}
(14,1,1) = {"
J
P
P
P
a
a
a
a
L
L
a
a
L
L
a
a
L
L
a
a
L
L
a
a
a
a
P
P
P
J
"}
(15,1,1) = {"
J
P
P
P
a
a
a
a
L
a
d
a
a
a
S
y
a
a
d
a
a
L
a
a
a
a
P
P
P
J
"}
(16,1,1) = {"
J
P
P
P
a
a
a
a
L
a
a
a
a
a
y
i
a
a
a
a
a
L
a
a
a
a
P
P
P
J
"}
(17,1,1) = {"
J
P
P
P
a
a
a
a
L
L
a
a
L
L
a
a
L
L
a
a
L
L
a
a
a
a
P
P
P
J
"}
(18,1,1) = {"
J
P
P
t
t
a
a
E
a
L
L
a
a
L
d
a
L
a
a
L
L
E
a
a
a
t
t
P
P
J
"}
(19,1,1) = {"
J
P
P
P
t
t
E
a
a
a
a
o
a
a
a
a
a
a
o
a
a
a
E
a
t
t
P
P
P
J
"}
(20,1,1) = {"
J
P
P
P
P
t
t
a
a
a
a
a
L
a
a
a
a
L
a
a
a
a
a
t
t
P
P
P
P
J
"}
(21,1,1) = {"
J
P
P
P
P
P
t
t
a
a
a
a
L
L
a
a
L
L
a
a
a
a
t
t
P
P
P
P
P
J
"}
(22,1,1) = {"
J
P
P
P
P
P
P
t
t
a
a
E
a
L
L
L
L
E
a
a
a
t
t
P
P
P
P
P
P
J
"}
(23,1,1) = {"
J
P
P
P
P
P
P
P
t
t
E
a
a
a
a
a
a
a
E
a
t
t
P
P
P
P
P
P
P
J
"}
(24,1,1) = {"
J
P
P
P
P
P
P
P
P
t
t
a
a
a
a
a
a
a
a
t
t
P
P
P
P
P
P
P
P
J
"}
(25,1,1) = {"
J
P
P
P
P
P
P
P
P
P
t
t
a
a
a
a
a
a
t
t
P
P
P
P
P
P
P
P
P
J
"}
(26,1,1) = {"
J
P
P
P
P
P
P
P
P
P
P
t
t
a
a
a
a
t
t
P
P
P
P
P
P
P
P
P
P
J
"}
(27,1,1) = {"
J
P
P
P
P
P
P
P
P
P
P
P
t
P
P
P
P
t
P
P
P
P
P
P
P
P
P
P
P
J
"}
(28,1,1) = {"
J
P
P
P
P
P
P
P
P
P
P
P
P
P
P
P
P
P
P
P
P
P
P
P
P
P
P
P
P
J
"}
(29,1,1) = {"
J
P
P
P
P
P
P
P
P
P
P
P
P
P
P
P
P
P
P
P
P
P
P
P
P
P
P
P
P
J
"}
(30,1,1) = {"
J
J
J
J
J
J
J
J
J
J
J
J
J
J
J
J
J
J
J
J
J
J
J
J
J
J
J
J
J
J
"}
