//MAP CONVERTED BY dmm2tgm.py THIS HEADER COMMENT PREVENTS RECONVERSION, DO NOT REMOVE
"a" = (
/turf/simulated/floor/outdoors/ice/dark{
	nitrogen = 82.1472;
	oxygen = 21.8366;
	temperature = 293.15
	},
/area/submap/crystalcore/dark/two)
"c" = (
/turf/simulated/wall/dungeon,
/area/submap/crystalcore/dark/two)
"e" = (
/turf/simulated/floor/dungeon,
/area/submap/crystalcore/dark/two)
"n" = (
/obj/structure/loot_pile/surface/alien/end,
/turf/simulated/floor/dungeon,
/area/submap/crystalcore/dark/two)
"r" = (
/obj/machinery/crystal/ice,
/turf/simulated/floor/outdoors/ice/dark{
	nitrogen = 82.1472;
	oxygen = 21.8366;
	temperature = 293.15
	},
/area/submap/crystalcore/dark/two)
"z" = (
/turf/template_noop,
/area/submap/crystalcore/dark/two)
"J" = (
/obj/structure/foamedmetal,
/turf/simulated/floor/dungeon,
/area/submap/crystalcore/dark/two)
"T" = (
/turf/template_noop,
/area/template_noop)

(1,1,1) = {"
T
T
T
T
T
T
T
T
T
T
T
T
T
T
T
T
T
T
T
T
T
T
T
T
T
T
T
T
T
T
"}
(2,1,1) = {"
T
z
z
z
z
z
z
z
z
z
z
z
z
z
z
z
z
z
z
z
z
z
z
z
z
z
z
z
z
T
"}
(3,1,1) = {"
T
z
z
z
z
z
z
z
z
z
z
z
z
z
z
z
z
z
z
z
z
z
z
z
z
z
z
z
z
T
"}
(4,1,1) = {"
T
z
z
z
z
z
z
z
z
z
c
c
c
c
J
c
c
c
c
z
z
z
z
z
z
z
z
z
z
T
"}
(5,1,1) = {"
T
z
z
z
z
z
z
z
c
c
c
a
a
a
e
a
a
a
c
c
c
z
z
z
z
z
z
z
z
T
"}
(6,1,1) = {"
T
z
z
z
z
z
z
z
c
a
a
a
a
a
a
a
a
r
a
a
c
z
z
z
z
z
z
z
z
T
"}
(7,1,1) = {"
T
z
z
z
z
z
z
z
c
a
a
a
a
a
a
a
a
a
a
r
c
z
z
z
z
z
z
z
z
T
"}
(8,1,1) = {"
T
z
z
z
z
z
z
z
c
a
a
r
a
a
r
a
a
a
a
a
c
z
z
z
z
z
z
z
z
T
"}
(9,1,1) = {"
T
z
z
z
z
z
z
z
c
c
c
a
a
a
a
a
a
a
c
c
c
z
z
z
z
z
z
z
z
T
"}
(10,1,1) = {"
T
z
z
c
c
c
c
c
z
z
c
a
r
a
a
a
a
a
c
z
z
c
c
c
c
c
z
z
z
T
"}
(11,1,1) = {"
T
z
z
c
a
a
a
c
z
z
c
c
c
a
a
r
c
c
c
z
z
c
a
a
a
c
z
z
z
T
"}
(12,1,1) = {"
T
z
z
c
a
a
a
c
c
c
z
z
c
a
e
a
c
z
z
c
c
c
a
a
a
c
z
z
z
T
"}
(13,1,1) = {"
T
z
z
c
r
a
a
a
a
c
z
z
c
c
e
c
c
z
z
c
a
a
r
a
a
c
z
z
z
T
"}
(14,1,1) = {"
T
z
z
c
a
a
a
a
a
c
c
c
c
e
e
e
c
c
c
c
a
a
a
a
a
c
z
z
z
T
"}
(15,1,1) = {"
T
z
z
c
a
a
a
a
a
a
a
c
e
c
n
c
e
c
a
a
a
a
a
a
a
c
z
z
z
T
"}
(16,1,1) = {"
T
z
z
J
e
r
a
a
a
a
e
e
e
n
c
n
e
e
e
a
r
a
a
a
e
J
z
z
z
T
"}
(17,1,1) = {"
T
z
z
c
a
a
a
a
r
a
a
c
e
c
n
c
e
c
a
a
a
a
a
a
a
c
z
z
z
T
"}
(18,1,1) = {"
T
z
z
c
a
a
a
a
a
c
c
c
c
e
e
e
c
c
c
c
a
a
a
a
a
c
z
z
z
T
"}
(19,1,1) = {"
T
z
z
c
r
a
a
a
a
c
z
z
c
c
e
c
c
z
z
c
a
a
r
a
a
c
z
z
z
T
"}
(20,1,1) = {"
T
z
z
c
a
a
a
c
c
c
z
z
c
a
e
a
c
z
z
c
c
c
a
a
a
c
z
z
z
T
"}
(21,1,1) = {"
T
z
z
c
a
a
a
c
z
z
c
c
c
a
r
a
c
c
c
z
z
c
a
a
a
c
z
z
z
T
"}
(22,1,1) = {"
T
z
z
c
c
c
c
c
z
z
c
r
a
a
a
a
a
a
c
z
z
c
c
c
c
c
z
z
z
T
"}
(23,1,1) = {"
T
z
z
z
z
z
z
z
c
c
c
a
a
r
a
a
a
a
c
c
c
z
z
z
z
z
z
z
z
T
"}
(24,1,1) = {"
T
z
z
z
z
z
z
z
c
a
a
a
a
a
a
a
r
a
a
a
c
z
z
z
z
z
z
z
z
T
"}
(25,1,1) = {"
T
z
z
z
z
z
z
z
c
a
a
r
a
a
a
a
a
a
a
a
c
z
z
z
z
z
z
z
z
T
"}
(26,1,1) = {"
T
z
z
z
z
z
z
z
c
a
a
a
a
a
e
a
a
a
r
a
c
z
z
z
z
z
z
z
z
T
"}
(27,1,1) = {"
T
z
z
z
z
z
z
z
c
c
c
c
c
c
J
c
c
c
c
c
c
z
z
z
z
z
z
z
z
T
"}
(28,1,1) = {"
T
z
z
z
z
z
z
z
z
z
z
z
z
z
z
z
z
z
z
z
z
z
z
z
z
z
z
z
z
T
"}
(29,1,1) = {"
T
z
z
z
z
z
z
z
z
z
z
z
z
z
z
z
z
z
z
z
z
z
z
z
z
z
z
z
z
T
"}
(30,1,1) = {"
T
T
T
T
T
T
T
T
T
T
T
T
T
T
T
T
T
T
T
T
T
T
T
T
T
T
T
T
T
T
"}
