//MAP CONVERTED BY dmm2tgm.py THIS HEADER COMMENT PREVENTS RECONVERSION, DO NOT REMOVE
"aa" = (
/obj/effect/floor_decal/corner/yellow/border{
	dir = 9
	},
/turf/simulated/floor/tiled/white,
/area/submap/blobden)
"ak" = (
/turf/simulated/wall/titanium,
/area/submap/blobden)
"aH" = (
/obj/effect/floor_decal/corner/blue/border{
	dir = 6
	},
/turf/simulated/floor/tiled/white,
/area/submap/blobden)
"aQ" = (
/obj/structure/blob/core/random_hard,
/turf/simulated/floor/tiled/white,
/area/submap/blobden)
"bC" = (
/obj/effect/floor_decal/corner/red/border{
	dir = 9
	},
/turf/simulated/floor/tiled/white,
/area/submap/blobden)
"cq" = (
/obj/effect/floor_decal/corner/orange/border{
	dir = 8
	},
/turf/simulated/floor/tiled/white,
/area/submap/blobden)
"dt" = (
/obj/effect/floor_decal/corner/blue/border,
/turf/simulated/floor/tiled/white,
/area/submap/blobden)
"dS" = (
/obj/effect/floor_decal/corner/green/border{
	dir = 8
	},
/turf/simulated/floor/tiled/white,
/area/submap/blobden)
"eL" = (
/obj/effect/floor_decal/corner/red/border,
/turf/simulated/floor/tiled/white,
/area/submap/blobden)
"eY" = (
/obj/structure/table/borosilicate,
/obj/item/rig_module/rad_shield/advanced,
/turf/simulated/floor/tiled/white,
/area/submap/blobden)
"fb" = (
/obj/effect/floor_decal/corner/orange/border,
/turf/simulated/floor/tiled/white,
/area/submap/blobden)
"gk" = (
/obj/effect/floor_decal/corner/green/border{
	dir = 4
	},
/turf/simulated/floor/tiled/white,
/area/submap/blobden)
"ig" = (
/obj/structure/table/borosilicate,
/obj/item/rig_module/mounted/egun,
/turf/simulated/floor/tiled/white,
/area/submap/blobden)
"iN" = (
/obj/structure/table/borosilicate,
/obj/item/weapon/storage/firstaid/bonemed,
/turf/simulated/floor/tiled/white,
/area/submap/blobden)
"kY" = (
/obj/effect/floor_decal/corner/purple/border,
/turf/simulated/floor/tiled/white,
/area/submap/blobden)
"ls" = (
/obj/effect/floor_decal/corner/blue/border{
	dir = 4
	},
/turf/simulated/floor/tiled/white,
/area/submap/blobden)
"lt" = (
/turf/simulated/mineral,
/area/template_noop)
"lO" = (
/obj/effect/floor_decal/corner/yellow/border{
	dir = 4
	},
/turf/simulated/floor/tiled/white,
/area/submap/blobden)
"nB" = (
/obj/effect/floor_decal/corner/green/bordercorner{
	dir = 1
	},
/obj/effect/floor_decal/corner/orange/bordercorner,
/turf/simulated/floor/tiled/white,
/area/submap/blobden)
"pr" = (
/obj/effect/floor_decal/corner/green/bordercorner,
/obj/effect/floor_decal/corner/orange/bordercorner{
	dir = 1
	},
/turf/simulated/floor/tiled/white,
/area/submap/blobden)
"pU" = (
/turf/simulated/floor/tiled/white,
/area/submap/blobden)
"qc" = (
/obj/machinery/door/airlock/centcom{
	name = "Special Operations";
	req_access = list(103)
	},
/turf/simulated/floor/tiled/white,
/area/submap/blobden)
"qz" = (
/obj/effect/floor_decal/corner/green/border,
/turf/simulated/floor/tiled/white,
/area/submap/blobden)
"qW" = (
/obj/effect/floor_decal/corner/purple/border{
	dir = 8
	},
/turf/simulated/floor/tiled/white,
/area/submap/blobden)
"ry" = (
/obj/effect/floor_decal/corner/red/border{
	dir = 1
	},
/turf/simulated/floor/tiled/white,
/area/submap/blobden)
"sJ" = (
/obj/effect/floor_decal/corner/green/border{
	dir = 10
	},
/turf/simulated/floor/tiled/white,
/area/submap/blobden)
"uj" = (
/obj/effect/floor_decal/corner/purple/border{
	dir = 4
	},
/turf/simulated/floor/tiled/white,
/area/submap/blobden)
"uA" = (
/obj/effect/floor_decal/corner/purple/border{
	dir = 5
	},
/turf/simulated/floor/tiled/white,
/area/submap/blobden)
"wD" = (
/obj/effect/floor_decal/corner/red/border{
	dir = 5
	},
/turf/simulated/floor/tiled/white,
/area/submap/blobden)
"wX" = (
/obj/effect/floor_decal/corner/purple/border{
	dir = 6
	},
/turf/simulated/floor/tiled/white,
/area/submap/blobden)
"xW" = (
/obj/effect/floor_decal/corner/orange/border{
	dir = 1
	},
/turf/simulated/floor/tiled/white,
/area/submap/blobden)
"yW" = (
/obj/effect/floor_decal/corner/purple/border{
	dir = 1
	},
/turf/simulated/floor/tiled/white,
/area/submap/blobden)
"zE" = (
/obj/effect/floor_decal/corner/green/border{
	dir = 1
	},
/turf/simulated/floor/tiled/white,
/area/submap/blobden)
"Ac" = (
/obj/effect/floor_decal/corner/blue/border{
	dir = 8
	},
/turf/simulated/floor/tiled/white,
/area/submap/blobden)
"AJ" = (
/obj/structure/table/borosilicate,
/obj/item/weapon/cell/device/weapon/empproof,
/obj/item/weapon/cell/device/weapon/empproof,
/obj/item/weapon/cell/device/weapon/empproof,
/obj/item/weapon/cell/device/weapon/empproof,
/turf/simulated/floor/tiled/white,
/area/submap/blobden)
"Bc" = (
/obj/effect/floor_decal/corner/purple/border{
	dir = 10
	},
/turf/simulated/floor/tiled/white,
/area/submap/blobden)
"Bw" = (
/obj/effect/floor_decal/corner/yellow/border{
	dir = 1
	},
/turf/simulated/floor/tiled/white,
/area/submap/blobden)
"Db" = (
/obj/structure/table/borosilicate,
/obj/random/maintenance/security,
/obj/random/maintenance/security,
/obj/random/maintenance/security,
/turf/simulated/floor/tiled/white,
/area/submap/blobden)
"DR" = (
/obj/effect/floor_decal/corner/green/border{
	dir = 6
	},
/turf/simulated/floor/tiled/white,
/area/submap/blobden)
"Fe" = (
/obj/structure/table/borosilicate,
/obj/item/rig_module/chem_dispenser/combat,
/turf/simulated/floor/tiled/white,
/area/submap/blobden)
"FA" = (
/obj/effect/floor_decal/corner/blue/border{
	dir = 9
	},
/turf/simulated/floor/tiled/white,
/area/submap/blobden)
"FC" = (
/obj/effect/floor_decal/corner/green/bordercorner{
	dir = 4
	},
/obj/effect/floor_decal/corner/orange/bordercorner{
	dir = 8
	},
/turf/simulated/floor/tiled/white,
/area/submap/blobden)
"FL" = (
/obj/effect/floor_decal/corner/yellow/border{
	dir = 5
	},
/turf/simulated/floor/tiled/white,
/area/submap/blobden)
"Gy" = (
/obj/effect/floor_decal/corner/blue/border{
	dir = 10
	},
/turf/simulated/floor/tiled/white,
/area/submap/blobden)
"Ha" = (
/obj/structure/table/borosilicate,
/obj/random/maintenance/research,
/obj/random/maintenance/research,
/obj/random/maintenance/research,
/turf/simulated/floor/tiled/white,
/area/submap/blobden)
"Hs" = (
/obj/structure/table/borosilicate,
/obj/random/maintenance/engineering,
/obj/random/maintenance/engineering,
/obj/random/maintenance/engineering,
/turf/simulated/floor/tiled/white,
/area/submap/blobden)
"HQ" = (
/obj/structure/table/borosilicate,
/obj/random/energy/sec,
/turf/simulated/floor/tiled/white,
/area/submap/blobden)
"Iv" = (
/obj/effect/floor_decal/corner/green/border{
	dir = 5
	},
/turf/simulated/floor/tiled/white,
/area/submap/blobden)
"IC" = (
/obj/effect/floor_decal/corner/blue/border{
	dir = 1
	},
/turf/simulated/floor/tiled/white,
/area/submap/blobden)
"Kc" = (
/obj/effect/floor_decal/corner/red/border{
	dir = 6
	},
/turf/simulated/floor/tiled/white,
/area/submap/blobden)
"La" = (
/obj/effect/floor_decal/corner/yellow/border,
/turf/simulated/floor/tiled/white,
/area/submap/blobden)
"NS" = (
/obj/structure/table/borosilicate,
/obj/random/maintenance/medical,
/obj/random/maintenance/medical,
/obj/random/maintenance/medical,
/turf/simulated/floor/tiled/white,
/area/submap/blobden)
"OA" = (
/obj/structure/table/borosilicate,
/obj/random/energy/highend,
/turf/simulated/floor/tiled/white,
/area/submap/blobden)
"PM" = (
/obj/effect/floor_decal/corner/green/border{
	dir = 9
	},
/turf/simulated/floor/tiled/white,
/area/submap/blobden)
"Qg" = (
/obj/structure/table/borosilicate,
/obj/item/rig_module/grenade_launcher/metalfoam,
/turf/simulated/floor/tiled/white,
/area/submap/blobden)
"Qp" = (
/obj/effect/floor_decal/corner/red/border{
	dir = 4
	},
/turf/simulated/floor/tiled/white,
/area/submap/blobden)
"RM" = (
/obj/effect/floor_decal/corner/orange/border{
	dir = 4
	},
/turf/simulated/floor/tiled/white,
/area/submap/blobden)
"SR" = (
/obj/effect/floor_decal/corner/purple/border{
	dir = 9
	},
/turf/simulated/floor/tiled/white,
/area/submap/blobden)
"Tq" = (
/obj/effect/floor_decal/corner/blue/border{
	dir = 5
	},
/turf/simulated/floor/tiled/white,
/area/submap/blobden)
"TK" = (
/obj/effect/floor_decal/corner/red/border{
	dir = 8
	},
/turf/simulated/floor/tiled/white,
/area/submap/blobden)
"Uv" = (
/obj/effect/floor_decal/corner/green/bordercorner{
	dir = 8
	},
/obj/effect/floor_decal/corner/orange/bordercorner{
	dir = 4
	},
/turf/simulated/floor/tiled/white,
/area/submap/blobden)
"Vm" = (
/obj/effect/floor_decal/corner/yellow/border{
	dir = 6
	},
/turf/simulated/floor/tiled/white,
/area/submap/blobden)
"WE" = (
/obj/effect/floor_decal/corner/yellow/border{
	dir = 8
	},
/turf/simulated/floor/tiled/white,
/area/submap/blobden)
"WG" = (
/obj/effect/floor_decal/corner/red/border{
	dir = 10
	},
/turf/simulated/floor/tiled/white,
/area/submap/blobden)
"Yd" = (
/obj/effect/floor_decal/corner/yellow/border{
	dir = 10
	},
/turf/simulated/floor/tiled/white,
/area/submap/blobden)

(1,1,1) = {"
lt
lt
lt
lt
lt
lt
lt
lt
lt
lt
lt
lt
lt
lt
lt
lt
lt
lt
lt
lt
lt
lt
lt
"}
(2,1,1) = {"
lt
lt
lt
lt
lt
lt
lt
lt
lt
lt
lt
lt
lt
lt
lt
lt
lt
lt
lt
lt
lt
lt
lt
"}
(3,1,1) = {"
lt
lt
lt
lt
lt
lt
lt
lt
lt
lt
lt
lt
lt
lt
lt
lt
lt
lt
lt
lt
lt
lt
lt
"}
(4,1,1) = {"
lt
lt
lt
lt
lt
lt
lt
lt
lt
lt
lt
lt
lt
lt
lt
lt
lt
lt
lt
lt
lt
lt
lt
"}
(5,1,1) = {"
lt
lt
lt
lt
ak
ak
ak
ak
ak
ak
ak
ak
ak
ak
ak
ak
ak
ak
ak
lt
lt
lt
lt
"}
(6,1,1) = {"
lt
lt
lt
lt
ak
FA
Ac
Ac
Gy
ak
PM
dS
sJ
ak
SR
qW
qW
Bc
ak
lt
lt
lt
lt
"}
(7,1,1) = {"
lt
lt
lt
lt
ak
IC
iN
NS
dt
ak
zE
pU
qz
ak
yW
Ha
OA
kY
ak
lt
lt
lt
lt
"}
(8,1,1) = {"
lt
lt
lt
lt
ak
IC
NS
Fe
dt
ak
zE
pU
qz
ak
yW
Qg
Ha
kY
ak
lt
lt
lt
lt
"}
(9,1,1) = {"
lt
lt
lt
lt
ak
Tq
ls
ls
aH
qc
zE
pU
qz
qc
uA
uj
uj
wX
ak
lt
lt
lt
lt
"}
(10,1,1) = {"
lt
lt
lt
lt
ak
ak
ak
ak
qc
ak
zE
pU
qz
ak
qc
ak
ak
ak
ak
lt
lt
lt
lt
"}
(11,1,1) = {"
lt
lt
lt
lt
ak
PM
dS
dS
dS
dS
nB
RM
Uv
dS
dS
dS
dS
sJ
ak
lt
lt
lt
lt
"}
(12,1,1) = {"
lt
lt
lt
lt
ak
zE
pU
pU
pU
pU
fb
aQ
xW
pU
pU
pU
pU
qz
ak
lt
lt
lt
lt
"}
(13,1,1) = {"
lt
lt
lt
lt
ak
Iv
gk
gk
gk
gk
FC
cq
pr
gk
gk
gk
gk
DR
ak
lt
lt
lt
lt
"}
(14,1,1) = {"
lt
lt
lt
lt
ak
ak
ak
ak
qc
ak
zE
pU
qz
ak
qc
ak
ak
ak
ak
lt
lt
lt
lt
"}
(15,1,1) = {"
lt
lt
lt
lt
ak
aa
WE
WE
Yd
qc
zE
pU
qz
qc
bC
TK
TK
WG
ak
lt
lt
lt
lt
"}
(16,1,1) = {"
lt
lt
lt
lt
ak
Bw
Hs
eY
La
ak
zE
pU
qz
ak
ry
ig
Db
eL
ak
lt
lt
lt
lt
"}
(17,1,1) = {"
lt
lt
lt
lt
ak
Bw
AJ
Hs
La
ak
zE
pU
qz
ak
ry
Db
HQ
eL
ak
lt
lt
lt
lt
"}
(18,1,1) = {"
lt
lt
lt
lt
ak
FL
lO
lO
Vm
ak
Iv
gk
DR
ak
wD
Qp
Qp
Kc
ak
lt
lt
lt
lt
"}
(19,1,1) = {"
lt
lt
lt
lt
ak
ak
ak
ak
ak
ak
ak
ak
ak
ak
ak
ak
ak
ak
ak
lt
lt
lt
lt
"}
(20,1,1) = {"
lt
lt
lt
lt
lt
lt
lt
lt
lt
lt
lt
lt
lt
lt
lt
lt
lt
lt
lt
lt
lt
lt
lt
"}
(21,1,1) = {"
lt
lt
lt
lt
lt
lt
lt
lt
lt
lt
lt
lt
lt
lt
lt
lt
lt
lt
lt
lt
lt
lt
lt
"}
(22,1,1) = {"
lt
lt
lt
lt
lt
lt
lt
lt
lt
lt
lt
lt
lt
lt
lt
lt
lt
lt
lt
lt
lt
lt
lt
"}
(23,1,1) = {"
lt
lt
lt
lt
lt
lt
lt
lt
lt
lt
lt
lt
lt
lt
lt
lt
lt
lt
lt
lt
lt
lt
lt
"}
