//MAP CONVERTED BY dmm2tgm.py THIS HEADER COMMENT PREVENTS RECONVERSION, DO NOT REMOVE
"aq" = (
/obj/structure/table/sifwoodentable,
/obj/item/weapon/flame/candle/candelabra/everburn,
/turf/simulated/floor/wood/sif,
/area/submap/bloodchurch)
"ce" = (
/mob/living/simple_mob/vore/demonAI/wendigo{
	faction = "cult"
	},
/turf/simulated/floor/wood/sif,
/area/submap/bloodchurch)
"dF" = (
/mob/living/simple_mob/humanoid/cultist/hunter,
/turf/simulated/floor/wood/sif,
/area/submap/bloodchurch)
"eT" = (
/obj/structure/cliff/automatic{
	dir = 2
	},
/turf/simulated/floor/outdoors/dirt,
/area/submap/bloodchurch)
"fb" = (
/obj/structure/table/sifwoodentable,
/obj/random/meat,
/obj/random/meat,
/obj/random/meat,
/obj/random/meat,
/turf/simulated/floor/wood/sif,
/area/submap/bloodchurch)
"fn" = (
/obj/effect/decal/cleanable/blood/gibs,
/obj/structure/closet/crate/secure/loot,
/obj/item/clothing/gloves/regen,
/turf/simulated/floor/wood/sif,
/area/submap/bloodchurch)
"fQ" = (
/obj/structure/table/sifwoodentable,
/obj/random/medical/pillbottle,
/turf/simulated/floor/wood/sif,
/area/submap/bloodchurch)
"gM" = (
/obj/structure/bookcase,
/turf/simulated/floor/wood/sif,
/area/submap/bloodchurch)
"hQ" = (
/obj/structure/bed/double/padded,
/mob/living/simple_mob/humanoid/cultist/castertesh,
/obj/item/weapon/bedsheet/hosdouble,
/turf/simulated/floor/wood/sif,
/area/submap/bloodchurch)
"il" = (
/obj/structure/closet,
/obj/random/energy/highend,
/turf/simulated/floor/wood/sif,
/area/submap/bloodchurch)
"iT" = (
/obj/structure/kitchenspike,
/turf/simulated/floor/wood/sif,
/area/submap/bloodchurch)
"jP" = (
/mob/living/simple_mob/construct/artificer/caster,
/turf/simulated/floor/outdoors/dirt,
/area/submap/bloodchurch)
"kn" = (
/obj/structure/loot_pile/surface/bones,
/turf/simulated/floor/wood/sif,
/area/submap/bloodchurch)
"lt" = (
/obj/effect/decal/cleanable/blood/gibs,
/turf/simulated/floor/wood/sif,
/area/submap/bloodchurch)
"mn" = (
/obj/item/clothing/suit/wizrobe/psypurple,
/turf/simulated/floor/wood/sif,
/area/submap/bloodchurch)
"oI" = (
/obj/structure/table/bench/sifwooden/padded,
/mob/living/simple_mob/humanoid/cultist/human/bloodjaunt,
/turf/simulated/floor/wood/sif,
/area/submap/bloodchurch)
"pJ" = (
/obj/structure/table/bench/sifwooden/padded,
/turf/simulated/floor/wood/sif,
/area/submap/bloodchurch)
"pL" = (
/mob/living/simple_mob/humanoid/cultist/noodle,
/turf/simulated/floor/wood/sif,
/area/submap/bloodchurch)
"qb" = (
/obj/structure/bed/double/padded,
/mob/living/simple_mob/humanoid/cultist/human/bloodjaunt,
/obj/item/weapon/bedsheet/hosdouble,
/turf/simulated/floor/wood/sif,
/area/submap/bloodchurch)
"rQ" = (
/turf/simulated/floor/wood/sif,
/area/submap/bloodchurch)
"sy" = (
/obj/structure/table/rack,
/obj/item/clothing/suit/storage/hooded/wintercoat/narsie,
/obj/item/clothing/suit/storage/hooded/wintercoat/narsie,
/turf/simulated/floor/wood/sif,
/area/submap/bloodchurch)
"tW" = (
/obj/structure/table/bench/sifwooden/padded,
/mob/living/simple_mob/humanoid/cultist/castertesh,
/turf/simulated/floor/wood/sif,
/area/submap/bloodchurch)
"wh" = (
/mob/living/simple_mob/humanoid/cultist/elite,
/turf/simulated/floor/wood/sif,
/area/submap/bloodchurch)
"wA" = (
/obj/item/clothing/head/wizard/amp,
/mob/living/simple_mob/construct/shade,
/turf/simulated/floor/wood/sif,
/area/submap/bloodchurch)
"xJ" = (
/obj/structure/closet/crate,
/obj/item/stolenpackage,
/obj/item/stolenpackage,
/obj/item/stolenpackage,
/obj/item/rig_module/vision/thermal,
/turf/simulated/floor/wood/sif,
/area/submap/bloodchurch)
"xN" = (
/obj/structure/table/sifwoodentable,
/obj/random/firstaid,
/turf/simulated/floor/wood/sif,
/area/submap/bloodchurch)
"yn" = (
/obj/structure/cliff/automatic{
	dir = 8
	},
/turf/simulated/floor/outdoors/dirt,
/area/submap/bloodchurch)
"yo" = (
/obj/structure/table/bench/sifwooden/padded,
/mob/living/simple_mob/humanoid/cultist/lizard,
/turf/simulated/floor/wood/sif,
/area/submap/bloodchurch)
"yC" = (
/turf/simulated/floor/outdoors/dirt,
/area/submap/bloodchurch)
"yD" = (
/obj/structure/table/sifwoodentable,
/obj/item/weapon/spellbook/oneuse/forcewall,
/turf/simulated/floor/wood/sif,
/area/submap/bloodchurch)
"zB" = (
/obj/structure/cliff/automatic/corner{
	dir = 9
	},
/turf/simulated/floor/outdoors/dirt,
/area/submap/bloodchurch)
"zO" = (
/obj/item/clothing/suit/wizrobe,
/mob/living/simple_mob/construct/shade,
/turf/simulated/floor/wood/sif,
/area/submap/bloodchurch)
"Ac" = (
/obj/structure/table/sifwoodentable,
/obj/item/weapon/flame/candle/everburn,
/turf/simulated/floor/wood/sif,
/area/submap/bloodchurch)
"AL" = (
/turf/template_noop,
/area/template_noop)
"AZ" = (
/obj/item/clothing/suit/wizrobe,
/turf/simulated/floor/wood/sif,
/area/submap/bloodchurch)
"DJ" = (
/obj/structure/table/sifwoodentable,
/obj/item/clothing/head/psy_crown/wrath,
/turf/simulated/floor/wood/sif,
/area/submap/bloodchurch)
"EZ" = (
/obj/structure/loot_pile/surface/bones,
/obj/item/weapon/storage/backpack/dufflebag/syndie,
/turf/simulated/floor/wood/sif,
/area/submap/bloodchurch)
"FG" = (
/obj/structure/table/sifwoodentable,
/obj/random/meat,
/obj/random/meat,
/obj/random/meat,
/obj/random/meat,
/obj/random/meat,
/turf/simulated/floor/wood/sif,
/area/submap/bloodchurch)
"GX" = (
/mob/living/simple_mob/construct/juggernaut,
/turf/simulated/floor/wood/sif,
/area/submap/bloodchurch)
"Hn" = (
/obj/random/explorer_shield,
/obj/random/contraband/nofail,
/obj/random/contraband/nofail,
/obj/structure/closet/crate/secure/loot,
/obj/item/weapon/rig/pathfinder,
/turf/simulated/floor/wood/sif,
/area/submap/bloodchurch)
"Jq" = (
/obj/item/weapon/gun/energy/staff/focus,
/turf/simulated/floor/wood/sif,
/area/submap/bloodchurch)
"Ku" = (
/mob/living/simple_mob/humanoid/cultist/human/bloodjaunt/fireball,
/turf/simulated/floor/outdoors/dirt,
/area/submap/bloodchurch)
"KD" = (
/obj/structure/cliff/automatic,
/turf/simulated/floor/outdoors/dirt,
/area/submap/bloodchurch)
"MC" = (
/obj/item/weapon/flame/candle/candelabra/everburn,
/obj/structure/table/sifwoodentable,
/turf/simulated/floor/wood/sif,
/area/submap/bloodchurch)
"MK" = (
/obj/structure/loot_pile/surface/bones,
/obj/item/weapon/storage/backpack/holding/duffle,
/turf/simulated/floor/wood/sif,
/area/submap/bloodchurch)
"MQ" = (
/turf/simulated/wall/log_sif,
/area/submap/bloodchurch)
"Nn" = (
/obj/effect/landmark/loot_spawn,
/obj/item/weapon/storage/belt/holding,
/turf/simulated/floor/wood/sif,
/area/submap/bloodchurch)
"OC" = (
/obj/structure/simple_door/sifwood,
/turf/simulated/floor/wood/sif,
/area/submap/bloodchurch)
"OZ" = (
/obj/structure/cliff/automatic/corner{
	dir = 10
	},
/turf/simulated/floor/outdoors/dirt,
/area/submap/bloodchurch)
"Pn" = (
/obj/effect/landmark/loot_spawn,
/turf/simulated/floor/wood/sif,
/area/submap/bloodchurch)
"RN" = (
/obj/structure/table/sifwoodentable,
/obj/random/contraband/nofail,
/obj/random/contraband/nofail,
/obj/random/gun/random,
/turf/simulated/floor/wood/sif,
/area/submap/bloodchurch)
"Uz" = (
/obj/structure/cliff/automatic/corner{
	dir = 6
	},
/turf/simulated/floor/outdoors/dirt,
/area/submap/bloodchurch)
"WM" = (
/obj/structure/table/bench/sifwooden/padded,
/mob/living/simple_mob/humanoid/cultist/caster,
/turf/simulated/floor/wood/sif,
/area/submap/bloodchurch)
"Yz" = (
/mob/living/simple_mob/construct/shade,
/turf/simulated/floor/wood/sif,
/area/submap/bloodchurch)
"YL" = (
/obj/structure/cliff/automatic{
	dir = 4
	},
/turf/simulated/floor/outdoors/dirt,
/area/submap/bloodchurch)
"YS" = (
/obj/structure/cliff/automatic/corner,
/turf/simulated/floor/outdoors/dirt,
/area/submap/bloodchurch)

(1,1,1) = {"
AL
AL
AL
AL
AL
AL
AL
AL
AL
AL
AL
AL
AL
AL
AL
AL
AL
AL
AL
AL
AL
AL
AL
AL
AL
AL
AL
AL
AL
AL
AL
AL
AL
AL
AL
"}
(2,1,1) = {"
AL
AL
AL
AL
AL
AL
AL
AL
AL
AL
AL
AL
AL
AL
AL
AL
AL
AL
AL
AL
AL
AL
AL
AL
AL
AL
AL
AL
AL
AL
AL
AL
AL
AL
AL
"}
(3,1,1) = {"
AL
Uz
YL
YL
YL
YL
YL
YL
YL
YL
YL
YL
YL
YL
YL
YL
YL
YL
YL
YL
YL
YL
YL
YL
YL
YL
YL
YL
YL
YL
YL
YL
YL
YS
AL
"}
(4,1,1) = {"
AL
eT
yC
yC
yC
yC
yC
yC
yC
yC
yC
yC
yC
yC
yC
yC
yC
yC
yC
yC
yC
yC
yC
yC
yC
yC
yC
yC
yC
yC
yC
yC
yC
KD
AL
"}
(5,1,1) = {"
AL
eT
yC
yC
yC
yC
yC
yC
yC
yC
yC
yC
yC
yC
yC
yC
yC
Ku
yC
yC
yC
yC
yC
yC
yC
yC
yC
yC
yC
yC
yC
yC
yC
KD
AL
"}
(6,1,1) = {"
AL
eT
yC
jP
yC
yC
yC
yC
yC
yC
yC
yC
yC
yC
yC
yC
yC
yC
yC
yC
yC
yC
yC
yC
yC
yC
yC
yC
yC
yC
yC
jP
yC
KD
AL
"}
(7,1,1) = {"
AL
eT
yC
yC
yC
yC
yC
yC
yC
yC
yC
yC
yC
yC
yC
yC
yC
yC
yC
yC
yC
yC
yC
yC
yC
yC
yC
yC
yC
yC
yC
yC
yC
KD
AL
"}
(8,1,1) = {"
AL
eT
yC
yC
yC
Uz
YL
YL
YL
YL
YL
YL
YL
YL
YL
YL
YL
YL
YL
YL
YL
YL
YL
YL
YL
YL
YL
YL
YL
YS
yC
yC
yC
KD
AL
"}
(9,1,1) = {"
AL
eT
yC
yC
yC
eT
MQ
MQ
MQ
MQ
MQ
MQ
MQ
MQ
MQ
MQ
MQ
MQ
MQ
MQ
MQ
yC
yC
yC
yC
yC
yC
yC
yC
KD
yC
yC
yC
KD
AL
"}
(10,1,1) = {"
AL
eT
yC
yC
yC
eT
MQ
kn
xJ
Yz
lt
Pn
lt
Yz
Jq
EZ
MQ
qb
rQ
xN
MQ
yC
yC
yC
yC
yC
yC
yC
yC
KD
yC
yC
yC
KD
AL
"}
(11,1,1) = {"
AL
eT
yC
yC
yC
eT
MQ
lt
zO
rQ
rQ
kn
Yz
lt
AZ
Pn
MQ
ce
rQ
aq
MQ
yC
yC
yC
yC
yC
yC
yC
yC
KD
yC
yC
yC
KD
AL
"}
(12,1,1) = {"
AL
eT
yC
yC
yC
eT
MQ
Nn
lt
rQ
Yz
mn
MK
wA
kn
fn
MQ
il
rQ
rQ
MQ
yC
yC
yC
yC
yC
yC
yC
yC
KD
yC
yC
yC
KD
AL
"}
(13,1,1) = {"
AL
eT
yC
yC
yC
eT
MQ
MQ
MQ
OC
MQ
MQ
MQ
MQ
MQ
MQ
MQ
MQ
MQ
OC
MQ
yC
yC
jP
yC
yC
yC
yC
yC
KD
yC
yC
yC
KD
AL
"}
(14,1,1) = {"
AL
eT
yC
yC
yC
eT
MQ
gM
rQ
rQ
rQ
rQ
rQ
rQ
rQ
rQ
OC
rQ
rQ
rQ
MQ
yC
yC
yC
yC
yC
yC
yC
yC
KD
yC
yC
yC
KD
AL
"}
(15,1,1) = {"
AL
eT
yC
yC
yC
eT
MQ
gM
rQ
rQ
Ac
rQ
Ac
rQ
Ac
rQ
MQ
MQ
MQ
MQ
MQ
MQ
yC
yC
yC
yC
yC
yC
yC
KD
yC
yC
yC
KD
AL
"}
(16,1,1) = {"
AL
eT
yC
yC
yC
eT
MQ
rQ
rQ
rQ
WM
rQ
yo
rQ
oI
rQ
MQ
MQ
sy
sy
MQ
MQ
yC
yC
yC
yC
yC
yC
yC
KD
yC
yC
yC
KD
AL
"}
(17,1,1) = {"
AL
eT
yC
yC
yC
eT
MQ
rQ
DJ
rQ
pJ
rQ
pJ
rQ
pJ
rQ
MQ
MC
rQ
rQ
MC
MQ
yC
yC
yC
yC
yC
yC
yC
KD
yC
yC
yC
KD
AL
"}
(18,1,1) = {"
AL
eT
yC
Ku
yC
eT
MQ
wh
fQ
rQ
rQ
rQ
rQ
rQ
rQ
rQ
OC
pL
GX
rQ
rQ
OC
yC
yC
jP
yC
yC
yC
yC
KD
yC
yC
yC
KD
AL
"}
(19,1,1) = {"
AL
eT
yC
yC
yC
eT
MQ
rQ
yD
rQ
pJ
rQ
pJ
rQ
pJ
rQ
MQ
MC
rQ
rQ
MC
MQ
yC
yC
yC
yC
yC
yC
yC
KD
yC
Ku
yC
KD
AL
"}
(20,1,1) = {"
AL
eT
yC
yC
yC
eT
MQ
rQ
rQ
rQ
oI
rQ
yo
rQ
tW
rQ
MQ
MQ
sy
sy
MQ
MQ
yC
yC
yC
yC
yC
yC
yC
KD
yC
yC
yC
KD
AL
"}
(21,1,1) = {"
AL
eT
yC
yC
yC
eT
MQ
gM
rQ
rQ
Ac
rQ
Ac
rQ
Ac
rQ
MQ
MQ
MQ
MQ
MQ
MQ
yC
yC
yC
yC
yC
yC
yC
KD
yC
yC
yC
KD
AL
"}
(22,1,1) = {"
AL
eT
yC
yC
yC
eT
MQ
gM
rQ
rQ
rQ
rQ
rQ
rQ
rQ
rQ
OC
rQ
rQ
rQ
MQ
yC
yC
yC
yC
yC
yC
yC
yC
KD
yC
yC
yC
KD
AL
"}
(23,1,1) = {"
AL
eT
yC
yC
yC
eT
MQ
MQ
MQ
OC
MQ
MQ
MQ
MQ
MQ
MQ
MQ
MQ
MQ
OC
MQ
yC
yC
jP
yC
KD
yC
yC
yC
KD
yC
yC
yC
KD
AL
"}
(24,1,1) = {"
AL
eT
yC
yC
yC
eT
MQ
Hn
lt
rQ
rQ
rQ
rQ
lt
rQ
RN
MQ
il
rQ
rQ
MQ
yC
yC
yC
yC
KD
yC
yC
yC
KD
yC
yC
yC
KD
AL
"}
(25,1,1) = {"
AL
eT
yC
yC
yC
eT
MQ
rQ
dF
rQ
rQ
lt
rQ
rQ
dF
lt
MQ
ce
rQ
aq
MQ
yC
yC
yC
yC
KD
yC
yC
yC
KD
yC
yC
yC
KD
AL
"}
(26,1,1) = {"
AL
eT
yC
yC
yC
eT
MQ
FG
FG
FG
iT
iT
iT
FG
FG
fb
MQ
hQ
rQ
xN
MQ
yC
yC
yC
yC
KD
yC
yC
yC
KD
yC
yC
yC
KD
AL
"}
(27,1,1) = {"
AL
eT
yC
yC
yC
eT
MQ
MQ
MQ
MQ
MQ
MQ
MQ
MQ
MQ
MQ
MQ
MQ
MQ
MQ
MQ
yC
yC
yC
yC
KD
yC
yC
yC
KD
yC
yC
yC
KD
AL
"}
(28,1,1) = {"
AL
eT
yC
yC
yC
OZ
yn
yn
yn
yn
yn
yn
yn
yn
yn
yn
yn
yn
yn
yn
yn
yn
yn
yn
yn
zB
yC
yC
yC
KD
yC
yC
yC
KD
AL
"}
(29,1,1) = {"
AL
eT
yC
yC
yC
yC
yC
yC
yC
yC
yC
yC
yC
yC
yC
yC
yC
yC
yC
yC
yC
yC
yC
yC
yC
yC
yC
yC
yC
KD
yC
yC
yC
KD
AL
"}
(30,1,1) = {"
AL
eT
yC
yC
yC
yC
yC
yC
yC
yC
yC
yC
yC
yC
yC
yC
yC
yC
yC
yC
yC
yC
yC
yC
yC
yC
yC
yC
yC
KD
yC
yC
yC
KD
AL
"}
(31,1,1) = {"
AL
eT
yC
jP
yC
yC
yC
yC
yC
yC
yC
yC
yC
Ku
yC
yC
yC
yC
yC
yC
yC
yC
yC
yC
yC
jP
yC
yC
yC
KD
yC
yC
yC
KD
AL
"}
(32,1,1) = {"
AL
eT
yC
yC
yC
yC
yC
yC
yC
yC
yC
yC
yC
yC
yC
yC
yC
yC
yC
yC
yC
yC
yC
yC
yC
yC
yC
yC
yC
KD
yC
yC
yC
KD
AL
"}
(33,1,1) = {"
AL
OZ
yn
yn
yn
yn
yn
yn
yn
yn
yn
yn
yn
yn
yn
yn
yn
yn
yn
yn
yn
yn
yn
yn
yn
yn
yn
yn
yn
zB
yC
yC
yC
KD
AL
"}
(34,1,1) = {"
AL
AL
AL
AL
AL
AL
AL
AL
AL
AL
AL
AL
AL
AL
AL
AL
AL
AL
AL
AL
AL
AL
AL
AL
AL
AL
AL
AL
AL
AL
yC
yC
yC
zB
AL
"}
(35,1,1) = {"
AL
AL
AL
AL
AL
AL
AL
AL
AL
AL
AL
AL
AL
AL
AL
AL
AL
AL
AL
AL
AL
AL
AL
AL
AL
AL
AL
AL
AL
AL
AL
AL
AL
AL
AL
"}
