//MAP CONVERTED BY dmm2tgm.py THIS HEADER COMMENT PREVENTS RECONVERSION, DO NOT REMOVE
"a" = (
/turf/simulated/floor/outdoors/dirt,
/area/submap/bloodchurch)
"b" = (
/obj/structure/table/bench/sifwooden/padded,
/mob/living/simple_mob/humanoid/cultist/human/bloodjaunt,
/turf/simulated/floor/wood/sif,
/area/submap/bloodchurch)
"c" = (
/mob/living/simple_mob/construct/shade,
/turf/simulated/floor/wood/sif,
/area/submap/bloodchurch)
"d" = (
/obj/structure/table/sifwoodentable,
/obj/random/firstaid,
/turf/simulated/floor/wood/sif,
/area/submap/bloodchurch)
"e" = (
/mob/living/simple_mob/humanoid/cultist/elite,
/turf/simulated/floor/wood/sif,
/area/submap/bloodchurch)
"f" = (
/obj/structure/bed/double/padded,
/mob/living/simple_mob/humanoid/cultist/human/bloodjaunt,
/obj/item/weapon/bedsheet/hosdouble,
/turf/simulated/floor/wood/sif,
/area/submap/bloodchurch)
"g" = (
/obj/structure/bed/double/padded,
/mob/living/simple_mob/humanoid/cultist/castertesh,
/obj/item/weapon/bedsheet/hosdouble,
/turf/simulated/floor/wood/sif,
/area/submap/bloodchurch)
"h" = (
/obj/structure/table/sifwoodentable,
/obj/random/meat,
/obj/random/meat,
/obj/random/meat,
/obj/random/meat,
/turf/simulated/floor/wood/sif,
/area/submap/bloodchurch)
"i" = (
/obj/random/explorer_shield,
/obj/random/contraband/nofail,
/obj/random/contraband/nofail,
/obj/structure/closet/crate/secure/loot,
/obj/item/weapon/rig/pathfinder,
/turf/simulated/floor/wood/sif,
/area/submap/bloodchurch)
"j" = (
/obj/structure/table/bench/sifwooden/padded,
/mob/living/simple_mob/humanoid/cultist/caster,
/turf/simulated/floor/wood/sif,
/area/submap/bloodchurch)
"k" = (
/obj/structure/loot_pile/surface/bones,
/obj/item/weapon/storage/backpack/holding/duffle,
/turf/simulated/floor/wood/sif,
/area/submap/bloodchurch)
"l" = (
/obj/structure/table/rack,
/obj/item/clothing/suit/storage/hooded/wintercoat/narsie,
/obj/item/clothing/suit/storage/hooded/wintercoat/narsie,
/turf/simulated/floor/wood/sif,
/area/submap/bloodchurch)
"m" = (
/obj/structure/cliff/automatic/corner{
	dir = 9
	},
/turf/simulated/floor/outdoors/dirt,
/area/submap/bloodchurch)
"n" = (
/obj/structure/closet/crate,
/obj/item/stolenpackage,
/obj/item/stolenpackage,
/obj/item/stolenpackage,
/obj/item/rig_module/vision/thermal,
/turf/simulated/floor/wood/sif,
/area/submap/bloodchurch)
"o" = (
/obj/structure/table/bench/sifwooden/padded,
/mob/living/simple_mob/humanoid/cultist/castertesh,
/turf/simulated/floor/wood/sif,
/area/submap/bloodchurch)
"p" = (
/obj/structure/table/sifwoodentable,
/obj/item/clothing/head/psy_crown/wrath,
/turf/simulated/floor/wood/sif,
/area/submap/bloodchurch)
"q" = (
/obj/effect/decal/cleanable/blood/gibs,
/turf/simulated/floor/wood/sif,
/area/submap/bloodchurch)
"r" = (
/obj/structure/loot_pile/surface/bones,
/turf/simulated/floor/wood/sif,
/area/submap/bloodchurch)
"s" = (
/obj/structure/cliff/automatic/corner{
	dir = 6
	},
/turf/simulated/floor/outdoors/dirt,
/area/submap/bloodchurch)
"t" = (
/obj/structure/loot_pile/surface/bones,
/obj/item/weapon/storage/backpack/dufflebag/syndie,
/turf/simulated/floor/wood/sif,
/area/submap/bloodchurch)
"u" = (
/obj/structure/table/sifwoodentable,
/obj/item/weapon/flame/candle/candelabra/everburn,
/turf/simulated/floor/wood/sif,
/area/submap/bloodchurch)
"v" = (
/obj/item/clothing/head/wizard/amp,
/turf/simulated/floor/wood/sif,
/area/submap/bloodchurch)
"w" = (
/obj/structure/cliff/automatic{
	dir = 8
	},
/turf/simulated/floor/outdoors/dirt,
/area/submap/bloodchurch)
"x" = (
/turf/simulated/wall/log_sif,
/area/submap/bloodchurch)
"y" = (
/obj/structure/cliff/automatic{
	dir = 2
	},
/turf/simulated/floor/outdoors/dirt,
/area/submap/bloodchurch)
"z" = (
/mob/living/simple_mob/construct/juggernaut,
/turf/simulated/floor/wood/sif,
/area/submap/bloodchurch)
"A" = (
/obj/item/weapon/gun/energy/staff/focus,
/turf/simulated/floor/wood/sif,
/area/submap/bloodchurch)
"B" = (
/obj/structure/table/sifwoodentable,
/obj/random/contraband/nofail,
/obj/random/contraband/nofail,
/obj/random/gun/random,
/turf/simulated/floor/wood/sif,
/area/submap/bloodchurch)
"C" = (
/obj/structure/table/sifwoodentable,
/obj/item/weapon/flame/candle/everburn,
/turf/simulated/floor/wood/sif,
/area/submap/bloodchurch)
"D" = (
/obj/structure/table/sifwoodentable,
/obj/random/meat,
/obj/random/meat,
/obj/random/meat,
/obj/random/meat,
/obj/random/meat,
/turf/simulated/floor/wood/sif,
/area/submap/bloodchurch)
"E" = (
/obj/item/clothing/suit/wizrobe,
/turf/simulated/floor/wood/sif,
/area/submap/bloodchurch)
"F" = (
/obj/structure/kitchenspike,
/turf/simulated/floor/wood/sif,
/area/submap/bloodchurch)
"G" = (
/obj/structure/cliff/automatic/corner,
/turf/simulated/floor/outdoors/dirt,
/area/submap/bloodchurch)
"H" = (
/obj/effect/landmark/loot_spawn,
/turf/simulated/floor/wood/sif,
/area/submap/bloodchurch)
"I" = (
/obj/effect/decal/cleanable/blood/gibs,
/mob/living/simple_mob/construct/shade,
/turf/simulated/floor/wood/sif,
/area/submap/bloodchurch)
"J" = (
/mob/living/simple_mob/humanoid/cultist/human/bloodjaunt/fireball,
/turf/simulated/floor/outdoors/dirt,
/area/submap/bloodchurch)
"K" = (
/obj/structure/simple_door/sifwood,
/turf/simulated/floor/wood/sif,
/area/submap/bloodchurch)
"L" = (
/obj/structure/closet,
/obj/random/energy/highend,
/turf/simulated/floor/wood/sif,
/area/submap/bloodchurch)
"M" = (
/obj/structure/table/bench/sifwooden/padded,
/turf/simulated/floor/wood/sif,
/area/submap/bloodchurch)
"N" = (
/obj/structure/bookcase,
/turf/simulated/floor/wood/sif,
/area/submap/bloodchurch)
"O" = (
/turf/template_noop,
/area/template_noop)
"P" = (
/mob/living/simple_mob/vore/demonAI/wendigo{
	faction = "cult"
	},
/turf/simulated/floor/wood/sif,
/area/submap/bloodchurch)
"Q" = (
/turf/simulated/floor/wood/sif,
/area/submap/bloodchurch)
"R" = (
/mob/living/simple_mob/humanoid/cultist/hunter,
/turf/simulated/floor/wood/sif,
/area/submap/bloodchurch)
"S" = (
/mob/living/simple_mob/construct/artificer/caster,
/turf/simulated/floor/outdoors/dirt,
/area/submap/bloodchurch)
"T" = (
/obj/structure/table/sifwoodentable,
/obj/item/weapon/spellbook/oneuse/forcewall,
/turf/simulated/floor/wood/sif,
/area/submap/bloodchurch)
"U" = (
/obj/structure/cliff/automatic,
/turf/simulated/floor/outdoors/dirt,
/area/submap/bloodchurch)
"V" = (
/obj/structure/cliff/automatic{
	dir = 4
	},
/turf/simulated/floor/outdoors/dirt,
/area/submap/bloodchurch)
"W" = (
/obj/structure/cliff/automatic/corner{
	dir = 10
	},
/turf/simulated/floor/outdoors/dirt,
/area/submap/bloodchurch)
"X" = (
/obj/structure/table/sifwoodentable,
/obj/random/medical/pillbottle,
/turf/simulated/floor/wood/sif,
/area/submap/bloodchurch)
"Y" = (
/obj/item/clothing/suit/wizrobe/psypurple,
/turf/simulated/floor/wood/sif,
/area/submap/bloodchurch)
"Z" = (
/obj/structure/table/bench/sifwooden/padded,
/mob/living/simple_mob/humanoid/cultist/lizard,
/turf/simulated/floor/wood/sif,
/area/submap/bloodchurch)

(1,1,1) = {"
O
O
O
O
O
O
O
O
O
O
O
O
O
O
O
O
O
O
O
O
O
O
O
O
O
O
O
O
O
O
O
O
O
O
O
"}
(2,1,1) = {"
O
O
O
O
O
O
O
O
O
O
O
O
O
O
O
O
O
O
O
O
O
O
O
O
O
O
O
O
O
O
O
O
O
O
O
"}
(3,1,1) = {"
O
s
V
V
V
V
V
V
V
V
V
V
V
V
V
V
V
V
V
V
V
V
V
V
V
V
V
V
V
V
V
V
V
G
O
"}
(4,1,1) = {"
O
y
a
a
a
a
a
a
a
a
a
a
a
a
a
a
a
a
a
a
a
a
a
a
a
a
a
a
a
a
a
a
a
U
O
"}
(5,1,1) = {"
O
y
a
a
a
a
a
a
a
a
a
a
a
a
a
a
a
J
a
a
a
a
a
a
a
a
a
a
a
a
a
a
a
U
O
"}
(6,1,1) = {"
O
y
a
S
a
a
a
a
a
a
a
a
a
a
a
a
a
a
a
a
a
a
a
a
a
a
a
a
a
a
a
S
a
U
O
"}
(7,1,1) = {"
O
y
a
a
a
a
a
a
a
a
a
a
a
a
a
a
a
a
a
a
a
a
a
a
a
a
a
a
a
a
a
a
a
U
O
"}
(8,1,1) = {"
O
y
a
a
a
s
V
V
V
V
V
V
V
V
V
V
V
V
V
V
V
V
V
V
V
V
V
V
V
G
a
a
a
U
O
"}
(9,1,1) = {"
O
y
a
a
a
y
x
x
x
x
x
x
x
x
x
x
x
x
x
x
x
a
a
a
a
a
a
a
a
U
a
a
a
U
O
"}
(10,1,1) = {"
O
y
a
a
a
y
x
r
n
c
q
H
q
c
A
t
x
f
Q
d
x
a
a
a
a
a
a
a
a
U
a
a
a
U
O
"}
(11,1,1) = {"
O
y
a
a
a
y
x
q
E
Q
Q
r
Q
q
E
H
x
P
Q
u
x
a
a
a
a
a
a
a
a
U
a
a
a
U
O
"}
(12,1,1) = {"
O
y
a
a
a
y
x
H
q
Q
c
Y
k
v
r
I
x
L
Q
Q
x
a
a
a
a
a
a
a
a
U
a
a
a
U
O
"}
(13,1,1) = {"
O
y
a
a
a
y
x
x
x
K
x
x
x
x
x
x
x
x
x
K
x
a
a
S
a
a
a
a
a
U
a
a
a
U
O
"}
(14,1,1) = {"
O
y
a
a
a
y
x
N
Q
Q
Q
Q
Q
Q
Q
Q
K
Q
Q
Q
x
a
a
a
a
a
a
a
a
U
a
a
a
U
O
"}
(15,1,1) = {"
O
y
a
a
a
y
x
N
Q
Q
C
Q
C
Q
C
Q
x
x
x
x
x
x
a
a
a
a
a
a
a
U
a
a
a
U
O
"}
(16,1,1) = {"
O
y
a
a
a
y
x
Q
Q
Q
j
Q
Z
Q
b
Q
x
x
l
l
x
x
a
a
a
a
a
a
a
U
a
a
a
U
O
"}
(17,1,1) = {"
O
y
a
a
a
y
x
Q
p
Q
M
Q
M
Q
M
Q
x
x
Q
Q
x
x
a
a
a
a
a
a
a
U
a
a
a
U
O
"}
(18,1,1) = {"
O
y
a
J
a
y
x
e
X
Q
Q
Q
Q
Q
Q
Q
K
Q
z
Q
Q
K
a
a
S
a
a
a
a
U
a
a
a
U
O
"}
(19,1,1) = {"
O
y
a
a
a
y
x
Q
T
Q
M
Q
M
Q
M
Q
x
x
Q
Q
x
x
a
a
a
a
a
a
a
U
a
J
a
U
O
"}
(20,1,1) = {"
O
y
a
a
a
y
x
Q
Q
Q
b
Q
Z
Q
o
Q
x
x
l
l
x
x
a
a
a
a
a
a
a
U
a
a
a
U
O
"}
(21,1,1) = {"
O
y
a
a
a
y
x
N
Q
Q
C
Q
C
Q
C
Q
x
x
x
x
x
x
a
a
a
a
a
a
a
U
a
a
a
U
O
"}
(22,1,1) = {"
O
y
a
a
a
y
x
N
Q
Q
Q
Q
Q
Q
Q
Q
K
Q
Q
Q
x
a
a
a
a
a
a
a
a
U
a
a
a
U
O
"}
(23,1,1) = {"
O
y
a
a
a
y
x
x
x
K
x
x
x
x
x
x
x
x
x
K
x
a
a
S
a
U
a
a
a
U
a
a
a
U
O
"}
(24,1,1) = {"
O
y
a
a
a
y
x
i
q
Q
Q
Q
Q
q
Q
B
x
L
Q
Q
x
a
a
a
a
U
a
a
a
U
a
a
a
U
O
"}
(25,1,1) = {"
O
y
a
a
a
y
x
Q
R
Q
Q
q
Q
Q
R
q
x
P
Q
u
x
a
a
a
a
U
a
a
a
U
a
a
a
U
O
"}
(26,1,1) = {"
O
y
a
a
a
y
x
D
D
D
F
F
F
D
D
h
x
g
Q
d
x
a
a
a
a
U
a
a
a
U
a
a
a
U
O
"}
(27,1,1) = {"
O
y
a
a
a
y
x
x
x
x
x
x
x
x
x
x
x
x
x
x
x
a
a
a
a
U
a
a
a
U
a
a
a
U
O
"}
(28,1,1) = {"
O
y
a
a
a
W
w
w
w
w
w
w
w
w
w
w
w
w
w
w
w
w
w
w
w
m
a
a
a
U
a
a
a
U
O
"}
(29,1,1) = {"
O
y
a
a
a
a
a
a
a
a
a
a
a
a
a
a
a
a
a
a
a
a
a
a
a
a
a
a
a
U
a
a
a
U
O
"}
(30,1,1) = {"
O
y
a
a
a
a
a
a
a
a
a
a
a
a
a
a
a
a
a
a
a
a
a
a
a
a
a
a
a
U
a
a
a
U
O
"}
(31,1,1) = {"
O
y
a
S
a
a
a
a
a
a
a
a
a
J
a
a
a
a
a
a
a
a
a
a
a
S
a
a
a
U
a
a
a
U
O
"}
(32,1,1) = {"
O
y
a
a
a
a
a
a
a
a
a
a
a
a
a
a
a
a
a
a
a
a
a
a
a
a
a
a
a
U
a
a
a
U
O
"}
(33,1,1) = {"
O
W
w
w
w
w
w
w
w
w
w
w
w
w
w
w
w
w
w
w
w
w
w
w
w
w
w
w
w
m
a
a
a
U
O
"}
(34,1,1) = {"
O
O
O
O
O
O
O
O
O
O
O
O
O
O
O
O
O
O
O
O
O
O
O
O
O
O
O
O
O
O
a
a
a
m
O
"}
(35,1,1) = {"
O
O
O
O
O
O
O
O
O
O
O
O
O
O
O
O
O
O
O
O
O
O
O
O
O
O
O
O
O
O
O
O
O
O
O
"}
