//MAP CONVERTED BY dmm2tgm.py THIS HEADER COMMENT PREVENTS RECONVERSION, DO NOT REMOVE
"a" = (
/mob/living/simple_mob/humanoid/cultist/tesh,
/turf/simulated/floor/wood,
/area/submap/carriershuttle)
"b" = (
/obj/machinery/firework_launcher,
/turf/simulated/floor/wood,
/area/submap/carriershuttle)
"c" = (
/obj/structure/table/wooden_reinforced,
/obj/item/device/soulstone,
/turf/simulated/floor/wood,
/area/submap/carriershuttle)
"d" = (
/obj/structure/railing,
/obj/structure/table/wooden_reinforced,
/obj/random/medical/pillbottle,
/turf/simulated/floor/wood,
/area/submap/carriershuttle)
"e" = (
/obj/structure/railing{
	dir = 1
	},
/turf/simulated/floor/wood,
/area/submap/carriershuttle)
"f" = (
/obj/structure/cliff/automatic{
	dir = 8
	},
/turf/simulated/floor/outdoors/dirt,
/area/submap/carriershuttle)
"g" = (
/obj/structure/cliff/automatic{
	dir = 9
	},
/turf/simulated/floor/outdoors/dirt,
/area/submap/carriershuttle)
"h" = (
/obj/structure/simple_door/wood,
/turf/simulated/floor/wood/sif,
/area/submap/carriershuttle)
"i" = (
/obj/structure/table/wooden_reinforced,
/obj/item/weapon/flame/candle/everburn,
/turf/simulated/floor/wood,
/area/submap/carriershuttle)
"j" = (
/obj/structure/cliff/automatic{
	dir = 10
	},
/turf/simulated/floor/outdoors/dirt,
/area/submap/carriershuttle)
"k" = (
/obj/structure/table/wooden_reinforced,
/obj/random/energy/highend,
/turf/simulated/floor/wood,
/area/submap/carriershuttle)
"l" = (
/obj/structure/table/wooden_reinforced,
/obj/random/gun/random,
/turf/simulated/floor/wood,
/area/submap/carriershuttle)
"m" = (
/obj/structure/table/wooden_reinforced,
/obj/random/firstaid,
/turf/simulated/floor/wood,
/area/submap/carriershuttle)
"n" = (
/obj/structure/table/wooden_reinforced,
/obj/item/clothing/head/psy_crown/wrath,
/turf/simulated/floor/wood,
/area/submap/carriershuttle)
"p" = (
/mob/living/simple_mob/vore/alienanimals/space_jellyfish{
	faction = "cult"
	},
/turf/simulated/floor/water,
/area/submap/carriershuttle)
"q" = (
/obj/structure/closet/crate,
/obj/item/weapon/firework_star/weather/storm,
/obj/item/weapon/firework_star/weather/storm,
/obj/item/weapon/firework_star/weather/rain,
/obj/item/weapon/firework_star/weather/rain,
/obj/item/weapon/firework_star/weather/hail,
/obj/item/weapon/firework_star/weather/hail,
/obj/item/weapon/firework_star/weather/blizzard,
/obj/item/weapon/firework_star/weather/blizzard,
/obj/item/weapon/firework_star/weather/fallout,
/turf/simulated/floor/wood,
/area/submap/carriershuttle)
"r" = (
/obj/structure/railing,
/turf/simulated/floor/wood,
/area/submap/carriershuttle)
"s" = (
/turf/simulated/wall/log,
/area/submap/carriershuttle)
"t" = (
/obj/structure/railing,
/obj/structure/table/wooden_reinforced,
/obj/random/firstaid,
/turf/simulated/floor/wood,
/area/submap/carriershuttle)
"u" = (
/turf/simulated/floor/water,
/area/submap/carriershuttle)
"v" = (
/turf/simulated/floor/outdoors/dirt,
/area/submap/carriershuttle)
"w" = (
/turf/template_noop,
/area/template_noop)
"x" = (
/obj/structure/table/wooden_reinforced,
/obj/random/projectile/random,
/turf/simulated/floor/wood,
/area/submap/carriershuttle)
"y" = (
/obj/structure/cliff/automatic{
	dir = 4
	},
/turf/simulated/floor/outdoors/dirt,
/area/submap/carriershuttle)
"B" = (
/obj/structure/bed,
/obj/item/weapon/bedsheet/blue,
/turf/simulated/floor/wood,
/area/submap/carriershuttle)
"C" = (
/mob/living/simple_mob/humanoid/cultist/noodle,
/turf/simulated/floor/wood,
/area/submap/carriershuttle)
"D" = (
/obj/structure/cliff/automatic/corner{
	dir = 10
	},
/turf/simulated/floor/outdoors/dirt,
/area/submap/carriershuttle)
"E" = (
/obj/structure/cliff/automatic/corner,
/turf/simulated/floor/outdoors/dirt,
/area/submap/carriershuttle)
"F" = (
/obj/structure/railing{
	dir = 1
	},
/obj/structure/table/wooden_reinforced,
/obj/random/medical/pillbottle,
/turf/simulated/floor/wood,
/area/submap/carriershuttle)
"G" = (
/obj/structure/cliff/automatic,
/turf/simulated/floor/outdoors/dirt,
/area/submap/carriershuttle)
"H" = (
/obj/structure/closet/crate/secure/loot,
/obj/random/mainttoyloot/nofail,
/obj/random/mainttoyloot/nofail,
/turf/simulated/floor/wood,
/area/submap/carriershuttle)
"I" = (
/mob/living/simple_mob/humanoid/cultist/hunter,
/turf/simulated/floor/wood,
/area/submap/carriershuttle)
"J" = (
/turf/simulated/floor/wood,
/area/submap/carriershuttle)
"M" = (
/obj/structure/cliff/automatic{
	dir = 6
	},
/turf/simulated/floor/outdoors/dirt,
/area/submap/carriershuttle)
"N" = (
/obj/structure/railing{
	dir = 4
	},
/turf/simulated/floor/wood,
/area/submap/carriershuttle)
"O" = (
/obj/structure/table/wooden_reinforced,
/obj/item/clothing/head/psy_crown/gluttony,
/turf/simulated/floor/wood,
/area/submap/carriershuttle)
"P" = (
/obj/structure/railing{
	dir = 8
	},
/turf/simulated/floor/wood,
/area/submap/carriershuttle)
"Q" = (
/obj/structure/cliff/automatic{
	dir = 2
	},
/turf/simulated/floor/outdoors/dirt,
/area/submap/carriershuttle)
"R" = (
/mob/living/simple_mob/humanoid/cultist/castertesh,
/turf/simulated/floor/wood,
/area/submap/carriershuttle)
"S" = (
/obj/structure/table/wooden_reinforced,
/turf/simulated/floor/wood,
/area/submap/carriershuttle)
"T" = (
/obj/structure/railing{
	dir = 1
	},
/obj/structure/table/wooden_reinforced,
/obj/random/firstaid,
/turf/simulated/floor/wood,
/area/submap/carriershuttle)
"U" = (
/obj/structure/cliff/automatic/corner{
	dir = 6
	},
/turf/simulated/floor/outdoors/dirt,
/area/submap/carriershuttle)
"V" = (
/obj/structure/cliff/automatic{
	dir = 5
	},
/turf/simulated/floor/outdoors/dirt,
/area/submap/carriershuttle)
"W" = (
/obj/structure/railing{
	dir = 1
	},
/obj/structure/table/wooden_reinforced,
/obj/item/weapon/flame/candle/everburn,
/turf/simulated/floor/wood,
/area/submap/carriershuttle)
"X" = (
/mob/living/simple_mob/humanoid/cultist/human/bloodjaunt/fireball,
/turf/simulated/floor/wood,
/area/submap/carriershuttle)
"Y" = (
/obj/structure/cliff/automatic/corner{
	dir = 9
	},
/turf/simulated/floor/outdoors/dirt,
/area/submap/carriershuttle)
"Z" = (
/obj/structure/railing,
/obj/structure/table/wooden_reinforced,
/obj/item/weapon/flame/candle/everburn,
/turf/simulated/floor/wood,
/area/submap/carriershuttle)

(1,1,1) = {"
w
w
w
w
w
w
w
w
w
w
w
w
w
w
w
w
w
w
w
w
w
w
w
w
w
w
w
w
w
"}
(2,1,1) = {"
w
g
f
f
f
f
f
f
f
f
f
f
f
f
f
f
f
f
f
f
f
f
f
f
f
f
f
j
w
"}
(3,1,1) = {"
w
G
u
u
u
u
u
u
u
u
u
u
u
u
u
u
u
u
u
u
u
u
u
u
u
u
u
Q
w
"}
(4,1,1) = {"
w
G
u
u
p
u
u
u
u
u
p
u
u
u
u
u
u
u
u
u
u
u
p
u
u
u
u
Q
w
"}
(5,1,1) = {"
w
G
u
u
u
u
u
u
u
u
u
u
u
u
u
u
u
u
u
u
u
u
u
u
u
u
u
Q
w
"}
(6,1,1) = {"
w
G
u
p
u
U
y
y
y
y
y
y
y
y
y
y
y
y
y
y
y
y
y
E
u
u
u
Q
w
"}
(7,1,1) = {"
w
G
u
u
u
Q
s
s
P
P
P
P
s
s
s
s
s
P
P
P
P
s
s
G
u
p
u
Q
w
"}
(8,1,1) = {"
w
G
u
u
u
Q
e
J
J
J
R
J
s
O
i
c
s
J
R
J
J
J
r
G
u
u
u
Q
w
"}
(9,1,1) = {"
w
G
u
u
u
Q
e
J
J
J
J
J
h
J
I
J
h
J
J
J
J
J
r
G
u
u
u
Q
w
"}
(10,1,1) = {"
w
G
u
u
u
Q
e
X
J
J
a
S
s
J
J
J
s
S
a
J
J
X
r
G
u
u
u
Q
w
"}
(11,1,1) = {"
w
G
u
u
u
Q
e
J
J
S
l
i
s
J
J
J
s
i
x
S
J
J
r
G
u
u
u
Q
w
"}
(12,1,1) = {"
w
G
u
u
u
Q
s
h
s
s
s
s
s
s
h
s
s
s
s
s
s
h
s
G
u
u
u
Q
w
"}
(13,1,1) = {"
w
G
u
u
u
Q
v
v
v
U
s
B
J
J
J
J
J
B
s
E
v
v
v
G
u
u
u
Q
w
"}
(14,1,1) = {"
w
G
u
p
u
Q
v
v
v
Q
s
b
a
J
J
J
a
H
s
G
v
v
v
G
u
p
u
Q
w
"}
(15,1,1) = {"
w
G
u
u
u
Q
v
v
v
Q
s
B
J
J
J
J
J
B
s
G
v
v
v
G
u
u
u
Q
w
"}
(16,1,1) = {"
w
Y
u
u
u
D
v
v
v
Q
s
s
s
s
h
s
s
s
s
G
v
v
v
Y
u
u
u
D
w
"}
(17,1,1) = {"
w
v
v
v
v
v
v
v
v
Q
T
J
J
J
J
J
J
J
d
G
v
v
v
v
v
v
v
v
w
"}
(18,1,1) = {"
w
v
v
v
v
v
v
v
v
Q
W
R
J
J
C
J
J
R
Z
G
v
v
v
v
v
v
v
v
w
"}
(19,1,1) = {"
w
v
v
v
v
v
v
v
v
Q
F
J
J
J
J
J
J
J
t
G
v
v
v
v
v
v
v
v
w
"}
(20,1,1) = {"
w
E
u
u
u
U
v
v
v
Q
s
s
s
s
h
s
s
s
s
G
v
v
v
E
u
u
u
U
w
"}
(21,1,1) = {"
w
G
u
u
u
Q
v
v
v
Q
s
B
J
J
J
J
J
B
s
G
v
v
v
G
u
u
u
Q
w
"}
(22,1,1) = {"
w
G
u
u
u
Q
v
v
v
Q
s
H
a
J
J
J
a
q
s
G
v
v
v
G
u
p
u
Q
w
"}
(23,1,1) = {"
w
G
u
p
u
Q
v
v
v
D
s
B
J
J
J
J
J
B
s
Y
v
v
v
G
u
u
u
Q
w
"}
(24,1,1) = {"
w
G
u
u
u
Q
s
h
s
s
s
s
s
s
h
s
s
s
s
s
s
h
s
G
u
u
u
Q
w
"}
(25,1,1) = {"
w
G
u
u
u
Q
e
J
J
S
m
i
s
J
J
J
s
i
k
S
J
J
r
G
u
u
u
Q
w
"}
(26,1,1) = {"
w
G
u
u
u
Q
e
X
J
J
a
S
s
J
J
J
s
S
a
J
J
X
r
G
u
u
u
Q
w
"}
(27,1,1) = {"
w
G
u
u
u
Q
e
J
J
J
J
J
h
J
I
J
h
J
J
J
J
J
r
G
u
p
u
Q
w
"}
(28,1,1) = {"
w
G
u
u
u
Q
e
J
J
J
R
J
s
c
i
n
s
J
R
J
J
J
r
G
u
u
u
Q
w
"}
(29,1,1) = {"
w
G
u
p
u
Q
s
s
N
N
N
N
s
s
s
s
s
N
N
N
N
s
s
G
u
u
u
Q
w
"}
(30,1,1) = {"
w
G
u
u
u
D
f
f
f
f
f
f
f
f
f
f
f
f
f
f
f
f
f
Y
u
u
u
Q
w
"}
(31,1,1) = {"
w
G
u
u
u
u
u
u
u
u
u
u
u
u
u
u
u
u
u
u
p
u
u
u
u
u
u
Q
w
"}
(32,1,1) = {"
w
G
u
u
u
u
p
u
u
u
u
u
u
p
u
u
u
u
u
u
u
u
u
u
u
p
u
Q
w
"}
(33,1,1) = {"
w
G
u
u
u
u
u
u
u
u
u
u
u
u
u
u
u
u
u
u
u
u
u
u
u
u
u
Q
w
"}
(34,1,1) = {"
w
V
y
y
y
y
y
y
y
y
y
y
y
y
y
y
y
y
y
y
y
y
y
y
y
y
y
M
w
"}
(35,1,1) = {"
w
w
w
w
w
w
w
w
w
w
w
w
w
w
w
w
w
w
w
w
w
w
w
w
w
w
w
w
w
"}
