//MAP CONVERTED BY dmm2tgm.py THIS HEADER COMMENT PREVENTS RECONVERSION, DO NOT REMOVE
"aa" = (
/mob/living/simple_mob/mechanical/mecha/ripley/blue_flames{
	faction = "pirate"
	},
/turf/simulated/floor/wood,
/area/submap/cove)
"aP" = (
/mob/living/simple_mob/humanoid/cultist/hunter{
	faction = "pirate"
	},
/turf/simulated/floor/wood,
/area/submap/cove)
"br" = (
/obj/machinery/power/apc{
	dir = 1;
	name = "PAPC";
	pixel_x = 0;
	pixel_y = 24
	},
/obj/machinery/power/terminal{
	dir = 4
	},
/turf/simulated/floor/wood,
/area/submap/cove)
"bx" = (
/obj/structure/railing{
	dir = 1
	},
/obj/structure/railing{
	dir = 8
	},
/turf/simulated/floor/wood,
/area/submap/cove)
"ds" = (
/mob/living/simple_mob/humanoid/pirate/ranged/handcannon/armored,
/turf/simulated/floor/wood,
/area/submap/cove)
"eO" = (
/obj/structure/table/rack,
/obj/item/weapon/reagent_containers/chem_disp_cartridge/corophizine,
/obj/item/weapon/reagent_containers/chem_disp_cartridge/moonshine,
/obj/random/gun/random,
/obj/random/energy/highend,
/obj/random/maintenance/morestuff,
/obj/random/maintenance/morestuff,
/obj/random/maintenance/morestuff,
/obj/random/contraband,
/turf/simulated/floor/wood,
/area/submap/cove)
"fq" = (
/turf/simulated/floor/water{
	outdoors = 0
	},
/area/submap/cove)
"ht" = (
/obj/machinery/appliance/cooker/grill,
/turf/simulated/floor/wood,
/area/submap/cove)
"iU" = (
/obj/structure/table/sifwooden_reinforced,
/obj/random/maintenance/foodstuff,
/obj/random/maintenance/foodstuff,
/obj/random/maintenance/foodstuff,
/turf/simulated/floor/wood,
/area/submap/cove)
"kD" = (
/obj/structure/table/sifwooden_reinforced,
/obj/machinery/chemical_dispenser/bar_coffee/full{
	dir = 8
	},
/obj/machinery/light/poi{
	dir = 4
	},
/turf/simulated/floor/wood,
/area/submap/cove)
"ld" = (
/obj/structure/table/sifwooden_reinforced,
/obj/random/contraband,
/turf/simulated/floor/wood,
/area/submap/cove)
"lk" = (
/turf/simulated/wall/wood,
/area/submap/cove)
"lL" = (
/turf/simulated/floor/water/ocean,
/area/submap/cove)
"mh" = (
/obj/random/mob/merc/all,
/turf/simulated/floor/wood,
/area/submap/cove)
"nt" = (
/obj/structure/table/bench/wooden,
/mob/living/simple_mob/humanoid/merc/voxpirate/ranged/suppressor{
	faction = "pirate"
	},
/turf/simulated/floor/wood,
/area/submap/cove)
"nN" = (
/mob/living/simple_mob/mechanical/mecha/ripley/pirate/manned,
/turf/simulated/floor/outdoors/snow,
/area/submap/cove)
"oa" = (
/mob/living/simple_mob/humanoid/pirate/captain,
/turf/simulated/floor/wood,
/area/submap/cove)
"oh" = (
/turf/simulated/wall/gold{
	can_open = 1
	},
/area/submap/cove)
"ov" = (
/obj/structure/table/marble,
/obj/random/maintenance/foodstuff,
/obj/random/maintenance/foodstuff,
/obj/random/maintenance/foodstuff,
/obj/random/maintenance/foodstuff,
/turf/simulated/floor/wood,
/area/submap/cove)
"oM" = (
/obj/machinery/teleport/hub,
/turf/simulated/floor/wood,
/area/submap/cove)
"ps" = (
/obj/structure/closet/crate/secure/loot,
/obj/machinery/light/poi{
	dir = 4
	},
/turf/simulated/floor/wood,
/area/submap/cove)
"qI" = (
/turf/simulated/floor/outdoors/snow,
/area/submap/cove)
"qO" = (
/obj/structure/table/bench/wooden,
/mob/living/simple_mob/humanoid/pirate/mate/ranged/shotgun,
/turf/simulated/floor/wood,
/area/submap/cove)
"qW" = (
/obj/machinery/appliance/cooker/oven,
/turf/simulated/floor/wood,
/area/submap/cove)
"rj" = (
/turf/simulated/mineral/ignore_mapgen,
/area/template_noop)
"sc" = (
/obj/structure/prop/rock/water,
/turf/simulated/floor/water{
	outdoors = 0
	},
/area/submap/cove)
"sl" = (
/obj/structure/simple_door/wood,
/turf/simulated/floor/wood,
/area/submap/cove)
"uf" = (
/obj/structure/prop/rock/watersharp,
/turf/simulated/floor/water{
	outdoors = 0
	},
/area/submap/cove)
"uy" = (
/mob/living/simple_mob/mechanical/mecha/ripley/pirate/manned,
/turf/simulated/floor/wood,
/area/submap/cove)
"uM" = (
/obj/machinery/light/poi{
	dir = 1
	},
/turf/simulated/floor/wood,
/area/submap/cove)
"vN" = (
/obj/structure/table/standard,
/obj/item/weapon/gun/projectile/revolvershotgun,
/turf/simulated/floor/wood,
/area/submap/cove)
"wD" = (
/obj/structure/table/sifwooden_reinforced,
/obj/machinery/chemical_dispenser/bar_alc/full{
	dir = 8
	},
/turf/simulated/floor/wood,
/area/submap/cove)
"wO" = (
/obj/structure/table/bench/wooden,
/turf/simulated/floor/wood,
/area/submap/cove)
"xo" = (
/mob/living/simple_mob/mechanical/mecha/ripley/red_flames{
	faction = "pirate"
	},
/turf/simulated/floor/wood,
/area/submap/cove)
"xN" = (
/obj/structure/table/rack,
/obj/item/weapon/reagent_containers/chem_disp_cartridge/dexalin,
/obj/item/weapon/reagent_containers/chem_disp_cartridge/nuka_cola,
/obj/random/gun/random,
/obj/random/energy/highend,
/obj/random/maintenance/morestuff,
/obj/random/maintenance/morestuff,
/obj/random/maintenance/morestuff,
/obj/random/contraband,
/turf/simulated/floor/wood,
/area/submap/cove)
"Ac" = (
/mob/living/simple_mob/humanoid/pirate/ranged/handcannon/armored,
/turf/simulated/floor/outdoors/snow,
/area/submap/cove)
"AU" = (
/obj/machinery/light/poi{
	dir = 8
	},
/turf/simulated/floor/wood,
/area/submap/cove)
"Dv" = (
/obj/structure/prop/rock/small/water,
/turf/simulated/floor/water{
	outdoors = 0
	},
/area/submap/cove)
"EC" = (
/obj/structure/table/sifwooden_reinforced,
/obj/random/maintenance/foodstuff,
/obj/random/maintenance/foodstuff,
/obj/random/maintenance/foodstuff,
/obj/machinery/light/poi{
	dir = 4
	},
/turf/simulated/floor/wood,
/area/submap/cove)
"ED" = (
/mob/living/simple_mob/humanoid/pirate/shield/machete/armored,
/turf/simulated/floor/wood,
/area/submap/cove)
"Gb" = (
/turf/simulated/floor/wood,
/area/submap/cove)
"Hb" = (
/obj/structure/table/bench/wooden,
/mob/living/simple_mob/humanoid/merc/melee/sword/space{
	faction = "pirate"
	},
/turf/simulated/floor/wood,
/area/submap/cove)
"Hu" = (
/obj/structure/table/rack,
/obj/item/weapon/reagent_containers/chem_disp_cartridge/sleeptox,
/obj/item/weapon/reagent_containers/chem_disp_cartridge/oxycodone,
/obj/random/gun/random,
/obj/random/energy/highend,
/obj/random/maintenance/morestuff,
/obj/random/maintenance/morestuff,
/obj/random/maintenance/morestuff,
/obj/random/contraband,
/turf/simulated/floor/wood,
/area/submap/cove)
"HQ" = (
/obj/structure/table/sifwooden_reinforced,
/obj/machinery/chemical_dispenser/bar_soft/full{
	dir = 8
	},
/turf/simulated/floor/wood,
/area/submap/cove)
"IP" = (
/mob/living/simple_mob/humanoid/pirate/mate/ranged/shotgun,
/turf/simulated/floor/wood,
/area/submap/cove)
"Kk" = (
/mob/living/simple_mob/humanoid/pirate/las/armored,
/turf/simulated/floor/outdoors/snow,
/area/submap/cove)
"Ky" = (
/obj/structure/table/marble,
/obj/machinery/microwave,
/turf/simulated/floor/wood,
/area/submap/cove)
"LQ" = (
/obj/structure/table/marble,
/obj/random/maintenance/foodstuff,
/obj/random/maintenance/foodstuff,
/obj/random/maintenance/foodstuff,
/obj/random/maintenance/foodstuff,
/obj/random/maintenance/foodstuff,
/turf/simulated/floor/wood,
/area/submap/cove)
"MQ" = (
/obj/structure/table/sifwooden_reinforced,
/obj/random/maintenance/foodstuff,
/obj/random/maintenance/foodstuff,
/turf/simulated/floor/wood,
/area/submap/cove)
"Nn" = (
/obj/machinery/power/smes/buildable/point_of_interest,
/turf/simulated/floor/wood,
/area/submap/cove)
"NQ" = (
/mob/living/simple_mob/humanoid/pirate/las/armored,
/turf/simulated/floor/wood,
/area/submap/cove)
"Ox" = (
/obj/random/ammo,
/turf/simulated/floor/wood,
/area/submap/cove)
"Pj" = (
/obj/structure/table/bench/wooden,
/mob/living/simple_mob/humanoid/merc/voxpirate/ranged/captain{
	faction = "pirate"
	},
/turf/simulated/floor/wood,
/area/submap/cove)
"Pl" = (
/obj/structure/railing{
	dir = 8
	},
/turf/simulated/floor/wood,
/area/submap/cove)
"RE" = (
/obj/structure/table/sifwooden_reinforced,
/obj/random/gun/random,
/turf/simulated/floor/wood,
/area/submap/cove)
"RT" = (
/turf/template_noop,
/area/template_noop)
"RV" = (
/obj/machinery/light/poi,
/turf/simulated/floor/wood,
/area/submap/cove)
"SB" = (
/mob/living/simple_mob/humanoid/pirate/ranged/armored,
/turf/simulated/floor/outdoors/snow,
/area/submap/cove)
"Tm" = (
/turf/simulated/mineral/ignore_mapgen,
/area/submap/cove)
"TN" = (
/obj/random/medical/pillbottle,
/turf/simulated/floor/wood,
/area/submap/cove)
"Wb" = (
/obj/structure/railing{
	dir = 4
	},
/turf/simulated/floor/wood,
/area/submap/cove)
"Wu" = (
/mob/living/simple_mob/humanoid/pirate/ranged/shotgun/armored,
/turf/simulated/floor/outdoors/snow,
/area/submap/cove)
"WK" = (
/obj/structure/bed/chair/comfy/orange{
	dir = 8
	},
/turf/simulated/floor/wood,
/area/submap/cove)
"Xf" = (
/obj/structure/table/bench/wooden,
/mob/living/simple_mob/humanoid/pirate/ranged/handcannon/armored,
/turf/simulated/floor/wood,
/area/submap/cove)
"Xl" = (
/obj/structure/railing{
	dir = 1
	},
/turf/simulated/floor/wood,
/area/submap/cove)
"XJ" = (
/obj/structure/bed/double/padded,
/obj/item/weapon/bedsheet/piratedouble,
/obj/machinery/light/poi{
	dir = 1
	},
/turf/simulated/floor/wood,
/area/submap/cove)
"Zs" = (
/obj/structure/railing{
	dir = 1
	},
/obj/structure/railing{
	dir = 4
	},
/turf/simulated/floor/wood,
/area/submap/cove)

(1,1,1) = {"
RT
RT
RT
RT
RT
RT
RT
RT
RT
RT
RT
rj
rj
rj
rj
rj
rj
rj
rj
rj
RT
RT
RT
RT
RT
RT
RT
RT
RT
RT
"}
(2,1,1) = {"
RT
RT
RT
RT
RT
RT
RT
RT
fq
fq
fq
fq
rj
rj
rj
rj
rj
rj
rj
rj
rj
rj
rj
RT
RT
RT
RT
RT
RT
RT
"}
(3,1,1) = {"
RT
RT
RT
RT
RT
RT
RT
fq
fq
fq
fq
fq
fq
fq
fq
rj
rj
rj
rj
rj
rj
rj
rj
rj
rj
rj
rj
rj
rj
RT
"}
(4,1,1) = {"
RT
RT
RT
RT
RT
fq
fq
fq
fq
fq
sc
fq
fq
fq
fq
fq
rj
rj
rj
rj
lk
lk
lk
lk
lk
lk
lk
lk
rj
RT
"}
(5,1,1) = {"
RT
RT
RT
RT
fq
fq
fq
fq
fq
fq
fq
fq
fq
fq
fq
sc
fq
qI
rj
rj
lk
Gb
aP
Ox
Ox
TN
Gb
lk
rj
RT
"}
(6,1,1) = {"
RT
RT
RT
fq
fq
sc
fq
fq
fq
fq
fq
fq
Dv
fq
fq
fq
fq
qI
qI
rj
lk
Gb
LQ
ht
qW
LQ
Gb
lk
rj
RT
"}
(7,1,1) = {"
RT
RT
fq
fq
fq
fq
fq
fq
fq
uf
fq
fq
fq
fq
fq
fq
qI
qI
qI
Tm
lk
Ox
TN
ds
IP
Ox
Gb
lk
rj
RT
"}
(8,1,1) = {"
RT
fq
fq
uf
fq
fq
fq
fq
fq
fq
fq
fq
sc
fq
fq
qI
qI
qI
Tm
Tm
lk
Gb
LQ
Ky
Ky
ov
Gb
lk
rj
RT
"}
(9,1,1) = {"
RT
fq
fq
fq
Gb
Gb
Gb
fq
fq
fq
fq
fq
fq
fq
qI
qI
qI
qI
Tm
Tm
lk
Gb
Ox
TN
NQ
Gb
Ox
lk
rj
RT
"}
(10,1,1) = {"
RT
fq
fq
fq
Gb
oM
Gb
fq
fq
fq
fq
fq
fq
Ac
qI
qI
qI
qI
lk
lk
lk
lk
Gb
lk
lk
Gb
lk
lk
rj
RT
"}
(11,1,1) = {"
RT
fq
fq
fq
Gb
Gb
Gb
fq
fq
fq
fq
fq
fq
Kk
SB
qI
bx
Pl
lk
Gb
Gb
AU
Gb
Gb
Gb
Gb
AU
lk
rj
RT
"}
(12,1,1) = {"
RT
fq
fq
fq
Gb
Gb
Gb
mh
mh
Gb
Gb
Gb
ED
Wu
qI
qI
Xl
Gb
lk
Gb
wO
Gb
Pj
Gb
wO
Gb
Gb
lk
rj
RT
"}
(13,1,1) = {"
RT
fq
fq
fq
Gb
Gb
Gb
Gb
mh
mh
Gb
Gb
Gb
qI
nN
qI
Gb
Gb
sl
Gb
MQ
ld
MQ
RE
MQ
Gb
RV
lk
rj
RT
"}
(14,1,1) = {"
RT
fq
fq
fq
Gb
Gb
Gb
mh
mh
Gb
Gb
Gb
ED
Wu
qI
qI
Xl
Gb
lk
uM
Hb
uy
wO
Gb
wO
Gb
Gb
lk
rj
RT
"}
(15,1,1) = {"
RT
RT
uf
fq
Gb
Gb
Gb
fq
fq
fq
fq
fq
fq
Kk
SB
qI
Zs
Wb
lk
Gb
Gb
wO
Gb
wO
Gb
qO
Gb
lk
rj
RT
"}
(16,1,1) = {"
RT
RT
fq
fq
Gb
oM
Gb
fq
fq
fq
fq
fq
fq
Ac
qI
qI
qI
qI
lk
Gb
Gb
MQ
RE
MQ
ld
MQ
RV
lk
rj
RT
"}
(17,1,1) = {"
RT
RT
fq
fq
Gb
Gb
Gb
fq
fq
fq
fq
fq
fq
lL
qI
qI
qI
qI
lk
Gb
Gb
nt
Gb
wO
Gb
wO
Gb
lk
rj
RT
"}
(18,1,1) = {"
RT
RT
fq
fq
fq
fq
fq
fq
fq
fq
fq
fq
fq
fq
qI
qI
qI
qI
lk
Gb
Gb
Gb
Gb
Gb
Gb
Gb
Gb
lk
rj
RT
"}
(19,1,1) = {"
RT
RT
fq
fq
fq
fq
fq
fq
fq
fq
sc
fq
fq
fq
qI
qI
qI
qI
lk
uM
Gb
wO
Gb
Xf
Gb
wO
RV
lk
rj
RT
"}
(20,1,1) = {"
RT
RT
RT
fq
fq
fq
uf
fq
fq
fq
fq
fq
fq
fq
fq
qI
qI
qI
lk
Gb
ld
MQ
RE
MQ
ld
MQ
RE
lk
rj
RT
"}
(21,1,1) = {"
RT
RT
RT
fq
fq
fq
fq
fq
fq
Dv
fq
fq
fq
fq
fq
qI
qI
qI
lk
Gb
Gb
Gb
Gb
oa
Gb
Gb
Gb
lk
rj
RT
"}
(22,1,1) = {"
RT
RT
RT
RT
fq
fq
fq
fq
fq
fq
fq
fq
fq
fq
fq
qI
qI
qI
lk
HQ
iU
kD
iU
wD
EC
Gb
Gb
lk
rj
RT
"}
(23,1,1) = {"
RT
RT
RT
RT
fq
fq
fq
fq
fq
fq
fq
fq
fq
fq
fq
qI
qI
qI
lk
lk
lk
lk
lk
lk
lk
sl
lk
lk
rj
RT
"}
(24,1,1) = {"
RT
RT
RT
RT
fq
fq
sc
fq
fq
sc
fq
fq
uf
fq
fq
qI
qI
qI
Tm
Tm
lk
eO
aa
oh
Gb
Gb
vN
lk
rj
RT
"}
(25,1,1) = {"
RT
RT
RT
RT
fq
fq
fq
fq
fq
fq
fq
fq
fq
fq
fq
qI
qI
qI
qI
Tm
lk
lk
Gb
lk
XJ
Gb
WK
lk
rj
RT
"}
(26,1,1) = {"
RT
RT
RT
RT
fq
fq
fq
fq
fq
fq
fq
fq
fq
fq
fq
fq
qI
Tm
Tm
Tm
lk
xN
Gb
lk
lk
oh
lk
lk
rj
RT
"}
(27,1,1) = {"
RT
RT
RT
RT
RT
fq
fq
fq
fq
fq
fq
Dv
fq
fq
fq
fq
qI
Tm
Tm
Tm
lk
lk
Gb
lk
br
Gb
lk
lk
rj
RT
"}
(28,1,1) = {"
RT
RT
RT
RT
RT
fq
fq
fq
uf
fq
fq
fq
fq
fq
fq
fq
qI
qI
Tm
Tm
lk
Hu
xo
lk
Nn
ps
lk
rj
rj
RT
"}
(29,1,1) = {"
RT
RT
RT
RT
RT
RT
fq
fq
fq
fq
fq
fq
fq
sc
fq
fq
fq
qI
Tm
Tm
lk
lk
lk
lk
lk
lk
lk
rj
rj
RT
"}
(30,1,1) = {"
RT
RT
RT
RT
RT
RT
RT
fq
fq
fq
fq
fq
fq
fq
fq
fq
fq
qI
qI
Tm
Tm
Tm
Tm
Tm
Tm
Tm
Tm
rj
rj
RT
"}
(31,1,1) = {"
RT
RT
RT
RT
RT
RT
RT
fq
fq
uf
fq
fq
fq
fq
fq
fq
fq
qI
qI
Tm
Tm
rj
rj
rj
rj
rj
rj
rj
rj
RT
"}
(32,1,1) = {"
RT
RT
RT
RT
RT
RT
RT
RT
fq
fq
fq
fq
fq
Dv
fq
fq
fq
qI
Tm
rj
rj
rj
rj
rj
rj
rj
RT
RT
RT
RT
"}
(33,1,1) = {"
RT
RT
RT
RT
RT
RT
RT
RT
fq
fq
fq
fq
fq
fq
fq
fq
fq
Tm
rj
rj
rj
rj
rj
rj
RT
RT
RT
RT
RT
RT
"}
(34,1,1) = {"
RT
RT
RT
RT
RT
RT
RT
RT
RT
RT
fq
fq
fq
fq
fq
Tm
Tm
rj
rj
rj
rj
rj
RT
RT
RT
RT
RT
RT
RT
RT
"}
(35,1,1) = {"
RT
RT
RT
RT
RT
RT
RT
RT
RT
RT
RT
RT
RT
RT
rj
rj
rj
rj
rj
rj
RT
RT
RT
RT
RT
RT
RT
RT
RT
RT
"}
