//MAP CONVERTED BY dmm2tgm.py THIS HEADER COMMENT PREVENTS RECONVERSION, DO NOT REMOVE
"a" = (
/turf/simulated/floor/wood,
/area/space)
"b" = (
/mob/living/simple_mob/humanoid/pirate/las/armored,
/turf/simulated/floor/outdoors/ironsand,
/area/space)
"c" = (
/obj/structure/railing{
	dir = 1
	},
/obj/structure/railing{
	dir = 4
	},
/turf/simulated/floor/wood,
/area/space)
"d" = (
/mob/living/simple_mob/humanoid/pirate/captain,
/turf/simulated/floor/wood,
/area/space)
"e" = (
/obj/structure/table/sifwooden_reinforced,
/obj/machinery/chemical_dispenser/bar_alc/full{
	dir = 8
	},
/turf/simulated/floor/wood,
/area/space)
"g" = (
/obj/structure/table/standard,
/obj/item/weapon/gun/projectile/revolvershotgun,
/turf/simulated/floor/wood,
/area/space)
"h" = (
/turf/simulated/wall/wood,
/area/space)
"i" = (
/obj/machinery/power/smes/buildable/point_of_interest,
/turf/simulated/floor/wood,
/area/space)
"j" = (
/obj/structure/prop/rock/small/water,
/turf/simulated/floor/water/ocean,
/area/space)
"k" = (
/obj/structure/bed/double/padded,
/obj/item/weapon/bedsheet/piratedouble,
/turf/simulated/floor/wood,
/area/space)
"n" = (
/obj/structure/table/bench/wooden,
/mob/living/simple_mob/humanoid/merc/melee/sword/space{
	faction = "pirate"
	},
/turf/simulated/floor/wood,
/area/space)
"o" = (
/obj/structure/table/sifwooden_reinforced,
/obj/machinery/chemical_dispenser/bar_coffee/full{
	dir = 8
	},
/obj/machinery/light/poi{
	dir = 4
	},
/turf/simulated/floor/wood,
/area/space)
"p" = (
/obj/structure/bed/chair/comfy/black{
	dir = 4
	},
/turf/simulated/floor/wood,
/area/space)
"q" = (
/obj/structure/table/bench/wooden,
/mob/living/simple_mob/humanoid/merc/voxpirate/ranged/suppressor{
	faction = "pirate"
	},
/turf/simulated/floor/wood,
/area/space)
"r" = (
/obj/machinery/light/poi{
	dir = 8
	},
/turf/simulated/floor/wood,
/area/space)
"s" = (
/obj/structure/table/bench/wooden,
/mob/living/simple_mob/humanoid/pirate/ranged/handcannon/armored,
/turf/simulated/floor/wood,
/area/space)
"u" = (
/obj/machinery/power/apc{
	dir = 1;
	name = "PAPC";
	pixel_x = 0;
	pixel_y = 24
	},
/obj/machinery/power/terminal{
	dir = 4
	},
/turf/simulated/floor/wood,
/area/space)
"v" = (
/mob/living/simple_mob/humanoid/pirate/shield/machete/armored,
/turf/simulated/floor/wood,
/area/space)
"w" = (
/obj/structure/bed/chair/comfy/black{
	dir = 8
	},
/turf/simulated/floor/wood,
/area/space)
"x" = (
/turf/simulated/floor/water/ocean,
/area/space)
"y" = (
/mob/living/simple_mob/humanoid/pirate/ranged/shotgun/armored,
/turf/simulated/floor/outdoors/ironsand,
/area/space)
"z" = (
/turf/simulated/wall/gold{
	can_open = 1
	},
/area/space)
"A" = (
/obj/structure/table/sifwooden_reinforced,
/obj/random/maintenance/foodstuff,
/obj/random/maintenance/foodstuff,
/obj/random/maintenance/foodstuff,
/turf/simulated/floor/wood,
/area/space)
"B" = (
/obj/structure/table/sifwooden_reinforced,
/obj/random/gun/random,
/turf/simulated/floor/wood,
/area/space)
"C" = (
/turf/simulated/mineral/ignore_mapgen,
/area/space)
"D" = (
/mob/living/simple_mob/humanoid/pirate/ranged/handcannon/armored,
/turf/simulated/floor/outdoors/ironsand,
/area/space)
"E" = (
/obj/structure/prop/rock/watersharp,
/turf/simulated/floor/water/ocean,
/area/space)
"F" = (
/turf/template_noop,
/area/space)
"G" = (
/obj/machinery/teleport/hub,
/turf/simulated/floor/wood,
/area/space)
"H" = (
/mob/living/simple_mob/humanoid/pirate/ranged/armored,
/turf/simulated/floor/outdoors/ironsand,
/area/space)
"I" = (
/obj/structure/railing{
	dir = 1
	},
/obj/structure/railing{
	dir = 8
	},
/turf/simulated/floor/wood,
/area/space)
"J" = (
/obj/structure/prop/rock/water,
/turf/simulated/floor/water/ocean,
/area/space)
"K" = (
/obj/structure/railing{
	dir = 4
	},
/turf/simulated/floor/wood,
/area/space)
"L" = (
/obj/machinery/light/poi,
/turf/simulated/floor/wood,
/area/space)
"M" = (
/obj/structure/railing{
	dir = 1
	},
/turf/simulated/floor/wood,
/area/space)
"N" = (
/obj/structure/closet/crate/secure/loot,
/obj/machinery/light/poi{
	dir = 4
	},
/turf/simulated/floor/wood,
/area/space)
"O" = (
/obj/structure/table/sifwooden_reinforced,
/obj/machinery/chemical_dispenser/bar_soft/full{
	dir = 8
	},
/turf/simulated/floor/wood,
/area/space)
"P" = (
/obj/structure/table/bench/wooden,
/mob/living/simple_mob/humanoid/merc/voxpirate/ranged/captain{
	faction = "pirate"
	},
/turf/simulated/floor/wood,
/area/space)
"Q" = (
/obj/structure/simple_door/wood,
/turf/simulated/floor/wood,
/area/space)
"R" = (
/turf/simulated/floor/outdoors/ironsand,
/area/space)
"S" = (
/obj/structure/table/sifwooden_reinforced,
/obj/random/maintenance/foodstuff,
/obj/random/maintenance/foodstuff,
/obj/random/maintenance/foodstuff,
/obj/machinery/light/poi{
	dir = 4
	},
/turf/simulated/floor/wood,
/area/space)
"T" = (
/obj/structure/table/bench/wooden,
/turf/simulated/floor/wood,
/area/space)
"U" = (
/obj/structure/table/sifwooden_reinforced,
/obj/random/maintenance/foodstuff,
/obj/random/maintenance/foodstuff,
/turf/simulated/floor/wood,
/area/space)
"V" = (
/obj/structure/table/sifwooden_reinforced,
/obj/random/contraband,
/turf/simulated/floor/wood,
/area/space)
"W" = (
/obj/structure/railing{
	dir = 8
	},
/turf/simulated/floor/wood,
/area/space)
"X" = (
/obj/random/mob/merc/all,
/turf/simulated/floor/wood,
/area/space)
"Y" = (
/obj/structure/table/bench/wooden,
/mob/living/simple_mob/humanoid/pirate/mate/ranged/shotgun,
/turf/simulated/floor/wood,
/area/space)
"Z" = (
/obj/machinery/light/poi{
	dir = 1
	},
/turf/simulated/floor/wood,
/area/space)

(1,1,1) = {"
F
F
F
F
F
F
F
F
F
F
F
C
C
C
C
C
C
C
C
C
F
F
F
F
F
F
F
F
F
F
"}
(2,1,1) = {"
F
F
F
F
F
F
F
F
x
x
x
x
C
C
C
C
C
C
C
C
C
C
C
F
F
F
F
F
F
F
"}
(3,1,1) = {"
F
F
F
F
F
F
F
x
x
x
x
x
x
x
x
C
C
C
C
C
C
C
C
C
F
F
F
F
F
F
"}
(4,1,1) = {"
F
F
F
F
F
x
x
x
x
x
J
x
x
x
x
x
C
C
C
C
C
C
C
C
C
C
F
F
F
F
"}
(5,1,1) = {"
F
F
F
F
x
x
x
x
x
x
x
x
x
x
x
J
x
R
C
C
C
C
C
C
C
C
C
F
F
F
"}
(6,1,1) = {"
F
F
F
x
x
J
x
x
x
x
x
x
j
x
x
x
x
R
R
C
C
C
C
C
C
C
C
F
F
F
"}
(7,1,1) = {"
F
F
x
x
x
x
x
x
x
E
x
x
x
x
x
x
R
R
R
C
C
C
C
C
C
C
C
C
F
F
"}
(8,1,1) = {"
F
x
x
E
x
x
x
x
x
x
x
x
J
x
x
R
R
R
C
C
C
C
C
C
C
C
C
C
C
F
"}
(9,1,1) = {"
F
x
x
x
a
a
a
x
x
x
x
x
x
x
R
R
R
R
C
C
C
C
C
C
C
C
C
C
C
F
"}
(10,1,1) = {"
F
x
x
x
a
G
a
x
x
x
x
x
x
D
R
R
R
R
h
h
h
h
h
h
h
h
h
h
C
F
"}
(11,1,1) = {"
F
x
x
x
a
a
a
x
x
x
x
x
x
b
H
R
I
W
h
a
a
r
a
a
r
a
a
h
C
F
"}
(12,1,1) = {"
F
x
x
x
a
a
a
X
X
a
a
a
v
y
R
R
M
a
h
a
T
a
P
a
T
a
a
h
C
F
"}
(13,1,1) = {"
F
x
x
x
a
a
a
a
X
X
a
a
a
R
R
R
a
a
Q
a
U
V
U
B
U
a
L
h
C
F
"}
(14,1,1) = {"
F
x
x
x
a
a
a
X
X
a
a
a
v
y
R
R
M
a
h
Z
n
a
T
a
T
a
a
h
C
F
"}
(15,1,1) = {"
F
F
E
x
a
a
a
x
x
x
x
x
x
b
H
R
c
K
h
a
a
T
a
T
a
Y
a
h
C
F
"}
(16,1,1) = {"
F
F
x
x
a
G
a
x
x
x
x
x
x
D
R
R
R
R
h
a
a
U
B
U
V
U
L
h
C
F
"}
(17,1,1) = {"
F
F
x
x
a
a
a
x
x
x
x
x
x
x
R
R
R
R
h
a
a
q
a
T
a
T
a
h
C
F
"}
(18,1,1) = {"
F
F
x
x
x
x
x
x
x
x
x
x
x
x
R
R
R
R
h
a
a
a
a
a
a
a
a
h
C
F
"}
(19,1,1) = {"
F
F
x
x
x
x
x
x
x
x
J
x
x
x
R
R
R
R
h
Z
a
T
a
s
a
T
L
h
C
F
"}
(20,1,1) = {"
F
F
F
x
x
x
E
x
x
x
x
x
x
x
x
R
R
R
h
a
V
U
B
U
V
U
B
h
C
F
"}
(21,1,1) = {"
F
F
F
x
x
x
x
x
x
j
x
x
x
x
x
R
R
R
h
a
a
a
a
d
a
a
a
h
C
F
"}
(22,1,1) = {"
F
F
F
F
x
x
x
x
x
x
x
x
x
x
x
R
R
R
h
O
A
o
A
e
S
a
a
h
C
F
"}
(23,1,1) = {"
F
F
F
F
x
x
x
x
x
x
x
x
x
x
x
R
R
R
h
h
h
h
h
h
h
Q
h
h
C
F
"}
(24,1,1) = {"
F
F
F
F
x
x
J
x
x
J
x
x
E
x
x
R
R
R
C
C
h
u
a
z
a
a
p
h
C
F
"}
(25,1,1) = {"
F
F
F
F
x
x
x
x
x
x
x
x
x
x
x
R
R
R
R
C
h
i
N
h
Z
a
g
h
C
F
"}
(26,1,1) = {"
F
F
F
F
x
x
x
x
x
x
x
x
x
x
x
x
R
C
C
C
h
h
h
h
k
a
w
h
C
F
"}
(27,1,1) = {"
F
F
F
F
F
x
x
x
x
x
x
j
x
x
x
x
R
C
C
C
C
C
C
h
h
h
h
h
C
F
"}
(28,1,1) = {"
F
F
F
F
F
x
x
x
E
x
x
x
x
x
x
x
R
R
C
C
C
C
C
C
C
C
C
C
C
F
"}
(29,1,1) = {"
F
F
F
F
F
F
x
x
x
x
x
x
x
J
x
x
x
R
C
C
C
C
C
C
C
C
C
C
C
F
"}
(30,1,1) = {"
F
F
F
F
F
F
F
x
x
x
x
x
x
x
x
x
x
R
R
C
C
C
C
C
C
C
C
C
C
F
"}
(31,1,1) = {"
F
F
F
F
F
F
F
x
x
E
x
x
x
x
x
x
x
R
R
C
C
C
C
C
C
C
C
C
C
F
"}
(32,1,1) = {"
F
F
F
F
F
F
F
F
x
x
x
x
x
j
x
x
x
R
C
C
C
C
C
C
C
C
F
F
F
F
"}
(33,1,1) = {"
F
F
F
F
F
F
F
F
x
x
x
x
x
x
x
x
x
C
C
C
C
C
C
C
F
F
F
F
F
F
"}
(34,1,1) = {"
F
F
F
F
F
F
F
F
F
F
x
x
x
x
x
C
C
C
C
C
C
C
F
F
F
F
F
F
F
F
"}
(35,1,1) = {"
F
F
F
F
F
F
F
F
F
F
F
F
F
F
C
C
C
C
C
C
F
F
F
F
F
F
F
F
F
F
"}
