//MAP CONVERTED BY dmm2tgm.py THIS HEADER COMMENT PREVENTS RECONVERSION, DO NOT REMOVE
"aa" = (
/obj/machinery/atmospherics/pipe/simple/visible{
	dir = 9
	},
/obj/structure/sign/nanotrasen,
/turf/simulated/shuttle/wall/voidcraft/lightblue,
/area/space)
"ag" = (
/obj/effect/decal/cleanable/blood,
/obj/random/mob/spider/mutant,
/turf/simulated/shuttle/floor/white,
/area/space)
"am" = (
/obj/structure/table/glass,
/obj/item/device/defib_kit/loaded,
/obj/structure/closet/walllocker_double/medical/south,
/obj/item/weapon/storage/firstaid/regular,
/obj/item/weapon/storage/firstaid/combat,
/obj/item/weapon/storage/firstaid/surgery,
/obj/item/weapon/storage/firstaid/adv,
/turf/simulated/shuttle/floor/white,
/area/space)
"aC" = (
/obj/machinery/portable_atmospherics/canister/phoron,
/obj/machinery/atmospherics/portables_connector,
/obj/structure/sign/poster/nanotrasen{
	dir = 1
	},
/turf/simulated/shuttle/plating,
/area/space)
"bF" = (
/obj/structure/window/plastitanium/full,
/obj/structure/window/reinforced/survival_pod{
	dir = 1
	},
/obj/structure/window/reinforced/survival_pod,
/obj/structure/grille/rustic{
	health = 25;
	name = "reinforced grille"
	},
/obj/machinery/door/blast/regular,
/turf/simulated/shuttle/plating,
/area/space)
"bG" = (
/obj/structure/cable/green{
	d1 = 1;
	d2 = 8;
	icon_state = "1-8"
	},
/obj/machinery/atmospherics/pipe/simple/hidden/yellow{
	dir = 10
	},
/obj/effect/floor_decal/industrial/warning,
/obj/structure/cable/green{
	d1 = 1;
	d2 = 4;
	icon_state = "1-4"
	},
/obj/item/weapon/stock_parts/manipulator/omni,
/turf/simulated/shuttle/floor/black,
/area/space)
"cI" = (
/obj/structure/window/reinforced/survival_pod,
/obj/structure/grille/broken,
/obj/item/weapon/material/shard/titaniumglass,
/obj/item/weapon/material/shard/titaniumglass,
/turf/simulated/shuttle/plating,
/area/space)
"dv" = (
/obj/structure/cable/green{
	d1 = 1;
	d2 = 2;
	icon_state = "1-2"
	},
/turf/simulated/shuttle/floor/black,
/area/space)
"dU" = (
/obj/structure/bed/chair/bay/comfy/blue{
	dir = 1
	},
/mob/living/simple_mob/animal/giant_spider/phorogenic,
/turf/simulated/shuttle/floor/black,
/area/space)
"ey" = (
/obj/machinery/light{
	dir = 1
	},
/obj/structure/bed/chair/bay/shuttle,
/obj/random/rigsuit/chancetofail,
/turf/simulated/shuttle/floor/black,
/area/space)
"eQ" = (
/turf/simulated/shuttle/wall/voidcraft/lightblue,
/area/space)
"fv" = (
/obj/random/energy/highend,
/turf/simulated/shuttle/floor/black,
/area/space)
"go" = (
/obj/structure/cable/green{
	d1 = 1;
	d2 = 2;
	icon_state = "1-2"
	},
/obj/item/weapon/circuitboard/sleeper_console,
/turf/simulated/shuttle/floor/black,
/area/space)
"hi" = (
/obj/machinery/light{
	dir = 1
	},
/obj/machinery/computer/ship{
	dir = 4
	},
/turf/simulated/shuttle/floor/black,
/area/space)
"hl" = (
/obj/machinery/atmospherics/unary/engine{
	dir = 1
	},
/turf/template_noop,
/area/space)
"hn" = (
/obj/structure/bed/chair/bay/comfy/blue{
	dir = 1
	},
/obj/random/mob/spider/mutant,
/turf/simulated/shuttle/floor/black,
/area/space)
"hr" = (
/obj/structure/frame,
/turf/simulated/shuttle/floor/black,
/area/space)
"ig" = (
/turf/simulated/shuttle/wall/voidcraft/no_join,
/area/space)
"iG" = (
/obj/structure/cable/green{
	d1 = 4;
	d2 = 8;
	icon_state = "4-8"
	},
/obj/machinery/atmospherics/binary/pump{
	dir = 4
	},
/obj/effect/floor_decal/industrial/warning/corner,
/obj/effect/floor_decal/industrial/warning{
	dir = 8
	},
/turf/simulated/shuttle/floor/black,
/area/space)
"jc" = (
/obj/structure/bed/chair/bay/shuttle,
/mob/living/simple_mob/animal/giant_spider/nurse,
/obj/effect/decal/cleanable/blood,
/turf/simulated/shuttle/floor/black,
/area/space)
"ke" = (
/obj/structure/window/plastitanium/full,
/obj/structure/window/reinforced/survival_pod{
	dir = 4
	},
/obj/structure/window/reinforced/survival_pod{
	dir = 1
	},
/obj/structure/window/reinforced/survival_pod,
/obj/structure/grille/rustic{
	health = 25;
	name = "reinforced grille"
	},
/obj/machinery/door/blast/regular,
/turf/simulated/shuttle/plating,
/area/space)
"lL" = (
/obj/effect/floor_decal/industrial/outline/yellow,
/obj/structure/closet/crate/engineering,
/obj/fiftyspawner/steel,
/obj/fiftyspawner/glass,
/obj/item/weapon/tank/phoron,
/obj/item/weapon/tank/phoron,
/obj/item/weapon/storage/toolbox/mechanical,
/obj/item/weapon/storage/toolbox/electrical,
/obj/item/device/multitool,
/obj/item/weapon/storage/briefcase/inflatable,
/obj/item/device/geiger,
/obj/item/clothing/glasses/goggles,
/obj/item/clothing/glasses/goggles,
/obj/item/device/t_scanner,
/obj/item/clothing/glasses/welding,
/obj/item/clothing/gloves/yellow,
/turf/simulated/shuttle/plating,
/area/space)
"mj" = (
/obj/machinery/atmospherics/pipe/simple/hidden/yellow{
	dir = 10
	},
/turf/simulated/shuttle/wall/voidcraft/hard_corner,
/area/space)
"mA" = (
/obj/structure/sign/redcross,
/turf/simulated/shuttle/wall/voidcraft/hard_corner,
/area/space)
"mX" = (
/obj/machinery/vending/wallmed1{
	dir = 4;
	pixel_x = -23
	},
/obj/machinery/light{
	dir = 8
	},
/mob/living/simple_mob/animal/giant_spider/phorogenic,
/obj/item/weapon/circuitboard/sleeper,
/turf/simulated/shuttle/floor/white,
/area/space)
"nS" = (
/turf/simulated/shuttle/wall/voidcraft/hard_corner,
/area/space)
"nV" = (
/mob/living/simple_mob/animal/giant_spider/phorogenic,
/turf/simulated/shuttle/floor/black,
/area/space)
"pd" = (
/obj/effect/floor_decal/industrial/warning{
	dir = 10
	},
/obj/machinery/atmospherics/unary/vent_pump/high_volume{
	dir = 1;
	frequency = 1380;
	id_tag = "shuttle4_pump"
	},
/obj/machinery/light,
/turf/simulated/shuttle/plating,
/area/space)
"pl" = (
/obj/structure/closet/secure_closet/guncabinet/phase{
	req_one_access = null
	},
/obj/effect/floor_decal/industrial/warning{
	dir = 5
	},
/obj/machinery/light{
	dir = 8
	},
/obj/random/rigsuit/chancetofail,
/obj/random/projectile,
/turf/simulated/shuttle/floor/darkred,
/area/space)
"qn" = (
/obj/machinery/atmospherics/unary/vent_pump/high_volume{
	frequency = 1380;
	id_tag = "shuttle4_pump"
	},
/obj/effect/floor_decal/industrial/warning{
	dir = 5
	},
/obj/machinery/airlock_sensor{
	frequency = 1380;
	id_tag = "shuttle4_sensor";
	pixel_y = 28
	},
/turf/simulated/shuttle/plating,
/area/space)
"rh" = (
/obj/machinery/computer/ship/navigation/telescreen{
	pixel_x = -32;
	pixel_y = -5
	},
/obj/structure/closet/walllocker/emerglocker{
	dir = 1;
	pixel_y = -32
	},
/mob/living/simple_mob/animal/giant_spider/carrier,
/turf/simulated/shuttle/floor/black,
/area/space)
"sR" = (
/obj/structure/window/plastitanium/full,
/obj/structure/window/reinforced/survival_pod{
	dir = 4
	},
/obj/structure/window/reinforced/survival_pod{
	dir = 8
	},
/obj/structure/window/reinforced/survival_pod{
	dir = 1
	},
/obj/structure/window/reinforced/survival_pod,
/obj/structure/grille/rustic{
	health = 25;
	name = "reinforced grille"
	},
/obj/machinery/door/blast/regular,
/turf/simulated/shuttle/plating,
/area/space)
"tP" = (
/obj/structure/cable/green{
	d1 = 1;
	d2 = 2;
	icon_state = "1-2"
	},
/obj/item/weapon/circuitboard/recharge_station,
/turf/simulated/shuttle/floor/black,
/area/space)
"up" = (
/obj/structure/cable/green{
	d2 = 4;
	icon_state = "0-4"
	},
/obj/structure/railing{
	dir = 1
	},
/obj/structure/frame,
/turf/simulated/shuttle/plating,
/area/space)
"ur" = (
/obj/machinery/atmospherics/pipe/manifold/visible{
	dir = 8
	},
/obj/machinery/light{
	dir = 4
	},
/obj/machinery/space_heater,
/obj/item/device/radio{
	pixel_x = 5;
	pixel_y = 5
	},
/obj/item/device/radio{
	pixel_x = 5;
	pixel_y = 5
	},
/obj/item/device/radio{
	pixel_x = -5;
	pixel_y = 5
	},
/obj/item/device/radio{
	pixel_x = -5;
	pixel_y = 5
	},
/obj/structure/closet/walllocker_double/hydrant/east,
/turf/simulated/shuttle/plating,
/area/space)
"uM" = (
/obj/structure/shuttle/engine/heater,
/obj/machinery/atmospherics/pipe/simple/hidden/yellow{
	dir = 10
	},
/turf/simulated/shuttle/wall/voidcraft/lightblue,
/area/space)
"vH" = (
/obj/item/weapon/stock_parts/capacitor/omni,
/turf/simulated/shuttle/floor/white,
/area/space)
"wv" = (
/obj/machinery/atmospherics/pipe/simple/visible{
	dir = 5
	},
/obj/machinery/access_button{
	command = "cycle_interior";
	frequency = 1380;
	master_tag = "shuttle4_shuttle";
	name = "interior access button";
	pixel_y = 26
	},
/obj/machinery/door/airlock/voidcraft/vertical{
	frequency = 1380;
	id_tag = "shuttle4_inner";
	locked = 1;
	name = "Internal Access"
	},
/obj/structure/cable/green{
	d1 = 4;
	d2 = 8;
	icon_state = "4-8"
	},
/turf/simulated/shuttle/plating,
/area/space)
"wU" = (
/obj/structure/cable/green{
	d2 = 2;
	icon_state = "0-2"
	},
/obj/structure/frame,
/turf/simulated/shuttle/plating,
/area/space)
"wZ" = (
/obj/machinery/portable_atmospherics/canister/phoron,
/obj/machinery/atmospherics/portables_connector,
/turf/simulated/shuttle/plating,
/area/space)
"xp" = (
/obj/machinery/power/apc/hyper{
	pixel_y = -24
	},
/obj/structure/cable/green{
	d2 = 4;
	icon_state = "0-4"
	},
/obj/effect/decal/cleanable/blood,
/turf/simulated/shuttle/floor/black,
/area/space)
"xA" = (
/obj/machinery/atmospherics/pipe/manifold/visible{
	dir = 4
	},
/obj/effect/floor_decal/industrial/warning{
	dir = 4
	},
/obj/structure/cable/green{
	d1 = 4;
	d2 = 8;
	icon_state = "4-8"
	},
/turf/simulated/shuttle/plating,
/area/space)
"xB" = (
/obj/machinery/optable,
/turf/simulated/shuttle/floor/white,
/area/space)
"zI" = (
/obj/structure/window/plastitanium/full,
/obj/structure/window/reinforced/survival_pod{
	dir = 8
	},
/obj/structure/window/reinforced/survival_pod{
	dir = 1
	},
/obj/structure/window/reinforced/survival_pod,
/obj/structure/grille/rustic{
	health = 25;
	name = "reinforced grille"
	},
/obj/machinery/door/blast/regular,
/turf/simulated/shuttle/plating,
/area/space)
"zO" = (
/obj/machinery/door/airlock/voidcraft/vertical{
	frequency = 1380;
	id_tag = "shuttle4_outer";
	locked = 1;
	name = "External Access"
	},
/obj/machinery/access_button{
	command = "cycle_exterior";
	frequency = 1380;
	master_tag = "shuttle4_shuttle";
	name = "exterior access button";
	pixel_y = 26
	},
/obj/machinery/door/blast/regular/open{
	dir = 4;
	id = "stargazer_blast";
	layer = 2.5;
	name = "window blast shield"
	},
/obj/structure/cable/green{
	d1 = 4;
	d2 = 8;
	icon_state = "4-8"
	},
/turf/simulated/shuttle/plating,
/area/space)
"AE" = (
/obj/machinery/door/airlock/voidcraft/vertical{
	icon_state = "door_locked";
	id_tag = "expshuttle4_door_L";
	locked = 1;
	name = "shuttle side hatch"
	},
/obj/structure/cable/blue{
	d1 = 4;
	d2 = 8;
	icon_state = "4-8"
	},
/obj/machinery/button/remote/airlock{
	id = "expshuttle4_door_L";
	name = "Side Hatch Control";
	pixel_y = -26;
	specialfunctions = 4
	},
/obj/machinery/door/blast/regular/open{
	dir = 4;
	id = "stargazer_blast";
	layer = 2.5;
	name = "window blast shield"
	},
/turf/simulated/shuttle/plating,
/area/space)
"AK" = (
/obj/machinery/atmospherics/unary/vent_pump/high_volume{
	frequency = 1380;
	id_tag = "shuttle4_pump"
	},
/obj/effect/floor_decal/industrial/warning{
	dir = 9
	},
/obj/machinery/embedded_controller/radio/airlock/docking_port{
	frequency = 1380;
	id_tag = "shuttle4_shuttle";
	pixel_y = 26;
	tag_airpump = "shuttle4_pump";
	tag_chamber_sensor = "shuttle4_sensor";
	tag_exterior_door = "shuttle4_outer";
	tag_interior_door = "shuttle4_inner"
	},
/obj/structure/closet/walllocker/emerglocker{
	pixel_x = -25;
	pixel_y = 32
	},
/turf/simulated/shuttle/plating,
/area/space)
"Cc" = (
/mob/living/simple_mob/animal/giant_spider/carrier,
/turf/simulated/shuttle/floor/black,
/area/space)
"CY" = (
/obj/machinery/shipsensors,
/obj/effect/catwalk_plated/dark,
/turf/simulated/shuttle/plating,
/area/space)
"DH" = (
/turf/simulated/shuttle/floor/black,
/area/space)
"DJ" = (
/obj/machinery/computer/ship,
/turf/simulated/shuttle/floor/black,
/area/space)
"DQ" = (
/obj/structure/table/reinforced,
/obj/item/device/gps{
	pixel_x = 3;
	pixel_y = 3
	},
/obj/item/device/gps,
/obj/structure/closet/walllocker_double/kitchen/east,
/obj/item/weapon/storage/mre/random,
/obj/item/weapon/storage/mre/random,
/obj/item/weapon/storage/mre/random,
/obj/item/weapon/storage/mre/random,
/obj/item/weapon/storage/mre/random,
/obj/item/weapon/storage/mre/random,
/obj/item/weapon/storage/mre/random,
/turf/simulated/shuttle/floor/black,
/area/space)
"Ft" = (
/obj/structure/bed/chair/bay/shuttle{
	dir = 1
	},
/obj/effect/decal/cleanable/blood,
/obj/random/mob/spider/mutant,
/turf/simulated/shuttle/floor/black,
/area/space)
"FI" = (
/obj/machinery/atmospherics/pipe/simple/hidden/yellow{
	dir = 8
	},
/obj/machinery/door/blast/regular/open{
	id = "stargazer_blast";
	layer = 2.5;
	name = "window blast shield"
	},
/obj/machinery/door/blast/regular,
/turf/simulated/shuttle/plating,
/area/space)
"FX" = (
/obj/machinery/atmospherics/pipe/manifold4w/visible,
/obj/machinery/meter,
/obj/effect/floor_decal/industrial/warning{
	dir = 8
	},
/obj/structure/cable/green{
	d1 = 4;
	d2 = 8;
	icon_state = "4-8"
	},
/turf/simulated/shuttle/plating,
/area/space)
"Gb" = (
/obj/machinery/atmospherics/pipe/simple/visible{
	dir = 4
	},
/turf/simulated/shuttle/wall/voidcraft/no_join,
/area/space)
"Hk" = (
/obj/machinery/atmospherics/pipe/simple/hidden/yellow{
	dir = 6
	},
/turf/simulated/shuttle/wall/voidcraft/hard_corner,
/area/space)
"KT" = (
/obj/structure/frame,
/turf/simulated/shuttle/floor/white,
/area/space)
"KV" = (
/obj/effect/floor_decal/industrial/warning{
	dir = 4
	},
/obj/structure/bed/chair/bay/shuttle,
/obj/structure/sign/poster/nanotrasen{
	dir = 1
	},
/turf/simulated/shuttle/floor/black,
/area/space)
"Ln" = (
/obj/structure/sign/nosmoking_1{
	pixel_y = 32
	},
/obj/structure/frame,
/turf/simulated/shuttle/floor/white,
/area/space)
"LN" = (
/obj/machinery/light,
/obj/structure/bed/chair/bay/shuttle{
	dir = 1
	},
/turf/simulated/shuttle/floor/black,
/area/space)
"LY" = (
/obj/structure/cable/green{
	d1 = 2;
	d2 = 8;
	icon_state = "2-8"
	},
/obj/item/weapon/stock_parts/scanning_module/omni,
/turf/simulated/shuttle/floor/black,
/area/space)
"MU" = (
/obj/effect/floor_decal/industrial/warning/full,
/obj/machinery/light{
	dir = 1
	},
/obj/machinery/mech_recharger,
/obj/random/mob/spider/mutant,
/turf/simulated/shuttle/plating,
/area/space)
"Ns" = (
/obj/machinery/computer/ship,
/obj/machinery/button/remote/blast_door{
	dir = 4;
	id = "stargazer_blast";
	name = "remote blast shielding control";
	pixel_x = -26;
	pixel_y = -1
	},
/turf/simulated/shuttle/floor/black,
/area/space)
"NF" = (
/obj/effect/floor_decal/industrial/warning{
	dir = 4
	},
/obj/structure/bed/chair/bay/shuttle{
	dir = 1
	},
/obj/effect/decal/cleanable/blood,
/obj/random/rigsuit/chancetofail,
/turf/simulated/shuttle/floor/black,
/area/space)
"NP" = (
/obj/effect/floor_decal/industrial/warning{
	dir = 6
	},
/obj/machinery/atmospherics/unary/vent_pump/high_volume{
	dir = 1;
	frequency = 1380;
	id_tag = "shuttle4_pump"
	},
/obj/structure/closet/emcloset,
/turf/simulated/shuttle/plating,
/area/space)
"OF" = (
/obj/machinery/computer/ship{
	dir = 8
	},
/obj/machinery/light{
	dir = 1
	},
/turf/simulated/shuttle/floor/black,
/area/space)
"Pn" = (
/obj/structure/shuttle/engine/heater,
/obj/machinery/atmospherics/pipe/simple/hidden/yellow{
	dir = 6
	},
/turf/simulated/shuttle/wall/voidcraft/lightblue,
/area/space)
"Qs" = (
/obj/machinery/atmospherics/pipe/manifold/hidden/yellow{
	dir = 1
	},
/obj/structure/shuttle/engine/heater,
/turf/simulated/shuttle/wall/voidcraft/hard_corner,
/area/space)
"Qx" = (
/obj/machinery/atmospherics/pipe/simple/hidden/yellow{
	dir = 8
	},
/turf/simulated/shuttle/wall/voidcraft/hard_corner,
/area/space)
"QU" = (
/obj/machinery/portable_atmospherics/canister/air,
/obj/machinery/atmospherics/portables_connector,
/obj/machinery/recharger/wallcharger{
	pixel_x = 4;
	pixel_y = 25
	},
/turf/simulated/shuttle/plating,
/area/space)
"Rd" = (
/obj/machinery/shuttle_sensor{
	id_tag = "shuttle4sens_exp_psg"
	},
/turf/simulated/shuttle/wall/voidcraft/hard_corner,
/area/space)
"RE" = (
/obj/structure/grille/broken,
/obj/item/weapon/material/shard/titaniumglass,
/obj/item/weapon/material/shard/titaniumglass,
/obj/structure/window/reinforced/survival_pod{
	dir = 1
	},
/turf/simulated/shuttle/plating,
/area/space)
"RL" = (
/obj/machinery/power/shield_generator/upgraded,
/obj/structure/railing{
	dir = 1
	},
/obj/structure/cable/green{
	d2 = 8;
	icon_state = "0-8"
	},
/obj/structure/cable/green{
	d1 = 1;
	d2 = 8;
	icon_state = "1-8"
	},
/turf/simulated/shuttle/plating,
/area/space)
"Se" = (
/obj/effect/catwalk_plated/dark,
/turf/simulated/shuttle/plating,
/area/space)
"SE" = (
/obj/machinery/atmospherics/pipe/simple/hidden/yellow{
	dir = 5
	},
/obj/machinery/power/terminal,
/obj/structure/cable/blue{
	d2 = 8;
	icon_state = "0-8"
	},
/obj/structure/closet/walllocker/emerglocker{
	pixel_x = -25;
	pixel_y = 32
	},
/mob/living/simple_mob/animal/giant_spider/phorogenic,
/turf/simulated/shuttle/floor/yellow,
/area/space)
"SV" = (
/obj/effect/floor_decal/industrial/warning,
/obj/structure/cable/green{
	d1 = 4;
	d2 = 8;
	icon_state = "4-8"
	},
/mob/living/simple_mob/animal/giant_spider/carrier,
/turf/simulated/shuttle/floor/black,
/area/space)
"Tb" = (
/obj/machinery/atmospherics/pipe/simple/visible{
	dir = 6
	},
/turf/simulated/shuttle/wall/voidcraft/hard_corner,
/area/space)
"TU" = (
/obj/machinery/atmospherics/pipe/simple/visible{
	dir = 4
	},
/turf/simulated/shuttle/wall/voidcraft/hard_corner,
/area/space)
"Ue" = (
/obj/machinery/portable_atmospherics/canister/air,
/obj/machinery/atmospherics/portables_connector{
	dir = 1
	},
/obj/machinery/recharger/wallcharger{
	pixel_x = 4;
	pixel_y = -32
	},
/turf/simulated/shuttle/plating,
/area/space)
"Uz" = (
/obj/machinery/atmospherics/pipe/manifold/hidden/yellow,
/obj/machinery/button/remote/airlock{
	desiredstate = 1;
	dir = 4;
	id = "expshuttle4_door_cargo";
	name = "Rear Hatch Control";
	pixel_x = -26;
	req_access = list(67);
	specialfunctions = 4
	},
/obj/machinery/door/blast/regular/open{
	id = "stargazer_blast";
	layer = 2.5;
	name = "window blast shield"
	},
/obj/machinery/door/airlock/multi_tile/metal/mait{
	icon_state = "door_locked";
	id_tag = "expshuttle4_door_cargo";
	locked = 1
	},
/obj/machinery/door/blast/regular,
/turf/simulated/shuttle/plating,
/area/space)
"UG" = (
/turf/template_noop,
/area/space)
"UT" = (
/obj/machinery/computer/ship,
/obj/machinery/button/remote/airlock{
	desiredstate = 1;
	dir = 8;
	id = "expshuttle4_door_cargo";
	name = "Rear Hatch Control";
	pixel_x = 26;
	req_access = list(67);
	specialfunctions = 4
	},
/turf/simulated/shuttle/floor/black,
/area/space)
"UU" = (
/obj/structure/fuel_port{
	pixel_y = -28
	},
/obj/structure/cable/green{
	d1 = 4;
	d2 = 8;
	icon_state = "4-8"
	},
/obj/machinery/atmospherics/pipe/simple/hidden/yellow{
	dir = 8
	},
/obj/structure/cable/green{
	d1 = 1;
	d2 = 8;
	icon_state = "1-8"
	},
/obj/random/energy/highend,
/turf/simulated/shuttle/floor/yellow,
/area/space)
"UY" = (
/obj/machinery/atmospherics/pipe/manifold/hidden/yellow,
/obj/structure/cable/green{
	d1 = 2;
	d2 = 4;
	icon_state = "2-4"
	},
/obj/effect/decal/cleanable/blood,
/obj/item/weapon/stock_parts/scanning_module/omni,
/turf/simulated/shuttle/floor/yellow,
/area/space)
"VE" = (
/obj/machinery/atmospherics/pipe/simple/visible{
	dir = 10
	},
/turf/simulated/shuttle/wall/voidcraft/no_join,
/area/space)
"Wn" = (
/obj/structure/cable/green{
	d1 = 1;
	d2 = 2;
	icon_state = "1-2"
	},
/obj/effect/decal/cleanable/blood,
/mob/living/simple_mob/animal/giant_spider/nurse,
/turf/simulated/shuttle/floor/black,
/area/space)
"Xp" = (
/obj/structure/window/plastitanium/full,
/obj/structure/window/reinforced/survival_pod{
	dir = 4
	},
/obj/structure/window/reinforced/survival_pod{
	dir = 8
	},
/obj/structure/window/reinforced/survival_pod{
	dir = 1
	},
/obj/structure/window/reinforced/survival_pod,
/obj/structure/grille/rustic{
	health = 25;
	name = "reinforced grille"
	},
/obj/machinery/door/blast/regular,
/obj/machinery/atmospherics/pipe/simple/visible,
/turf/simulated/shuttle/plating,
/area/space)
"Yk" = (
/obj/effect/floor_decal/industrial/warning{
	dir = 4
	},
/obj/item/weapon/stock_parts/manipulator/omni,
/turf/simulated/shuttle/floor/black,
/area/space)
"Yq" = (
/obj/machinery/shuttle_sensor{
	dir = 5;
	id_tag = "shuttle4sens_exp"
	},
/turf/simulated/shuttle/wall/voidcraft/lightblue,
/area/space)
"Yr" = (
/obj/item/weapon/stock_parts/capacitor/omni,
/turf/simulated/shuttle/floor/black,
/area/space)
"YK" = (
/obj/machinery/atmospherics/pipe/manifold/hidden/yellow{
	dir = 8
	},
/obj/structure/shuttle/engine/heater,
/turf/simulated/shuttle/wall/voidcraft/hard_corner,
/area/space)
"Zr" = (
/obj/machinery/atmospherics/pipe/manifold/hidden/yellow{
	dir = 4
	},
/obj/structure/shuttle/engine/heater,
/turf/simulated/shuttle/wall/voidcraft/hard_corner,
/area/space)
"Zs" = (
/obj/machinery/atmospherics/pipe/simple/visible,
/turf/simulated/shuttle/wall/voidcraft/hard_corner,
/area/space)
"ZS" = (
/obj/structure/sign/nanotrasen,
/turf/simulated/shuttle/wall/voidcraft/lightblue,
/area/space)

(1,1,1) = {"
UG
UG
UG
UG
UG
UG
UG
UG
UG
UG
UG
UG
UG
UG
UG
UG
"}
(2,1,1) = {"
UG
UG
UG
UG
UG
eQ
sR
ig
sR
ZS
eQ
AE
eQ
eQ
eQ
UG
"}
(3,1,1) = {"
UG
UG
UG
UG
eQ
nS
KT
mX
am
ig
wZ
SE
up
Pn
hl
UG
"}
(4,1,1) = {"
UG
UG
eQ
sR
nS
nS
Ln
ag
xB
nS
aC
UY
RL
Qs
hl
UG
"}
(5,1,1) = {"
UG
eQ
nS
hi
pl
nS
mA
vH
nS
nS
wU
UU
Hk
Zr
hl
UG
"}
(6,1,1) = {"
UG
zI
Ns
dU
xp
nS
hr
fv
rh
nS
MU
iG
Qx
CY
UG
UG
"}
(7,1,1) = {"
UG
bF
DJ
DH
LY
go
dv
Wn
dv
tP
dv
bG
Uz
Se
UG
UG
"}
(8,1,1) = {"
UG
ke
UT
hn
Cc
RE
jc
Yr
Ft
cI
lL
SV
FI
Se
UG
UG
"}
(9,1,1) = {"
UG
eQ
nS
OF
DQ
Rd
ey
nV
LN
Tb
Zs
wv
mj
YK
hl
UG
"}
(10,1,1) = {"
UG
UG
eQ
sR
nS
nS
KV
Yk
NF
TU
AK
FX
pd
Qs
hl
UG
"}
(11,1,1) = {"
UG
UG
UG
UG
eQ
nS
QU
ur
Ue
Gb
qn
xA
NP
uM
hl
UG
"}
(12,1,1) = {"
UG
UG
UG
UG
UG
eQ
sR
VE
Xp
aa
eQ
zO
Yq
eQ
eQ
UG
"}
(13,1,1) = {"
UG
UG
UG
UG
UG
UG
UG
UG
UG
UG
UG
UG
UG
UG
UG
UG
"}
