//MAP CONVERTED BY dmm2tgm.py THIS HEADER COMMENT PREVENTS RECONVERSION, DO NOT REMOVE
"aM" = (
/obj/fire,
/turf/simulated/floor/outdoors/dirt,
/area/submap/demonranch)
"bm" = (
/obj/structure/cliff/automatic{
	dir = 8
	},
/turf/simulated/floor/outdoors/dirt,
/area/submap/demonranch)
"cc" = (
/mob/living/simple_mob/humanoid/cultist/hunter,
/turf/simulated/floor/wood/sif,
/area/submap/demonranch)
"cO" = (
/obj/structure/railing,
/obj/effect/decal/cleanable/blood/gibs,
/turf/simulated/floor/wood/sif,
/area/submap/demonranch)
"eM" = (
/obj/structure/cliff/automatic,
/turf/simulated/floor/outdoors/dirt,
/area/submap/demonranch)
"gE" = (
/turf/simulated/floor/outdoors/grass/sif,
/area/template_noop)
"hq" = (
/turf/simulated/floor/water,
/area/submap/demonranch)
"hK" = (
/obj/structure/table/sifwoodentable,
/obj/item/clothing/suit/cultrobes,
/obj/item/clothing/head/culthood,
/obj/item/clothing/shoes/cult,
/turf/simulated/floor/wood/sif,
/area/submap/demonranch)
"hY" = (
/obj/effect/decal/cleanable/blood/gibs,
/turf/simulated/floor/outdoors/grass/sif,
/area/submap/demonranch)
"iw" = (
/obj/effect/landmark/loot_spawn/low,
/turf/simulated/floor/outdoors/dirt,
/area/submap/demonranch)
"kd" = (
/mob/living/simple_mob/vore/demonAI{
	faction = "cult"
	},
/turf/simulated/floor/outdoors/dirt,
/area/submap/demonranch)
"kV" = (
/obj/structure/table/sifwoodentable,
/obj/random/maintenance/foodstuff,
/obj/item/weapon/reagent_containers/food/snacks/meat,
/turf/simulated/floor/wood/sif,
/area/submap/demonranch)
"lo" = (
/obj/structure/cliff/automatic{
	dir = 2
	},
/turf/simulated/floor/outdoors/dirt,
/area/submap/demonranch)
"mG" = (
/obj/structure/table/sifwoodentable,
/obj/item/weapon/flame/candle/everburn,
/turf/simulated/floor/wood/sif,
/area/submap/demonranch)
"nh" = (
/obj/structure/cliff/automatic{
	dir = 4
	},
/turf/simulated/floor/outdoors/dirt,
/area/submap/demonranch)
"ot" = (
/obj/structure/loot_pile/surface/bones,
/turf/simulated/floor/outdoors/dirt,
/area/submap/demonranch)
"pr" = (
/turf/simulated/floor/outdoors/grass/sif,
/area/submap/demonranch)
"qv" = (
/obj/structure/table/sifwoodentable,
/obj/random/maintenance/foodstuff,
/obj/item/weapon/reagent_containers/food/snacks/meat,
/obj/random/energy,
/turf/simulated/floor/wood/sif,
/area/submap/demonranch)
"qA" = (
/obj/fire,
/obj/random/humanoidremains,
/turf/simulated/floor/outdoors/dirt,
/area/submap/demonranch)
"rx" = (
/obj/structure/table/sifwoodentable,
/obj/random/maintenance/foodstuff,
/obj/item/weapon/reagent_containers/food/snacks/meat,
/obj/random/gun/random,
/turf/simulated/floor/wood/sif,
/area/submap/demonranch)
"su" = (
/turf/simulated/floor/outdoors/dirt,
/area/submap/demonranch)
"sA" = (
/obj/fire,
/obj/fire,
/turf/simulated/floor/outdoors/dirt,
/area/submap/demonranch)
"ug" = (
/obj/structure/cliff/automatic/corner{
	dir = 6
	},
/turf/simulated/floor/outdoors/dirt,
/area/submap/demonranch)
"ul" = (
/obj/effect/decal/cleanable/blood/gibs,
/turf/simulated/floor/wood/sif,
/area/submap/demonranch)
"uK" = (
/mob/living/simple_mob/humanoid/cultist/human/bloodjaunt,
/turf/simulated/floor/wood/sif,
/area/submap/demonranch)
"uM" = (
/obj/structure/cliff/automatic{
	dir = 9
	},
/turf/simulated/floor/outdoors/dirt,
/area/submap/demonranch)
"vk" = (
/obj/structure/cliff/automatic/corner,
/turf/simulated/floor/outdoors/dirt,
/area/submap/demonranch)
"vY" = (
/mob/living/simple_mob/humanoid/cultist/tesh,
/turf/simulated/floor/wood/sif,
/area/submap/demonranch)
"we" = (
/obj/structure/railing{
	dir = 1
	},
/turf/simulated/floor/wood/sif,
/area/submap/demonranch)
"wt" = (
/obj/structure/cliff/automatic/corner{
	dir = 9
	},
/turf/simulated/floor/outdoors/dirt,
/area/submap/demonranch)
"yi" = (
/obj/structure/railing,
/turf/simulated/floor/wood/sif,
/area/submap/demonranch)
"zR" = (
/obj/structure/table/sifwoodentable,
/obj/item/weapon/flame/candle/candelabra,
/turf/simulated/floor/wood/sif,
/area/submap/demonranch)
"AI" = (
/obj/effect/landmark/loot_spawn,
/turf/simulated/floor/water,
/area/submap/demonranch)
"Cj" = (
/obj/structure/table/sifwoodentable,
/obj/random/contraband/nofail,
/obj/random/maintenance/foodstuff,
/obj/item/weapon/reagent_containers/food/snacks/meat,
/turf/simulated/floor/wood/sif,
/area/submap/demonranch)
"CN" = (
/obj/structure/table/sifwoodentable,
/obj/item/clothing/suit/cultrobes/alt,
/obj/item/clothing/head/culthood/alt,
/obj/item/clothing/shoes/cult,
/turf/simulated/floor/wood/sif,
/area/submap/demonranch)
"Ev" = (
/turf/simulated/floor/outdoors/dirt,
/area/template_noop)
"Gt" = (
/mob/living/simple_mob/humanoid/cultist/tesh,
/obj/effect/decal/cleanable/blood/gibs,
/turf/simulated/floor/wood/sif,
/area/submap/demonranch)
"Jf" = (
/obj/structure/kitchenspike,
/turf/simulated/floor/wood/sif,
/area/submap/demonranch)
"JG" = (
/obj/structure/closet/crate/secure/loot,
/turf/simulated/floor/wood/sif,
/area/submap/demonranch)
"Kf" = (
/obj/structure/table/sifwoodentable,
/obj/random/medical/pillbottle,
/obj/random/medical/pillbottle,
/turf/simulated/floor/wood/sif,
/area/submap/demonranch)
"KO" = (
/obj/structure/cliff/automatic{
	dir = 5
	},
/turf/simulated/floor/outdoors/dirt,
/area/submap/demonranch)
"Mq" = (
/obj/structure/cliff/automatic{
	dir = 6
	},
/turf/simulated/floor/outdoors/dirt,
/area/submap/demonranch)
"MV" = (
/mob/living/simple_mob/humanoid/cultist/castertesh,
/turf/simulated/floor/wood/sif,
/area/submap/demonranch)
"Nt" = (
/obj/structure/cliff/automatic{
	dir = 10
	},
/turf/simulated/floor/outdoors/dirt,
/area/submap/demonranch)
"NC" = (
/obj/structure/table/sifwoodentable,
/obj/random/firstaid,
/turf/simulated/floor/wood/sif,
/area/submap/demonranch)
"Pn" = (
/obj/structure/simple_door/sifwood,
/turf/simulated/floor/wood/sif,
/area/submap/demonranch)
"Rp" = (
/mob/living/simple_mob/vore/demonAI{
	faction = "cult"
	},
/turf/simulated/floor/water,
/area/submap/demonranch)
"Si" = (
/obj/effect/landmark/loot_spawn,
/turf/simulated/floor/outdoors/dirt,
/area/submap/demonranch)
"SG" = (
/obj/random/humanoidremains,
/turf/simulated/floor/outdoors/dirt,
/area/submap/demonranch)
"TH" = (
/turf/simulated/wall/log_sif,
/area/submap/demonranch)
"Up" = (
/obj/structure/cliff/automatic/corner{
	dir = 10
	},
/turf/simulated/floor/outdoors/dirt,
/area/submap/demonranch)
"UI" = (
/obj/structure/bed,
/obj/item/weapon/bedsheet/blue,
/turf/simulated/floor/wood/sif,
/area/submap/demonranch)
"UM" = (
/obj/item/weapon/spellbook/oneuse/charge,
/turf/simulated/floor/water,
/area/submap/demonranch)
"WY" = (
/obj/random/humanoidremains,
/turf/simulated/floor/water,
/area/submap/demonranch)
"Xg" = (
/turf/simulated/floor/wood/sif,
/area/submap/demonranch)
"XR" = (
/obj/structure/kitchenspike,
/obj/effect/decal/cleanable/blood/gibs,
/turf/simulated/floor/wood/sif,
/area/submap/demonranch)
"Zy" = (
/turf/template_noop,
/area/template_noop)

(1,1,1) = {"
Zy
Zy
Zy
Zy
Zy
Zy
Zy
Zy
Zy
Zy
Zy
Zy
Zy
Zy
Zy
Zy
Zy
Zy
Zy
Zy
Zy
Zy
Zy
Zy
Zy
Zy
Zy
Zy
Zy
Zy
Zy
Zy
Zy
Zy
Zy
"}
(2,1,1) = {"
Zy
Zy
uM
bm
bm
bm
bm
bm
bm
bm
bm
bm
bm
bm
bm
bm
bm
bm
bm
bm
bm
bm
bm
bm
bm
bm
bm
bm
bm
bm
bm
bm
Nt
Zy
Zy
"}
(3,1,1) = {"
Zy
Zy
eM
su
iw
hq
hq
iw
su
kd
aM
su
su
aM
su
ot
aM
SG
aM
su
aM
su
su
aM
aM
su
su
su
su
su
iw
su
lo
Zy
Zy
"}
(4,1,1) = {"
Zy
Zy
eM
su
hq
hq
hq
hq
su
su
aM
su
aM
su
aM
su
aM
su
su
aM
su
aM
aM
su
SG
su
kd
su
hq
hq
hq
iw
lo
Zy
Zy
"}
(5,1,1) = {"
Zy
Zy
eM
su
hq
UM
hq
hq
hq
su
su
aM
su
iw
kd
aM
su
aM
Si
su
ot
su
iw
aM
su
su
su
su
hq
hq
hq
hq
lo
Zy
Zy
"}
(6,1,1) = {"
Zy
Zy
eM
su
hq
hq
hq
hq
hq
su
aM
aM
su
aM
qA
su
su
su
aM
aM
su
su
aM
su
su
aM
ot
hq
hq
hq
hq
su
lo
Zy
Zy
"}
(7,1,1) = {"
Zy
Zy
eM
su
hq
hq
hq
AI
su
su
su
su
aM
su
su
su
aM
aM
su
kd
aM
aM
su
su
aM
su
su
Si
hq
hq
hq
su
lo
Zy
Zy
"}
(8,1,1) = {"
Zy
Zy
eM
su
su
hq
hq
su
ug
nh
nh
nh
nh
nh
nh
nh
nh
nh
nh
nh
nh
nh
nh
nh
nh
nh
vk
su
hq
hq
su
su
lo
Zy
Zy
"}
(9,1,1) = {"
Zy
Zy
eM
su
su
su
su
su
lo
TH
TH
TH
TH
TH
TH
TH
TH
TH
TH
TH
TH
TH
TH
TH
TH
TH
eM
su
su
su
su
kd
lo
Zy
Zy
"}
(10,1,1) = {"
Zy
Zy
eM
su
kd
su
SG
su
lo
we
Jf
Jf
Xg
ul
Xg
Xg
mG
TH
mG
Xg
ul
Xg
Jf
Jf
Xg
yi
eM
su
su
SG
su
su
lo
Zy
Zy
"}
(11,1,1) = {"
Zy
Zy
eM
su
su
su
ot
su
lo
we
ul
cc
Xg
Xg
Xg
Xg
qv
TH
rx
Xg
Xg
Xg
ul
cc
Xg
yi
eM
su
su
su
su
su
lo
Zy
Zy
"}
(12,1,1) = {"
Zy
Zy
eM
su
sA
su
su
sA
lo
we
Xg
MV
ul
Xg
Xg
vY
kV
TH
kV
Gt
Xg
Xg
Xg
MV
Xg
yi
eM
su
sA
su
su
sA
lo
Zy
Zy
"}
(13,1,1) = {"
Zy
Zy
eM
su
sA
sA
sA
sA
lo
we
Jf
Jf
Xg
Xg
ul
Xg
Cj
TH
Cj
Xg
Xg
Xg
Jf
Jf
ul
yi
eM
su
sA
sA
sA
sA
lo
Zy
Zy
"}
(14,1,1) = {"
Zy
Zy
eM
su
sA
sA
sA
sA
lo
TH
TH
TH
TH
TH
TH
Pn
TH
TH
TH
Pn
TH
TH
TH
TH
TH
TH
eM
su
sA
sA
sA
sA
lo
Zy
Zy
"}
(15,1,1) = {"
Zy
Zy
eM
su
sA
su
su
sA
lo
pr
pr
pr
pr
pr
TH
Xg
Kf
zR
NC
Xg
TH
pr
pr
pr
pr
pr
eM
su
sA
su
su
sA
lo
Zy
Zy
"}
(16,1,1) = {"
Zy
Zy
wt
su
su
su
su
su
Up
pr
pr
hY
pr
pr
Pn
Xg
Xg
vY
Xg
Xg
Pn
pr
pr
pr
hY
pr
wt
su
su
su
su
su
Up
Zy
Zy
"}
(17,1,1) = {"
Zy
Zy
Zy
Zy
Ev
su
su
pr
pr
pr
pr
pr
pr
pr
TH
CN
vY
Xg
vY
hK
TH
pr
pr
pr
pr
pr
pr
su
su
su
Ev
Ev
Zy
Zy
Zy
"}
(18,1,1) = {"
Zy
Zy
Zy
Zy
gE
pr
pr
pr
pr
pr
pr
pr
pr
TH
TH
TH
TH
Pn
TH
TH
TH
TH
pr
pr
pr
pr
pr
pr
pr
pr
Zy
Zy
Zy
Zy
Zy
"}
(19,1,1) = {"
Zy
Zy
Zy
gE
gE
pr
pr
pr
hY
pr
pr
pr
pr
TH
UI
Xg
zR
Xg
zR
Xg
UI
TH
pr
pr
pr
pr
pr
pr
pr
pr
Zy
Zy
Zy
Zy
Zy
"}
(20,1,1) = {"
Zy
Zy
Zy
gE
gE
pr
pr
pr
pr
pr
pr
pr
pr
TH
JG
uK
Xg
cc
Xg
uK
JG
TH
pr
pr
pr
pr
hY
pr
pr
pr
gE
Zy
Zy
Zy
Zy
"}
(21,1,1) = {"
Zy
Zy
Zy
Zy
gE
pr
pr
pr
pr
pr
pr
pr
pr
TH
UI
Xg
zR
Xg
zR
Xg
UI
TH
pr
pr
pr
pr
pr
pr
pr
pr
gE
Zy
Zy
Zy
Zy
"}
(22,1,1) = {"
Zy
Zy
Zy
Zy
Zy
su
su
su
pr
pr
pr
pr
pr
TH
TH
TH
TH
Pn
TH
TH
TH
TH
pr
pr
pr
pr
pr
pr
pr
su
Ev
Zy
Zy
Zy
Zy
"}
(23,1,1) = {"
Zy
Zy
Zy
Zy
Ev
su
su
su
su
pr
hY
pr
pr
pr
TH
hK
vY
Xg
vY
CN
TH
pr
pr
hY
pr
pr
pr
su
su
su
Ev
Ev
Zy
Zy
Zy
"}
(24,1,1) = {"
Zy
Zy
vk
su
su
su
su
su
ug
pr
pr
pr
pr
pr
Pn
Xg
Xg
vY
Xg
Xg
Pn
pr
pr
pr
pr
pr
vk
su
su
su
su
su
ug
Zy
Zy
"}
(25,1,1) = {"
Zy
Zy
eM
su
sA
su
su
sA
lo
pr
pr
pr
pr
pr
TH
Xg
NC
zR
Kf
Xg
TH
pr
pr
pr
pr
pr
eM
su
sA
su
su
sA
lo
Zy
Zy
"}
(26,1,1) = {"
Zy
Zy
eM
su
sA
sA
sA
sA
lo
TH
TH
TH
TH
TH
TH
Pn
TH
TH
TH
Pn
TH
TH
TH
TH
TH
TH
eM
su
sA
sA
sA
sA
lo
Zy
Zy
"}
(27,1,1) = {"
Zy
Zy
eM
su
sA
sA
sA
sA
lo
we
Jf
Jf
Xg
ul
Xg
Xg
Cj
TH
Cj
Xg
Xg
Xg
XR
Jf
Xg
yi
eM
su
sA
sA
sA
sA
lo
Zy
Zy
"}
(28,1,1) = {"
Zy
Zy
eM
su
sA
su
su
sA
lo
we
ul
MV
Xg
Xg
vY
Xg
kV
TH
kV
Xg
vY
Xg
Xg
MV
Xg
cO
eM
su
sA
su
su
sA
lo
Zy
Zy
"}
(29,1,1) = {"
Zy
Zy
eM
su
su
su
su
su
lo
we
Xg
cc
Xg
Xg
Xg
ul
rx
TH
qv
ul
Xg
Xg
Xg
cc
Xg
yi
eM
su
su
su
su
su
lo
Zy
Zy
"}
(30,1,1) = {"
Zy
Zy
eM
su
kd
su
SG
su
lo
we
Jf
Jf
ul
Xg
Xg
Xg
mG
TH
mG
Xg
Xg
ul
Jf
Jf
Xg
yi
eM
su
su
su
su
kd
lo
Zy
Zy
"}
(31,1,1) = {"
Zy
Zy
eM
su
su
su
su
su
lo
TH
TH
TH
TH
TH
TH
TH
TH
TH
TH
TH
TH
TH
TH
TH
TH
TH
eM
su
su
ot
su
su
lo
Zy
Zy
"}
(32,1,1) = {"
Zy
Zy
eM
su
su
hq
hq
su
Up
bm
bm
bm
bm
bm
bm
bm
bm
bm
bm
bm
bm
bm
bm
bm
bm
bm
wt
su
su
su
su
su
lo
Zy
Zy
"}
(33,1,1) = {"
Zy
Zy
eM
su
hq
hq
hq
AI
su
su
su
aM
aM
su
su
aM
su
aM
su
su
SG
aM
aM
su
su
su
su
AI
hq
su
su
SG
lo
Zy
Zy
"}
(34,1,1) = {"
Zy
Zy
eM
su
WY
hq
hq
hq
hq
ot
su
kd
aM
SG
aM
su
aM
su
su
aM
aM
su
su
aM
su
su
su
hq
hq
hq
su
su
lo
Zy
Zy
"}
(35,1,1) = {"
Zy
Zy
eM
su
su
hq
hq
hq
hq
su
aM
aM
su
iw
ot
aM
aM
Si
aM
su
su
iw
kd
su
aM
su
su
su
Rp
hq
hq
su
lo
Zy
Zy
"}
(36,1,1) = {"
Zy
Zy
eM
su
iw
su
hq
hq
su
su
su
su
aM
su
aM
su
kd
aM
su
qA
su
aM
su
aM
ot
su
su
SG
su
hq
hq
iw
lo
Zy
Zy
"}
(37,1,1) = {"
Zy
Zy
eM
su
su
iw
su
su
su
SG
su
su
su
aM
su
aM
su
su
aM
su
aM
su
aM
su
su
su
su
su
su
su
iw
su
lo
Zy
Zy
"}
(38,1,1) = {"
Zy
Zy
KO
nh
nh
nh
nh
nh
nh
nh
nh
nh
nh
nh
nh
nh
nh
nh
nh
nh
nh
nh
nh
nh
nh
nh
nh
nh
nh
nh
nh
nh
Mq
Zy
Zy
"}
(39,1,1) = {"
Zy
Zy
Zy
Zy
Zy
Zy
Zy
Zy
Zy
Zy
Zy
Zy
Zy
Zy
Zy
Zy
Zy
Zy
Zy
Zy
Zy
Zy
Zy
Zy
Zy
Zy
Zy
Zy
Zy
Zy
Zy
Zy
Zy
Zy
Zy
"}
