//MAP CONVERTED BY dmm2tgm.py THIS HEADER COMMENT PREVENTS RECONVERSION, DO NOT REMOVE
"ah" = (
/turf/simulated/floor/wood,
/area/submap/eclipseaqua)
"au" = (
/obj/structure/railing/grey{
	dir = 8
	},
/turf/simulated/floor/tiled/dark,
/area/submap/eclipseaqua)
"ca" = (
/obj/structure/table/rack,
/obj/item/weapon/rig/combat/equipped,
/obj/item/rig_module/vision/nvg,
/turf/simulated/floor/tiled/dark,
/area/submap/eclipseaqua)
"eb" = (
/obj/structure/cable{
	d1 = 1;
	d2 = 8;
	icon_state = "1-8"
	},
/turf/simulated/floor/tiled/dark,
/area/submap/eclipseaqua)
"eK" = (
/obj/structure/table/steel,
/obj/random/maintenance/foodstuff,
/obj/random/maintenance/foodstuff,
/obj/random/maintenance/foodstuff,
/turf/simulated/floor/tiled/dark,
/area/submap/eclipseaqua)
"gA" = (
/obj/structure/railing/grey{
	dir = 1
	},
/mob/living/simple_mob/humanoid/eclipse/solar/snipertesh,
/turf/simulated/floor/tiled/dark,
/area/submap/eclipseaqua)
"gH" = (
/mob/living/simple_mob/humanoid/eclipse/lunar/ravanger,
/turf/simulated/floor/tiled/dark,
/area/submap/eclipseaqua)
"gR" = (
/mob/living/simple_mob/humanoid/eclipse/lunar/shotgunner,
/turf/simulated/floor/outdoors/dirt,
/area/submap/eclipseaqua)
"iy" = (
/obj/structure/cable{
	d1 = 2;
	d2 = 4;
	icon_state = "2-4"
	},
/turf/simulated/floor/tiled/dark,
/area/submap/eclipseaqua)
"kd" = (
/mob/living/simple_mob/humanoid/eclipse/lunar/pummler,
/turf/simulated/floor/tiled/dark,
/area/submap/eclipseaqua)
"lS" = (
/obj/structure/table/steel,
/obj/item/weapon/storage/box/ambrosiadeus,
/turf/simulated/floor/tiled/dark,
/area/submap/eclipseaqua)
"mi" = (
/turf/template_noop,
/area/template_noop)
"mL" = (
/obj/structure/table/steel,
/obj/random/ammo,
/obj/random/ammo,
/obj/random/projectile/random,
/turf/simulated/floor/tiled/dark,
/area/submap/eclipseaqua)
"nc" = (
/obj/structure/railing,
/turf/simulated/floor/water,
/area/submap/eclipseaqua)
"nz" = (
/obj/machinery/biogenerator,
/turf/simulated/floor/tiled/dark,
/area/submap/eclipseaqua)
"ob" = (
/obj/machinery/door/airlock/voidcraft,
/turf/simulated/floor/tiled/dark,
/area/submap/eclipseaqua)
"pq" = (
/obj/machinery/power/smes/buildable/point_of_interest,
/turf/simulated/floor/tiled/dark,
/area/submap/eclipseaqua)
"pE" = (
/obj/structure/railing{
	dir = 1
	},
/turf/simulated/floor/water,
/area/submap/eclipseaqua)
"pN" = (
/obj/structure/railing/grey{
	dir = 4
	},
/obj/structure/railing/grey{
	dir = 1
	},
/turf/simulated/floor/tiled/dark,
/area/submap/eclipseaqua)
"rH" = (
/obj/structure/railing/grey{
	dir = 8
	},
/mob/living/simple_mob/humanoid/eclipse/solar/snipertesh,
/turf/simulated/floor/tiled/dark,
/area/submap/eclipseaqua)
"rR" = (
/mob/living/simple_mob/humanoid/eclipse/lunar/silvernoodle,
/turf/simulated/floor/tiled/dark,
/area/submap/eclipseaqua)
"ta" = (
/turf/simulated/floor/water,
/area/submap/eclipseaqua)
"uU" = (
/obj/structure/reagent_dispensers/fueltank,
/turf/simulated/floor/tiled/dark,
/area/submap/eclipseaqua)
"vt" = (
/obj/structure/railing/grey{
	dir = 8
	},
/obj/structure/railing/grey{
	dir = 1
	},
/turf/simulated/floor/tiled/dark,
/area/submap/eclipseaqua)
"vu" = (
/obj/machinery/power/terminal{
	dir = 8;
	icon_state = "term"
	},
/obj/structure/cable{
	d2 = 4;
	icon_state = "0-4"
	},
/turf/simulated/floor/tiled/dark,
/area/submap/eclipseaqua)
"xO" = (
/mob/living/simple_mob/humanoid/eclipse/solar/guardian,
/turf/simulated/floor/tiled/dark,
/area/submap/eclipseaqua)
"yn" = (
/obj/structure/table/steel,
/obj/random/maintenance/research,
/obj/random/maintenance/research,
/obj/random/maintenance/security,
/turf/simulated/floor/tiled/dark,
/area/submap/eclipseaqua)
"yX" = (
/obj/structure/window/titanium,
/obj/structure/window/titanium{
	dir = 1
	},
/obj/structure/window/titanium{
	dir = 4
	},
/obj/structure/window/titanium{
	dir = 8
	},
/obj/item/stack/material/void_opal,
/obj/structure/table/rack,
/turf/simulated/floor/reinforced/airless,
/area/submap/eclipseaqua)
"Cn" = (
/obj/structure/railing/grey{
	dir = 8
	},
/obj/structure/railing/grey,
/turf/simulated/floor/tiled/dark,
/area/submap/eclipseaqua)
"Cv" = (
/obj/machinery/power/apc{
	pixel_y = -24
	},
/obj/structure/cable,
/turf/simulated/floor/tiled/dark,
/area/submap/eclipseaqua)
"CM" = (
/mob/living/simple_mob/humanoid/eclipse/lunar/wheel,
/turf/simulated/floor/tiled/dark,
/area/submap/eclipseaqua)
"Dv" = (
/obj/structure/table/rack,
/obj/random/rigsuit,
/obj/item/rig_module/mounted/egun,
/turf/simulated/floor/tiled/dark,
/area/submap/eclipseaqua)
"Dw" = (
/obj/structure/table/steel,
/obj/random/ammo,
/obj/random/ammo,
/obj/random/energy/highend,
/turf/simulated/floor/tiled/dark,
/area/submap/eclipseaqua)
"Ej" = (
/obj/structure/cable{
	d1 = 4;
	d2 = 8;
	icon_state = "4-8"
	},
/turf/simulated/floor/tiled/dark,
/area/submap/eclipseaqua)
"Ek" = (
/obj/structure/railing/grey,
/mob/living/simple_mob/humanoid/eclipse/solar/snipertesh,
/turf/simulated/floor/tiled/dark,
/area/submap/eclipseaqua)
"Ev" = (
/obj/structure/table/rack,
/obj/random/rigsuit,
/obj/item/rig_module/chem_dispenser/combat,
/turf/simulated/floor/tiled/dark,
/area/submap/eclipseaqua)
"Ho" = (
/mob/living/simple_mob/humanoid/eclipse/solar/firemoff,
/turf/simulated/floor/tiled/dark,
/area/submap/eclipseaqua)
"HD" = (
/obj/structure/railing/grey{
	dir = 1
	},
/turf/simulated/floor/tiled/dark,
/area/submap/eclipseaqua)
"IY" = (
/obj/structure/table/steel,
/obj/item/weapon/reagent_containers/glass/bottle/left4zed,
/turf/simulated/floor/tiled/dark,
/area/submap/eclipseaqua)
"JQ" = (
/mob/living/simple_mob/humanoid/eclipse/lunar/bulletstorm,
/turf/simulated/floor/tiled/dark,
/area/submap/eclipseaqua)
"Kh" = (
/obj/machinery/power/terminal{
	dir = 1;
	icon_state = "term"
	},
/obj/structure/cable{
	d2 = 2;
	icon_state = "0-2"
	},
/turf/simulated/floor/tiled/dark,
/area/submap/eclipseaqua)
"Kv" = (
/obj/structure/table/steel,
/obj/random/ammo,
/obj/random/ammo,
/obj/random/handgun,
/turf/simulated/floor/tiled/dark,
/area/submap/eclipseaqua)
"KH" = (
/obj/structure/table/steel,
/obj/random/maintenance/research,
/obj/random/maintenance/research,
/obj/random/maintenance/morestuff,
/obj/random/maintenance/security,
/turf/simulated/floor/tiled/dark,
/area/submap/eclipseaqua)
"LC" = (
/obj/structure/table/steel,
/obj/random/ammo,
/obj/random/ammo,
/obj/random/medical/pillbottle,
/turf/simulated/floor/tiled/dark,
/area/submap/eclipseaqua)
"Ne" = (
/obj/structure/railing{
	dir = 8
	},
/turf/simulated/floor/water,
/area/submap/eclipseaqua)
"Oi" = (
/obj/structure/grille,
/obj/structure/window/titanium/full,
/obj/structure/window/titanium{
	dir = 8
	},
/obj/structure/window/titanium{
	dir = 4
	},
/obj/structure/window/titanium,
/obj/structure/window/titanium{
	dir = 1
	},
/turf/simulated/floor/tiled/dark,
/area/submap/eclipseaqua)
"Oo" = (
/obj/structure/table/steel,
/obj/random/ammo,
/obj/random/ammo,
/obj/random/grenade/lethal,
/turf/simulated/floor/tiled/dark,
/area/submap/eclipseaqua)
"Pf" = (
/turf/simulated/floor/outdoors/dirt,
/area/submap/eclipseaqua)
"Po" = (
/obj/structure/railing/grey{
	dir = 4
	},
/turf/simulated/floor/tiled/dark,
/area/submap/eclipseaqua)
"Qc" = (
/obj/machinery/portable_atmospherics/hydroponics,
/obj/item/seeds/celery,
/turf/simulated/floor/tiled/dark,
/area/submap/eclipseaqua)
"Qu" = (
/turf/simulated/wall/concrete,
/area/submap/eclipseaqua)
"QB" = (
/obj/structure/table/steel,
/obj/random/ammo,
/obj/random/ammo,
/obj/random/toolbox,
/turf/simulated/floor/tiled/dark,
/area/submap/eclipseaqua)
"Rt" = (
/turf/simulated/floor/outdoors/rocks,
/area/submap/eclipseaqua)
"Ry" = (
/turf/simulated/floor/tiled/dark,
/area/submap/eclipseaqua)
"TA" = (
/obj/structure/table/rack,
/obj/item/weapon/rig/breacher,
/obj/item/rig_module/pat_module,
/turf/simulated/floor/tiled/dark,
/area/submap/eclipseaqua)
"UF" = (
/obj/structure/railing/grey,
/turf/simulated/floor/tiled/dark,
/area/submap/eclipseaqua)
"UH" = (
/obj/structure/table/steel,
/obj/random/ammo,
/obj/random/ammo,
/obj/random/firstaid,
/turf/simulated/floor/tiled/dark,
/area/submap/eclipseaqua)
"UI" = (
/obj/structure/table/steel,
/obj/random/maintenance/research,
/obj/random/maintenance/research,
/obj/random/maintenance/morestuff,
/obj/random/maintenance/security,
/obj/item/stack/nanopaste/advanced,
/turf/simulated/floor/tiled/dark,
/area/submap/eclipseaqua)
"UJ" = (
/obj/structure/grille,
/obj/structure/window/titanium/full,
/obj/structure/window/titanium,
/obj/structure/window/titanium{
	dir = 4
	},
/obj/structure/window/titanium{
	dir = 1
	},
/obj/structure/window/titanium{
	dir = 8
	},
/turf/simulated/floor/tiled/dark,
/area/submap/eclipseaqua)
"UU" = (
/obj/structure/railing/grey,
/obj/structure/railing/grey{
	dir = 4
	},
/turf/simulated/floor/tiled/dark,
/area/submap/eclipseaqua)
"Vg" = (
/obj/item/weapon/stool/padded,
/turf/simulated/floor/tiled/dark,
/area/submap/eclipseaqua)
"Vn" = (
/obj/structure/table/steel,
/obj/random/ammo,
/obj/random/ammo,
/obj/random/gun/random,
/turf/simulated/floor/tiled/dark,
/area/submap/eclipseaqua)
"WS" = (
/obj/structure/railing/grey{
	dir = 4
	},
/mob/living/simple_mob/humanoid/eclipse/solar/snipertesh,
/turf/simulated/floor/tiled/dark,
/area/submap/eclipseaqua)
"Xm" = (
/obj/structure/table/steel,
/obj/random/ammo,
/obj/random/ammo,
/turf/simulated/floor/tiled/dark,
/area/submap/eclipseaqua)
"Yt" = (
/mob/living/simple_mob/humanoid/eclipse/solar/teslanoodle,
/turf/simulated/floor/tiled/dark,
/area/submap/eclipseaqua)
"Zm" = (
/obj/structure/cable{
	d1 = 2;
	d2 = 8;
	icon_state = "2-8"
	},
/obj/structure/cable{
	d1 = 1;
	d2 = 2;
	icon_state = "1-2"
	},
/turf/simulated/floor/tiled/dark,
/area/submap/eclipseaqua)
"ZK" = (
/obj/structure/railing{
	dir = 4
	},
/turf/simulated/floor/water,
/area/submap/eclipseaqua)

(1,1,1) = {"
mi
mi
mi
mi
mi
mi
mi
mi
mi
mi
mi
mi
mi
mi
mi
mi
mi
mi
mi
mi
mi
mi
mi
mi
mi
mi
mi
mi
mi
mi
mi
mi
mi
mi
mi
mi
mi
mi
mi
mi
mi
mi
mi
mi
mi
"}
(2,1,1) = {"
mi
mi
mi
mi
mi
mi
mi
mi
mi
mi
mi
mi
mi
mi
mi
mi
mi
mi
mi
mi
mi
mi
mi
mi
mi
mi
mi
mi
mi
mi
mi
mi
mi
mi
mi
mi
mi
mi
mi
mi
mi
mi
mi
mi
mi
"}
(3,1,1) = {"
mi
mi
mi
mi
mi
mi
mi
mi
mi
mi
mi
mi
mi
mi
mi
mi
mi
mi
mi
Rt
Rt
Rt
Rt
Rt
Rt
Rt
mi
mi
mi
mi
mi
mi
mi
mi
mi
mi
mi
mi
mi
mi
mi
mi
mi
mi
mi
"}
(4,1,1) = {"
mi
mi
mi
mi
mi
mi
mi
mi
mi
mi
mi
mi
mi
mi
Rt
Rt
Rt
Rt
Rt
ta
nc
ah
ah
ah
pE
ta
Rt
Rt
Rt
Rt
Rt
mi
mi
mi
mi
mi
mi
mi
mi
mi
mi
mi
mi
mi
mi
"}
(5,1,1) = {"
mi
mi
mi
mi
mi
mi
mi
mi
mi
mi
mi
Rt
Rt
Rt
ta
ta
ta
ta
ta
ta
nc
ah
ah
ah
pE
ta
ta
ta
ta
ta
ta
Rt
Rt
Rt
mi
mi
mi
mi
mi
mi
mi
mi
mi
mi
mi
"}
(6,1,1) = {"
mi
mi
mi
mi
mi
mi
mi
Rt
Rt
Rt
Rt
ta
ta
ta
ta
ta
ta
ta
ta
ta
nc
ah
ah
ah
pE
ta
ta
ta
ta
ta
ta
ta
ta
ta
Rt
Rt
Rt
Rt
mi
mi
mi
mi
mi
mi
mi
"}
(7,1,1) = {"
mi
mi
mi
mi
mi
mi
Rt
ta
ta
ta
ta
ta
ta
ta
ta
ta
ta
ta
ta
ta
nc
ah
ah
ah
pE
ta
ta
ta
ta
ta
ta
ta
ta
ta
ta
ta
ta
ta
Rt
mi
mi
mi
mi
mi
mi
"}
(8,1,1) = {"
mi
mi
mi
mi
mi
Rt
ta
ta
ta
ta
ta
ta
ta
ta
ta
ta
ta
ta
ta
ta
nc
ah
ah
ah
pE
ta
ta
ta
ta
ta
ta
ta
ta
ta
ta
ta
ta
ta
ta
Rt
mi
mi
mi
mi
mi
"}
(9,1,1) = {"
mi
mi
mi
mi
mi
Rt
ta
ta
ta
ta
ta
ta
ta
ta
ta
ta
ta
ta
ta
ta
nc
ah
ah
ah
pE
ta
ta
ta
ta
ta
ta
ta
ta
ta
ta
ta
ta
ta
ta
Rt
mi
mi
mi
mi
mi
"}
(10,1,1) = {"
mi
mi
mi
mi
mi
Rt
ta
ta
ta
ta
ta
ta
ta
ta
ta
ta
ta
ta
ta
ta
nc
ah
ah
ah
pE
ta
ta
ta
ta
ta
ta
ta
ta
ta
ta
ta
ta
ta
ta
Rt
mi
mi
mi
mi
mi
"}
(11,1,1) = {"
mi
mi
mi
mi
mi
Rt
ta
ta
ta
ta
ta
ta
ta
ta
ta
ta
ta
ta
ta
ta
nc
ah
ah
ah
pE
ta
ta
ta
ta
ta
ta
ta
ta
ta
ta
ta
ta
ta
ta
Rt
mi
mi
mi
mi
mi
"}
(12,1,1) = {"
mi
mi
mi
mi
Rt
ta
ta
ta
ta
ta
ta
ta
ta
ta
ta
ta
vt
rH
au
Qu
Qu
Pf
Pf
Pf
Qu
Qu
au
rH
Cn
ta
ta
ta
ta
ta
ta
ta
ta
ta
ta
ta
Rt
mi
mi
mi
mi
"}
(13,1,1) = {"
mi
mi
mi
mi
Rt
ta
ta
ta
ta
ta
ta
ta
ta
ta
ta
vt
Ry
Ry
Ry
QB
Qu
Pf
Pf
Pf
Qu
Xm
Ry
Ry
Ry
Cn
ta
ta
ta
ta
ta
ta
ta
ta
ta
ta
Rt
mi
mi
mi
mi
"}
(14,1,1) = {"
mi
mi
mi
mi
Rt
ta
ta
ta
ta
ta
ta
ta
ta
ta
vt
Ry
Ry
Ry
Ry
Xm
Qu
Pf
Pf
Pf
Qu
Dw
Ry
Ry
Ry
Ry
Cn
ta
ta
ta
ta
ta
ta
ta
ta
ta
Rt
mi
mi
mi
mi
"}
(15,1,1) = {"
mi
mi
mi
Rt
ta
ta
ta
ta
ta
ta
ta
ta
ta
vt
Qu
Qu
Qu
ob
Qu
Qu
Qu
Pf
Pf
Pf
Qu
Qu
Qu
ob
Qu
Qu
Qu
Cn
ta
ta
ta
ta
ta
ta
ta
ta
ta
Rt
mi
mi
mi
"}
(16,1,1) = {"
mi
mi
mi
Rt
ta
ta
ta
ta
ta
ta
ta
ta
vt
Ry
Qu
lS
IY
Ry
Ry
nz
Qu
Pf
gR
Pf
Qu
Ry
Ry
Vg
Vg
xO
Qu
Ry
Cn
ta
ta
ta
ta
ta
ta
ta
ta
Rt
mi
mi
mi
"}
(17,1,1) = {"
mi
mi
mi
Rt
ta
ta
ta
ta
ta
ta
ta
vt
Ry
Ry
Qu
uU
Ho
Ry
Ry
Ry
ob
Pf
Pf
Pf
Qu
Ry
Vg
eK
eK
Vg
Qu
Ry
Ry
Cn
ta
ta
ta
ta
ta
ta
ta
Rt
mi
mi
mi
"}
(18,1,1) = {"
mi
mi
mi
Rt
ta
ta
ta
ta
ta
ta
ta
gA
Ry
Ry
ob
Ry
Ry
Ry
Ry
Qc
Qu
Qu
Qu
Qu
Qu
Ry
Vg
eK
eK
Vg
ob
Ry
Ry
Ek
ta
ta
ta
ta
ta
ta
ta
Rt
mi
mi
mi
"}
(19,1,1) = {"
mi
mi
mi
Rt
ta
ta
ta
ta
ta
ta
ta
HD
Ry
Ry
Qu
Ry
Ry
Ry
rR
Qc
Qu
Ry
Ry
Ry
ob
Ry
gH
Vg
Vg
Ry
Qu
Ry
Ry
UF
ta
ta
ta
ta
ta
ta
ta
Rt
mi
mi
mi
"}
(20,1,1) = {"
mi
mi
Rt
ta
ta
ta
ta
ta
ta
ta
ta
Qu
Xm
Kv
Qu
Qc
Qc
Qc
Ry
Qu
Qu
Ry
Ry
Ry
Qu
Qu
Ry
Ry
Ry
Ry
Qu
Oo
Xm
Qu
ta
ta
ta
ta
ta
ta
ta
ta
Rt
mi
mi
"}
(21,1,1) = {"
mi
mi
Rt
ZK
ZK
ZK
ZK
ZK
ZK
ZK
ZK
Qu
Qu
Qu
Qu
Qu
Qu
Qu
ob
Qu
Ev
Ry
Ry
Ry
ca
Qu
Qu
Qu
ob
Qu
Qu
Qu
Qu
Qu
ZK
ZK
ZK
ZK
ZK
ZK
ZK
ZK
Rt
mi
mi
"}
(22,1,1) = {"
mi
mi
Rt
ah
ah
ah
ah
ah
ah
ah
ah
Pf
Pf
Pf
Pf
Pf
Pf
Qu
Ry
Ry
Ry
Ry
Yt
Ry
Ry
Ry
Ry
Qu
Pf
Pf
Pf
Pf
Pf
Pf
ah
ah
ah
ah
ah
ah
ah
ah
Rt
mi
mi
"}
(23,1,1) = {"
mi
mi
Rt
ah
ah
ah
ah
ah
ah
ah
ah
Pf
Pf
Pf
Pf
gR
Pf
Qu
Ry
Ry
Ry
xO
yX
CM
Ry
Ry
Ry
Qu
Pf
gR
Pf
Pf
Pf
Pf
ah
ah
ah
ah
ah
ah
ah
ah
Rt
mi
mi
"}
(24,1,1) = {"
mi
mi
Rt
ah
ah
ah
ah
ah
ah
ah
ah
Pf
Pf
Pf
Pf
Pf
Pf
Qu
Ry
Ry
Ry
Ry
kd
Ry
Ry
Ry
Ry
Qu
Pf
Pf
Pf
Pf
Pf
Pf
ah
ah
ah
ah
ah
ah
ah
ah
Rt
mi
mi
"}
(25,1,1) = {"
mi
mi
Rt
Ne
Ne
Ne
Ne
Ne
Ne
Ne
Ne
Qu
Qu
Qu
Qu
Qu
ob
Qu
Qu
Qu
TA
Ry
Ry
Ry
Dv
Qu
ob
Qu
Qu
Qu
Qu
Qu
Qu
Qu
Ne
Ne
Ne
Ne
Ne
Ne
Ne
Ne
Rt
mi
mi
"}
(26,1,1) = {"
mi
mi
Rt
ta
ta
ta
ta
ta
ta
ta
ta
Qu
Xm
LC
Qu
Ry
Ry
UJ
pq
Qu
Qu
Ry
Ry
Ry
Qu
Qu
Ry
Ry
Ry
yn
Qu
Vn
Xm
Qu
ta
ta
ta
ta
ta
ta
ta
ta
Rt
mi
mi
"}
(27,1,1) = {"
mi
mi
mi
Rt
ta
ta
ta
ta
ta
ta
ta
HD
Ry
Ry
Qu
Ry
Ry
Ry
vu
Ry
ob
Ry
Ry
Ry
Qu
yn
JQ
Ry
Ry
KH
Qu
Ry
Ry
UF
ta
ta
ta
ta
ta
ta
ta
Rt
mi
mi
mi
"}
(28,1,1) = {"
mi
mi
mi
Rt
ta
ta
ta
ta
ta
ta
ta
gA
Ry
Ry
ob
Ry
JQ
Ry
Ej
Ry
Qu
Qu
Qu
Qu
Qu
KH
Ry
Ry
Ry
Ry
ob
Ry
Ry
Ek
ta
ta
ta
ta
ta
ta
ta
Rt
mi
mi
mi
"}
(29,1,1) = {"
mi
mi
mi
Rt
ta
ta
ta
ta
ta
ta
ta
pN
Ry
Ry
Qu
Oi
Ry
iy
Zm
Cv
Qu
Pf
Pf
Pf
ob
Ry
Ry
Ry
Ho
yn
Qu
Ry
Ry
UU
ta
ta
ta
ta
ta
ta
ta
Rt
mi
mi
mi
"}
(30,1,1) = {"
mi
mi
mi
Rt
ta
ta
ta
ta
ta
ta
ta
ta
pN
Ry
Qu
pq
Kh
eb
Ry
Yt
Qu
Pf
gR
Pf
Qu
yn
KH
Ry
yn
UI
Qu
Ry
UU
ta
ta
ta
ta
ta
ta
ta
ta
Rt
mi
mi
mi
"}
(31,1,1) = {"
mi
mi
mi
Rt
ta
ta
ta
ta
ta
ta
ta
ta
ta
pN
Qu
Qu
Qu
ob
Qu
Qu
Qu
Pf
Pf
Pf
Qu
Qu
Qu
ob
Qu
Qu
Qu
UU
ta
ta
ta
ta
ta
ta
ta
ta
ta
Rt
mi
mi
mi
"}
(32,1,1) = {"
mi
mi
mi
mi
Rt
ta
ta
ta
ta
ta
ta
ta
ta
ta
pN
Ry
Ry
Ry
Ry
mL
Qu
Pf
Pf
Pf
Qu
UH
Ry
Ry
Ry
Ry
UU
ta
ta
ta
ta
ta
ta
ta
ta
ta
Rt
mi
mi
mi
mi
"}
(33,1,1) = {"
mi
mi
mi
mi
Rt
ta
ta
ta
ta
ta
ta
ta
ta
ta
ta
pN
Ry
Ry
Ry
Xm
Qu
Pf
Pf
Pf
Qu
Xm
Ry
Ry
Ry
UU
ta
ta
ta
ta
ta
ta
ta
ta
ta
ta
Rt
mi
mi
mi
mi
"}
(34,1,1) = {"
mi
mi
mi
mi
Rt
ta
ta
ta
ta
ta
ta
ta
ta
ta
ta
ta
pN
WS
Po
Qu
Qu
Pf
Pf
Pf
Qu
Qu
Po
WS
UU
ta
ta
ta
ta
ta
ta
ta
ta
ta
ta
ta
Rt
mi
mi
mi
mi
"}
(35,1,1) = {"
mi
mi
mi
mi
mi
Rt
ta
ta
ta
ta
ta
ta
ta
ta
ta
ta
ta
ta
ta
ta
nc
ah
ah
ah
pE
ta
ta
ta
ta
ta
ta
ta
ta
ta
ta
ta
ta
ta
ta
Rt
mi
mi
mi
mi
mi
"}
(36,1,1) = {"
mi
mi
mi
mi
mi
Rt
ta
ta
ta
ta
ta
ta
ta
ta
ta
ta
ta
ta
ta
ta
nc
ah
ah
ah
pE
ta
ta
ta
ta
ta
ta
ta
ta
ta
ta
ta
ta
ta
ta
Rt
mi
mi
mi
mi
mi
"}
(37,1,1) = {"
mi
mi
mi
mi
mi
Rt
ta
ta
ta
ta
ta
ta
ta
ta
ta
ta
ta
ta
ta
ta
nc
ah
ah
ah
pE
ta
ta
ta
ta
ta
ta
ta
ta
ta
ta
ta
ta
ta
ta
Rt
mi
mi
mi
mi
mi
"}
(38,1,1) = {"
mi
mi
mi
mi
mi
Rt
ta
ta
ta
ta
ta
ta
ta
ta
ta
ta
ta
ta
ta
ta
nc
ah
ah
ah
pE
ta
ta
ta
ta
ta
ta
ta
ta
ta
ta
ta
ta
ta
ta
Rt
mi
mi
mi
mi
mi
"}
(39,1,1) = {"
mi
mi
mi
mi
mi
mi
Rt
ta
ta
ta
ta
ta
ta
ta
ta
ta
ta
ta
ta
ta
nc
ah
ah
ah
pE
ta
ta
ta
ta
ta
ta
ta
ta
ta
ta
ta
ta
ta
Rt
mi
mi
mi
mi
mi
mi
"}
(40,1,1) = {"
mi
mi
mi
mi
mi
mi
mi
Rt
Rt
Rt
Rt
ta
ta
ta
ta
ta
ta
ta
ta
ta
nc
ah
ah
ah
pE
ta
ta
ta
ta
ta
ta
ta
ta
ta
Rt
Rt
Rt
Rt
mi
mi
mi
mi
mi
mi
mi
"}
(41,1,1) = {"
mi
mi
mi
mi
mi
mi
mi
mi
mi
mi
mi
Rt
Rt
Rt
ta
ta
ta
ta
ta
ta
nc
ah
ah
ah
pE
ta
ta
ta
ta
ta
ta
Rt
Rt
Rt
mi
mi
mi
mi
mi
mi
mi
mi
mi
mi
mi
"}
(42,1,1) = {"
mi
mi
mi
mi
mi
mi
mi
mi
mi
mi
mi
mi
mi
mi
Rt
Rt
Rt
Rt
Rt
ta
nc
ah
ah
ah
pE
ta
Rt
Rt
Rt
Rt
Rt
mi
mi
mi
mi
mi
mi
mi
mi
mi
mi
mi
mi
mi
mi
"}
(43,1,1) = {"
mi
mi
mi
mi
mi
mi
mi
mi
mi
mi
mi
mi
mi
mi
mi
mi
mi
mi
mi
Rt
Rt
Rt
Rt
Rt
Rt
Rt
mi
mi
mi
mi
mi
mi
mi
mi
mi
mi
mi
mi
mi
mi
mi
mi
mi
mi
mi
"}
(44,1,1) = {"
mi
mi
mi
mi
mi
mi
mi
mi
mi
mi
mi
mi
mi
mi
mi
mi
mi
mi
mi
mi
mi
mi
mi
mi
mi
mi
mi
mi
mi
mi
mi
mi
mi
mi
mi
mi
mi
mi
mi
mi
mi
mi
mi
mi
mi
"}
(45,1,1) = {"
mi
mi
mi
mi
mi
mi
mi
mi
mi
mi
mi
mi
mi
mi
mi
mi
mi
mi
mi
mi
mi
mi
mi
mi
mi
mi
mi
mi
mi
mi
mi
mi
mi
mi
mi
mi
mi
mi
mi
mi
mi
mi
mi
mi
mi
"}
