//MAP CONVERTED BY dmm2tgm.py THIS HEADER COMMENT PREVENTS RECONVERSION, DO NOT REMOVE
"a" = (
/turf/template_noop,
/area/template_noop)
"d" = (
/mob/living/simple_mob/construct/wraith,
/turf/simulated/floor/water,
/area/submap/leechpond)
"n" = (
/turf/template_noop,
/area/submap/leechpond)
"u" = (
/turf/simulated/floor/outdoors/mud,
/area/submap/leechpond)
"y" = (
/turf/simulated/floor/wood/sif,
/area/submap/leechpond)
"C" = (
/turf/simulated/floor/water,
/area/submap/leechpond)
"G" = (
/turf/simulated/wall/log_sif,
/area/submap/leechpond)
"I" = (
/mob/living/simple_mob/construct/artificer/caster,
/turf/simulated/floor/water,
/area/submap/leechpond)
"T" = (
/mob/living/simple_mob/faithless/strong,
/turf/simulated/floor/water,
/area/submap/leechpond)
"U" = (
/obj/effect/landmark/loot_spawn,
/turf/simulated/floor/wood/sif,
/area/submap/leechpond)

(1,1,1) = {"
a
a
a
a
a
a
a
a
a
a
a
a
a
a
a
a
a
a
a
a
a
a
a
"}
(2,1,1) = {"
a
a
a
u
u
u
u
u
u
u
u
u
u
u
u
a
a
a
a
a
a
a
a
"}
(3,1,1) = {"
a
a
u
u
C
C
C
C
C
C
C
C
C
C
u
u
u
u
a
a
a
a
a
"}
(4,1,1) = {"
a
a
u
C
C
C
C
C
C
C
C
C
C
C
C
C
C
u
u
u
a
a
a
"}
(5,1,1) = {"
a
a
u
C
T
C
C
C
C
T
C
C
C
C
I
C
C
C
C
u
u
a
a
"}
(6,1,1) = {"
a
u
u
C
C
C
C
C
C
C
C
C
C
C
C
C
C
C
C
C
u
u
a
"}
(7,1,1) = {"
a
u
C
C
C
C
C
C
C
C
C
C
C
C
C
C
C
C
C
C
C
u
a
"}
(8,1,1) = {"
a
u
C
C
C
C
I
C
C
C
C
C
G
G
C
C
C
C
C
C
C
u
a
"}
(9,1,1) = {"
a
u
u
C
C
C
C
C
G
y
C
C
U
G
C
C
T
C
C
C
C
u
a
"}
(10,1,1) = {"
a
a
u
u
C
C
C
C
G
C
C
C
C
C
C
C
C
C
C
C
C
u
a
"}
(11,1,1) = {"
a
a
a
u
u
C
C
C
C
C
C
y
C
C
C
C
C
C
C
C
u
u
a
"}
(12,1,1) = {"
a
a
a
n
u
C
C
C
C
C
d
y
y
C
C
C
C
C
C
C
u
a
a
"}
(13,1,1) = {"
a
a
u
u
u
C
C
C
G
y
C
C
C
G
C
C
C
C
C
C
u
a
a
"}
(14,1,1) = {"
a
a
u
C
C
T
C
C
G
U
C
C
U
C
C
C
C
I
C
C
u
u
a
"}
(15,1,1) = {"
a
u
u
C
C
C
C
C
G
G
G
C
G
C
C
C
C
C
C
C
C
u
a
"}
(16,1,1) = {"
a
u
C
C
C
C
C
C
C
C
C
C
C
C
C
C
C
C
C
C
u
u
a
"}
(17,1,1) = {"
a
u
C
C
C
C
C
I
C
C
C
C
C
C
C
C
C
C
C
C
u
a
a
"}
(18,1,1) = {"
a
u
C
C
C
C
C
C
C
C
C
C
C
T
C
C
u
u
u
u
u
a
a
"}
(19,1,1) = {"
a
u
C
C
T
C
C
C
C
C
C
C
C
C
C
u
u
a
a
a
a
a
a
"}
(20,1,1) = {"
a
u
u
C
C
C
C
C
u
u
u
u
C
C
C
u
a
a
a
a
a
a
a
"}
(21,1,1) = {"
a
a
u
u
C
C
C
u
u
a
a
u
u
C
C
u
a
a
a
a
a
a
a
"}
(22,1,1) = {"
a
a
a
u
u
u
u
u
a
a
a
a
u
u
u
u
a
a
a
a
a
a
a
"}
(23,1,1) = {"
a
a
a
a
a
a
a
a
a
a
a
a
a
a
a
a
a
a
a
a
a
a
a
"}
