//MAP CONVERTED BY dmm2tgm.py THIS HEADER COMMENT PREVENTS RECONVERSION, DO NOT REMOVE
"a" = (
/turf/template_noop,
/area/template_noop)
"b" = (
/obj/machinery/atmospherics/unary/engine{
	dir = 1
	},
/turf/simulated/floor/tiled/dark,
/area/submap/mouseattack)
"c" = (
/turf/simulated/floor/tiled/yellow,
/area/submap/mouseattack)
"i" = (
/obj/structure/table/rack,
/obj/item/weapon/archaeological_find,
/obj/item/weapon/archaeological_find,
/obj/item/weapon/archaeological_find,
/obj/random/rigsuit/chancetofail,
/obj/item/rig_module/mounted/phase,
/turf/template_noop,
/area/submap/mouseattack)
"j" = (
/turf/simulated/wall/gold,
/area/submap/mouseattack)
"l" = (
/mob/living/simple_mob/mechanical/mecha/mouse_tank/livewire/manned,
/turf/simulated/floor/tiled/dark,
/area/submap/mouseattack)
"m" = (
/mob/living/simple_mob/animal/space/mouse_army/stealth,
/turf/simulated/floor/tiled/yellow,
/area/submap/mouseattack)
"o" = (
/obj/structure/table/rack,
/obj/item/weapon/archaeological_find,
/obj/item/weapon/archaeological_find,
/obj/item/weapon/archaeological_find,
/obj/random/rigsuit/chancetofail,
/obj/item/rig_module/voice,
/turf/template_noop,
/area/submap/mouseattack)
"q" = (
/mob/living/simple_mob/mechanical/mecha/mouse_tank/eraticator/manned,
/turf/simulated/floor/tiled/dark,
/area/submap/mouseattack)
"s" = (
/turf/simulated/floor/tiled/dark,
/area/submap/mouseattack)
"t" = (
/obj/structure/shuttle/engine/heater,
/turf/simulated/wall/gold,
/area/submap/mouseattack)
"u" = (
/mob/living/simple_mob/animal/space/mouse_army/ammo,
/turf/simulated/floor/tiled/yellow,
/area/submap/mouseattack)
"v" = (
/obj/structure/table/rack,
/obj/item/weapon/archaeological_find,
/obj/item/weapon/archaeological_find,
/obj/item/weapon/archaeological_find,
/obj/item/rig_module/chem_dispenser/injector/advanced,
/turf/template_noop,
/area/submap/mouseattack)
"w" = (
/obj/structure/table/rack,
/obj/item/rig_module/device/defib,
/obj/item/weapon/archaeological_find,
/obj/item/weapon/archaeological_find,
/obj/item/weapon/archaeological_find,
/turf/simulated/floor/tiled/yellow,
/area/submap/mouseattack)
"y" = (
/turf/template_noop,
/area/submap/mouseattack)
"z" = (
/obj/machinery/door/blast/shutters,
/turf/simulated/floor/tiled/dark,
/area/submap/mouseattack)
"B" = (
/mob/living/simple_mob/animal/space/mouse_army/operative,
/turf/simulated/floor/tiled/yellow,
/area/submap/mouseattack)
"C" = (
/obj/structure/table/rack,
/obj/item/weapon/archaeological_find,
/obj/item/weapon/archaeological_find,
/obj/item/weapon/archaeological_find,
/obj/random/rigsuit/chancetofail,
/obj/item/rig_module/rad_shield,
/turf/template_noop,
/area/submap/mouseattack)
"D" = (
/mob/living/simple_mob/mechanical/mecha/mouse_tank/eraticator/manned,
/turf/simulated/floor/tiled/yellow,
/area/submap/mouseattack)
"H" = (
/mob/living/simple_mob/animal/space/mouse_army/pyro,
/turf/simulated/floor/tiled/yellow,
/area/submap/mouseattack)
"J" = (
/mob/living/simple_mob/mechanical/mecha/mouse_tank/livewire/manned,
/turf/simulated/floor/tiled/yellow,
/area/submap/mouseattack)
"N" = (
/obj/structure/table/rack,
/obj/random/rigsuit/chancetofail,
/obj/item/rig_module/fabricator,
/obj/item/weapon/archaeological_find,
/obj/item/weapon/archaeological_find,
/obj/item/weapon/archaeological_find,
/turf/simulated/floor/tiled/yellow,
/area/submap/mouseattack)
"S" = (
/obj/machinery/door/airlock/gold,
/turf/simulated/floor/tiled/yellow,
/area/submap/mouseattack)
"W" = (
/mob/living/simple_mob/mechanical/mecha/mouse_tank/manned,
/turf/simulated/floor/tiled/yellow,
/area/submap/mouseattack)
"X" = (
/turf/simulated/wall/r_wall,
/area/submap/mouseattack)
"Y" = (
/mob/living/simple_mob/mechanical/mecha/mouse_tank/manned,
/turf/simulated/floor/tiled/dark,
/area/submap/mouseattack)

(1,1,1) = {"
a
a
a
a
a
a
a
a
a
a
a
a
a
a
a
a
a
a
a
a
"}
(2,1,1) = {"
a
a
X
X
X
X
X
X
X
X
X
X
X
X
X
X
X
X
X
a
"}
(3,1,1) = {"
a
a
z
s
s
s
s
s
s
s
s
s
s
s
s
s
q
s
X
a
"}
(4,1,1) = {"
a
a
z
s
Y
s
s
j
j
S
j
j
S
j
t
b
s
s
X
a
"}
(5,1,1) = {"
a
a
z
s
s
s
s
j
c
c
m
c
c
c
t
b
s
s
X
a
"}
(6,1,1) = {"
a
a
z
s
s
s
s
j
J
c
N
w
c
J
t
b
s
s
X
a
"}
(7,1,1) = {"
a
a
z
s
s
s
s
j
c
c
c
H
c
c
t
b
s
s
X
a
"}
(8,1,1) = {"
a
a
z
s
Y
s
s
j
j
S
j
j
S
j
t
b
s
s
X
a
"}
(9,1,1) = {"
a
a
z
s
s
s
s
s
s
s
s
s
s
s
s
s
q
s
X
a
"}
(10,1,1) = {"
a
a
X
X
X
X
X
X
X
X
X
X
X
X
X
X
X
X
X
a
"}
(11,1,1) = {"
a
a
y
y
y
y
y
y
y
y
y
y
y
y
y
y
y
y
y
a
"}
(12,1,1) = {"
a
a
X
X
X
X
X
X
X
X
X
X
X
X
X
X
X
X
X
a
"}
(13,1,1) = {"
a
a
z
s
s
s
s
s
s
s
s
s
s
s
s
s
Y
s
X
a
"}
(14,1,1) = {"
a
a
z
s
l
s
s
j
j
S
j
j
S
j
t
b
s
s
X
a
"}
(15,1,1) = {"
a
a
z
s
s
s
s
j
c
c
c
u
c
c
t
b
s
s
X
a
"}
(16,1,1) = {"
a
a
z
s
s
s
s
j
D
c
v
o
c
D
t
b
s
s
X
a
"}
(17,1,1) = {"
a
a
z
s
s
s
s
j
c
c
c
u
c
c
t
b
s
s
X
a
"}
(18,1,1) = {"
a
a
z
s
l
s
s
j
j
S
j
j
S
j
t
b
s
s
X
a
"}
(19,1,1) = {"
a
a
z
s
s
s
s
s
s
s
s
s
s
s
s
s
Y
s
X
a
"}
(20,1,1) = {"
a
a
X
X
X
X
X
X
X
X
X
X
X
X
X
X
X
X
X
a
"}
(21,1,1) = {"
a
a
y
y
y
y
y
y
y
y
y
y
y
y
y
y
y
y
y
a
"}
(22,1,1) = {"
a
a
X
X
X
X
X
X
X
X
X
X
X
X
X
X
X
X
X
a
"}
(23,1,1) = {"
a
a
z
s
s
s
s
s
s
s
s
s
s
s
s
s
Y
s
X
a
"}
(24,1,1) = {"
a
a
z
s
q
s
s
j
j
S
j
j
S
j
t
b
s
s
X
a
"}
(25,1,1) = {"
a
a
z
s
s
s
s
j
c
c
c
m
c
c
t
b
s
s
X
a
"}
(26,1,1) = {"
a
a
z
s
s
s
s
j
J
c
i
C
c
W
t
b
s
s
X
a
"}
(27,1,1) = {"
a
a
z
s
s
s
s
j
c
c
B
c
c
c
t
b
s
s
X
a
"}
(28,1,1) = {"
a
a
z
s
l
s
s
j
j
S
j
j
S
j
t
b
s
s
X
a
"}
(29,1,1) = {"
a
a
z
s
s
s
s
s
s
s
s
s
s
s
s
s
q
s
X
a
"}
(30,1,1) = {"
a
a
X
X
X
X
X
X
X
X
X
X
X
X
X
X
X
X
X
a
"}
(31,1,1) = {"
a
a
a
a
a
a
a
a
a
a
a
a
a
a
a
a
a
a
a
a
"}
