//MAP CONVERTED BY dmm2tgm.py THIS HEADER COMMENT PREVENTS RECONVERSION, DO NOT REMOVE
"cD" = (
/obj/structure/table/rack/shelf/steel,
/obj/random/gun/random,
/obj/random/rigsuit,
/obj/random/gun/random,
/obj/machinery/light/poi{
	dir = 1
	},
/turf/simulated/floor/tiled/white,
/area/submap/piratevox)
"cH" = (
/mob/living/simple_mob/humanoid/merc/ranged/ionrifle{
	health = 15;
	maxHealth = 15
	},
/obj/machinery/light/poi{
	dir = 8
	},
/turf/simulated/floor/tiled/white,
/area/submap/piratevox)
"cK" = (
/obj/structure/grille/rustic{
	health = 25;
	name = "reinforced grille"
	},
/obj/structure/grille/rustic{
	health = 25;
	name = "reinforced grille"
	},
/obj/structure/window/plastitanium/full,
/turf/simulated/shuttle/plating,
/area/submap/piratevox)
"dy" = (
/obj/machinery/computer/ship{
	dir = 1
	},
/turf/simulated/floor/tiled/white,
/area/submap/piratevox)
"dz" = (
/obj/structure/cable/green{
	d1 = 2;
	d2 = 8;
	icon_state = "2-8"
	},
/turf/simulated/floor/tiled/white,
/area/submap/piratevox)
"fA" = (
/obj/random/mob/merc/all,
/obj/structure/bed/chair/bay/shuttle,
/turf/simulated/floor/tiled/red,
/area/submap/piratevox)
"fD" = (
/obj/machinery/door/airlock/external,
/turf/simulated/floor/tiled/white,
/area/submap/piratevox)
"fL" = (
/obj/structure/table/standard,
/obj/item/weapon/flame/lighter/zippo/rainbow,
/turf/simulated/floor/tiled/white,
/area/submap/piratevox)
"fV" = (
/obj/structure/table/standard,
/obj/random/maintenance/medical,
/obj/random/maintenance/medical,
/obj/random/gun/random,
/turf/simulated/floor/tiled/white,
/area/submap/piratevox)
"gp" = (
/obj/machinery/door/airlock/phoron,
/obj/structure/cable/green{
	d1 = 1;
	d2 = 2;
	icon_state = "1-2"
	},
/turf/simulated/floor/tiled/white,
/area/submap/piratevox)
"hj" = (
/obj/structure/table/rack/shelf/steel,
/obj/random/gun/random,
/obj/random/rigsuit,
/obj/random/gun/random,
/obj/machinery/light/poi,
/turf/simulated/floor/tiled/white,
/area/submap/piratevox)
"hB" = (
/obj/machinery/light/poi{
	dir = 8
	},
/turf/simulated/floor/tiled/white,
/area/submap/piratevox)
"it" = (
/obj/machinery/power/port_gen/pacman/mrs,
/obj/structure/cable/green{
	d2 = 2;
	icon_state = "0-2"
	},
/turf/simulated/floor/tiled/white,
/area/submap/piratevox)
"iJ" = (
/obj/machinery/power/terminal{
	dir = 1;
	icon_state = "term"
	},
/obj/structure/cable/green{
	d2 = 4;
	icon_state = "0-4"
	},
/turf/simulated/floor/tiled/white,
/area/submap/piratevox)
"iN" = (
/mob/living/simple_mob/humanoid/merc/voxpirate/ranged/captain,
/turf/simulated/floor/tiled/white,
/area/submap/piratevox)
"iU" = (
/obj/structure/cable/green{
	d1 = 1;
	d2 = 8;
	icon_state = "1-8"
	},
/turf/simulated/floor/tiled/white,
/area/submap/piratevox)
"ki" = (
/obj/machinery/light/poi{
	dir = 4
	},
/turf/simulated/floor/tiled/white,
/area/submap/piratevox)
"mE" = (
/obj/structure/table/standard,
/obj/random/maintenance/engineering,
/obj/random/maintenance/security,
/turf/simulated/floor/tiled/white,
/area/submap/piratevox)
"op" = (
/obj/effect/decal/cleanable/blood/splatter,
/turf/simulated/floor/tiled/red,
/area/submap/piratevox)
"pD" = (
/obj/structure/cable/green{
	d1 = 4;
	d2 = 8;
	icon_state = "4-8"
	},
/turf/simulated/floor/tiled/white,
/area/submap/piratevox)
"pJ" = (
/obj/structure/table/standard,
/obj/random/toolbox,
/turf/simulated/floor/tiled/white,
/area/submap/piratevox)
"pK" = (
/obj/structure/table/standard,
/obj/random/gun/random,
/turf/simulated/floor/tiled/white,
/area/submap/piratevox)
"pV" = (
/obj/structure/table/standard,
/obj/item/weapon/card/emag/used,
/turf/simulated/floor/tiled/white,
/area/submap/piratevox)
"rp" = (
/mob/living/simple_mob/humanoid/merc/voxpirate/ranged/suppressor,
/turf/simulated/floor/tiled/white,
/area/submap/piratevox)
"rS" = (
/mob/living/simple_mob/humanoid/merc/voxpirate/pirate,
/obj/effect/decal/cleanable/blood/splatter,
/turf/simulated/floor/tiled/white,
/area/submap/piratevox)
"to" = (
/obj/structure/table/rack/shelf/steel,
/obj/random/gun/random,
/obj/random/rigsuit,
/obj/random/gun/random,
/turf/simulated/floor/tiled/white,
/area/submap/piratevox)
"tX" = (
/obj/structure/table/standard,
/obj/item/weapon/grenade/chem_grenade/cleaner,
/obj/item/weapon/grenade/chem_grenade/cleaner,
/obj/item/rig_module/mounted/mop,
/obj/item/weapon/reagent_containers/glass/bucket,
/obj/machinery/light/poi{
	dir = 4
	},
/turf/simulated/floor/tiled/white,
/area/submap/piratevox)
"uQ" = (
/obj/machinery/porta_turret/stationary/syndie{
	faction = "voxpirate"
	},
/turf/simulated/shuttle/plating,
/area/submap/piratevox)
"vn" = (
/obj/structure/cable/green{
	d1 = 1;
	d2 = 4;
	icon_state = "1-4"
	},
/turf/simulated/floor/tiled/white,
/area/submap/piratevox)
"xe" = (
/obj/structure/bed/chair/office{
	dir = 1
	},
/mob/living/simple_mob/humanoid/merc/voxpirate/boarder,
/turf/simulated/floor/tiled/white,
/area/submap/piratevox)
"xr" = (
/turf/simulated/wall/rplastitanium,
/area/submap/piratevox)
"ye" = (
/turf/template_noop,
/area/submap/piratevox)
"zq" = (
/turf/simulated/wall/thull,
/area/submap/piratevox)
"An" = (
/obj/structure/table/standard,
/obj/random/medical/pillbottle,
/turf/simulated/floor/tiled/white,
/area/submap/piratevox)
"Ap" = (
/mob/living/simple_mob/humanoid/merc/voxpirate/ranged/suppressor,
/obj/structure/cable/green{
	d1 = 1;
	d2 = 2;
	icon_state = "1-2"
	},
/turf/simulated/floor/tiled/white,
/area/submap/piratevox)
"AS" = (
/obj/machinery/door/airlock/phoron,
/turf/simulated/floor/tiled/white,
/area/submap/piratevox)
"AV" = (
/mob/living/simple_mob/humanoid/merc/voxpirate/technician,
/turf/simulated/floor/tiled/white,
/area/submap/piratevox)
"Bl" = (
/obj/structure/shuttle/engine/heater{
	dir = 8
	},
/turf/simulated/wall/fancy_shuttle,
/area/submap/piratevox)
"Cm" = (
/turf/template_noop,
/area/template_noop)
"Dg" = (
/obj/structure/table/standard,
/obj/random/firstaid,
/obj/random/medical/pillbottle,
/turf/simulated/floor/tiled/white,
/area/submap/piratevox)
"Dt" = (
/obj/machinery/power/smes/buildable/point_of_interest,
/turf/simulated/floor/tiled/white,
/area/submap/piratevox)
"DI" = (
/mob/living/simple_mob/humanoid/merc/ranged/deagle,
/obj/structure/bed/chair/office{
	dir = 4
	},
/turf/simulated/floor/tiled/white,
/area/submap/piratevox)
"DX" = (
/turf/simulated/wall/fancy_shuttle,
/area/submap/piratevox)
"FN" = (
/mob/living/simple_mob/humanoid/merc/melee/sword/poi{
	health = 15;
	maxHealth = 15
	},
/obj/machinery/light/poi{
	dir = 4
	},
/turf/simulated/floor/tiled/white,
/area/submap/piratevox)
"Iu" = (
/mob/living/simple_mob/humanoid/merc/voxpirate/pirate,
/obj/machinery/light/poi{
	dir = 8
	},
/turf/simulated/floor/tiled/white,
/area/submap/piratevox)
"LG" = (
/mob/living/simple_mob/humanoid/merc/ranged{
	health = 15;
	maxHealth = 15
	},
/obj/structure/cable/green{
	d1 = 1;
	d2 = 2;
	icon_state = "1-2"
	},
/turf/simulated/floor/tiled/white,
/area/submap/piratevox)
"LP" = (
/obj/effect/decal/cleanable/blood/splatter,
/turf/simulated/floor/tiled/white,
/area/submap/piratevox)
"NE" = (
/obj/structure/cable/green{
	d1 = 1;
	d2 = 2;
	icon_state = "1-2"
	},
/turf/simulated/floor/tiled/white,
/area/submap/piratevox)
"NI" = (
/obj/structure/closet/crate/secure/loot,
/obj/item/stolenpackage,
/obj/item/stolenpackage,
/obj/item/stolenpackage,
/turf/simulated/floor/tiled/white,
/area/submap/piratevox)
"Op" = (
/mob/living/simple_mob/humanoid/merc/ranged{
	health = 15;
	maxHealth = 15
	},
/turf/simulated/floor/tiled/white,
/area/submap/piratevox)
"Os" = (
/turf/simulated/floor/tiled/white,
/area/submap/piratevox)
"OH" = (
/mob/living/simple_mob/humanoid/merc/voxpirate/boarder,
/turf/simulated/floor/tiled/white,
/area/submap/piratevox)
"Rr" = (
/obj/structure/shuttle/engine/propulsion{
	dir = 8
	},
/turf/simulated/wall/fancy_shuttle,
/area/submap/piratevox)
"Tk" = (
/mob/living/simple_mob/humanoid/merc/voxpirate/boarder,
/obj/structure/bed/chair/office,
/turf/simulated/floor/tiled/white,
/area/submap/piratevox)
"Tl" = (
/mob/living/simple_mob/humanoid/merc/voxpirate/pirate,
/turf/simulated/floor/tiled/white,
/area/submap/piratevox)
"Un" = (
/obj/machinery/power/apc{
	dir = 8;
	pixel_x = -24
	},
/obj/structure/cable/green{
	d2 = 4;
	icon_state = "0-4"
	},
/turf/simulated/floor/tiled/white,
/area/submap/piratevox)
"UL" = (
/obj/structure/grille/rustic{
	health = 25;
	name = "reinforced grille"
	},
/obj/structure/window/plastitanium/full,
/turf/simulated/shuttle/plating,
/area/submap/piratevox)
"Vh" = (
/turf/simulated/floor/tiled/red,
/area/submap/piratevox)
"Vs" = (
/mob/living/simple_mob/humanoid/merc/voxpirate/ranged/suppressor,
/turf/template_noop,
/area/template_noop)
"VO" = (
/obj/structure/cable/green{
	d1 = 1;
	d2 = 2;
	icon_state = "1-2"
	},
/obj/structure/cable/green{
	d1 = 2;
	d2 = 8;
	icon_state = "2-8"
	},
/obj/structure/cable/green{
	d1 = 1;
	d2 = 8;
	icon_state = "1-8"
	},
/obj/machinery/light/poi{
	dir = 4
	},
/turf/simulated/floor/tiled/white,
/area/submap/piratevox)
"VU" = (
/obj/structure/bed/chair/bay/shuttle,
/turf/simulated/floor/tiled/red,
/area/submap/piratevox)
"Wj" = (
/obj/structure/table/standard,
/obj/random/maintenance/medical,
/obj/random/maintenance/medical,
/turf/simulated/floor/tiled/white,
/area/submap/piratevox)
"WN" = (
/obj/structure/table/standard,
/obj/item/weapon/reagent_containers/spray/cleaner,
/obj/item/weapon/reagent_containers/spray/cleaner,
/obj/item/rig_module/cleaner_launcher,
/obj/item/weapon/mop/advanced,
/turf/simulated/floor/tiled/white,
/area/submap/piratevox)
"Xl" = (
/obj/effect/decal/cleanable/blood/splatter,
/mob/living/simple_mob/humanoid/merc/voxpirate/boarder,
/turf/simulated/floor/tiled/white,
/area/submap/piratevox)
"YQ" = (
/obj/effect/decal/cleanable/blood/splatter,
/obj/machinery/light/poi{
	dir = 4
	},
/turf/simulated/floor/tiled/white,
/area/submap/piratevox)
"Za" = (
/obj/structure/bed/chair/office,
/mob/living/simple_mob/humanoid/merc/voxpirate/boarder,
/turf/simulated/floor/tiled/white,
/area/submap/piratevox)
"ZP" = (
/mob/living/simple_mob/humanoid/merc/voxpirate/boarder,
/obj/structure/bed/chair/office{
	dir = 1
	},
/turf/simulated/floor/tiled/white,
/area/submap/piratevox)
"ZU" = (
/obj/machinery/computer/ship,
/turf/simulated/floor/tiled/white,
/area/submap/piratevox)

(1,1,1) = {"
Cm
Cm
Cm
Cm
Cm
Cm
Cm
Cm
Cm
Cm
Cm
Cm
Cm
Cm
Cm
Cm
Cm
Cm
Cm
Cm
Cm
Cm
Cm
Cm
Cm
Cm
Cm
Cm
Cm
"}
(2,1,1) = {"
Cm
Cm
Cm
Cm
Rr
Rr
Rr
Rr
Rr
Cm
Cm
Cm
Cm
Cm
Cm
Cm
Cm
Cm
Cm
Cm
Rr
Rr
Rr
Rr
Rr
Cm
Cm
Cm
Cm
"}
(3,1,1) = {"
Cm
Cm
Cm
Cm
Bl
Bl
Bl
Bl
Bl
Cm
Cm
Cm
Cm
Cm
Cm
Cm
Cm
Cm
Cm
Cm
Bl
Bl
Bl
Bl
Bl
Cm
Cm
Cm
Cm
"}
(4,1,1) = {"
Cm
Cm
Cm
Cm
DX
NI
hB
Os
DX
Cm
Cm
DX
DX
DX
DX
DX
DX
DX
Cm
Cm
DX
Os
hB
NI
DX
Cm
Cm
Cm
Cm
"}
(5,1,1) = {"
Cm
Cm
Cm
Cm
DX
mE
Os
Tl
DX
Cm
Cm
DX
LP
hB
DI
hB
Os
DX
Cm
Cm
DX
rS
Os
mE
DX
Cm
Cm
Cm
Cm
"}
(6,1,1) = {"
Cm
Cm
Cm
Cm
DX
mE
xe
Os
DX
DX
DX
DX
rp
An
fL
pK
rp
DX
DX
DX
DX
Os
Za
mE
DX
Cm
Cm
Cm
Cm
"}
(7,1,1) = {"
Cm
Cm
Cm
Cm
DX
mE
LP
Os
DX
Os
WN
DX
AV
Os
Os
Os
AV
DX
Dt
iJ
DX
Os
Os
mE
DX
Cm
Cm
Cm
Cm
"}
(8,1,1) = {"
Cm
Cm
Cm
Cm
DX
cD
Os
Os
AS
Os
tX
DX
OH
Os
iN
Os
Xl
DX
it
VO
gp
vn
LP
hj
DX
Cm
Cm
Cm
Cm
"}
(9,1,1) = {"
Cm
Cm
Cm
Cm
DX
to
AV
Os
DX
DX
DX
DX
DX
DX
AS
DX
DX
DX
DX
DX
DX
pD
AV
to
DX
Cm
Cm
Cm
Cm
"}
(10,1,1) = {"
Cm
Cm
Cm
Cm
DX
Dg
Op
Os
DX
Os
Os
LP
Os
Iu
Os
Iu
Un
Os
LP
Os
DX
pD
Op
Dg
DX
Cm
Cm
Cm
Cm
"}
(11,1,1) = {"
Cm
Cm
Cm
Cm
DX
Dg
ZP
Os
AS
rp
Op
Os
Os
Os
Xl
Os
dz
NE
LG
Ap
gp
iU
Tk
Dg
DX
Cm
Cm
Cm
Cm
"}
(12,1,1) = {"
Cm
Cm
Cm
Cm
DX
Dg
ki
LP
DX
Os
ki
Os
Os
AV
Os
AV
Os
Os
ki
Os
DX
Os
YQ
Dg
DX
Cm
Cm
Cm
Cm
"}
(13,1,1) = {"
Cm
Cm
Cm
Cm
DX
DX
DX
DX
DX
DX
DX
DX
DX
Os
Os
Os
DX
DX
DX
DX
DX
DX
DX
DX
DX
Cm
Cm
Cm
Cm
"}
(14,1,1) = {"
Cm
Cm
Cm
Cm
Cm
Cm
Cm
Cm
Cm
Cm
xr
xr
xr
Os
LP
Os
DX
xr
xr
Cm
Cm
Cm
Cm
Cm
Cm
Cm
Cm
Cm
Cm
"}
(15,1,1) = {"
Cm
Cm
Cm
Cm
Cm
Cm
Cm
Cm
Cm
Cm
xr
VU
VU
VU
Tl
VU
VU
VU
xr
Cm
Cm
Cm
Cm
Cm
Cm
Cm
Cm
Cm
Cm
"}
(16,1,1) = {"
Cm
Cm
Cm
Cm
Cm
Cm
Cm
Cm
Cm
Cm
xr
Vh
op
Vh
Os
Vh
Vh
Vh
xr
Cm
Cm
Cm
Cm
Cm
Cm
Cm
Vs
Cm
Cm
"}
(17,1,1) = {"
Cm
Cm
Cm
Cm
Cm
Cm
Cm
Cm
Cm
Cm
xr
VU
VU
fA
Os
fA
VU
VU
xr
Cm
Cm
Cm
Cm
Cm
Cm
Cm
Cm
Cm
Cm
"}
(18,1,1) = {"
Cm
Cm
Cm
Cm
Cm
Cm
Cm
Cm
Cm
Cm
xr
xr
xr
ki
Os
YQ
DX
xr
xr
Cm
Cm
Cm
Cm
Cm
Cm
Cm
Cm
Cm
Cm
"}
(19,1,1) = {"
Cm
Cm
Cm
Cm
Cm
Cm
Cm
Cm
Cm
ye
ye
UL
DX
DX
AS
DX
DX
UL
ye
ye
Cm
Cm
Cm
Cm
Cm
Cm
Cm
Cm
Cm
"}
(20,1,1) = {"
Cm
Cm
Cm
Cm
Cm
Cm
Cm
Cm
Cm
uQ
UL
UL
Wj
hB
Os
hB
Wj
UL
UL
uQ
Cm
Cm
Cm
Cm
Cm
Cm
Cm
Cm
Cm
"}
(21,1,1) = {"
Cm
Cm
Cm
Cm
Cm
Cm
Cm
Cm
ye
UL
UL
Wj
LP
Os
Tl
Os
Os
Wj
UL
UL
ye
Cm
Cm
Cm
Cm
Cm
Cm
Cm
Cm
"}
(22,1,1) = {"
Cm
Cm
Cm
Cm
Cm
Cm
Cm
Cm
UL
UL
Wj
rp
Os
Os
Os
Os
Os
OH
Wj
cK
UL
Cm
Cm
Cm
Cm
Cm
Cm
Cm
Cm
"}
(23,1,1) = {"
Cm
Cm
Cm
Cm
Cm
Cm
Cm
ye
DX
Wj
Os
Os
Os
Os
FN
Os
Os
Os
LP
Wj
DX
ye
Cm
Cm
Cm
Cm
Cm
Cm
Cm
"}
(24,1,1) = {"
Cm
Cm
Cm
Cm
Cm
Cm
ye
DX
DX
Os
Os
Os
Os
dy
zq
ZU
Os
Os
Os
Os
DX
DX
ye
Cm
Cm
Cm
Cm
Cm
Cm
"}
(25,1,1) = {"
Cm
Cm
Cm
Cm
Cm
Cm
ye
fD
Os
Os
rS
Op
dy
zq
zq
zq
ZU
Op
Tl
Os
Os
fD
ye
Cm
Cm
Cm
Cm
Cm
Cm
"}
(26,1,1) = {"
Cm
Cm
Cm
Cm
Cm
Cm
ye
DX
DX
Os
Os
Os
Os
dy
zq
ZU
Os
Os
LP
Os
DX
DX
ye
Cm
Cm
Cm
Cm
Cm
Cm
"}
(27,1,1) = {"
Cm
Cm
Cm
Cm
Cm
Cm
Cm
ye
DX
Wj
Os
Os
Os
Os
cH
LP
Os
Os
Os
Wj
DX
ye
Cm
Cm
Cm
Cm
Cm
Cm
Cm
"}
(28,1,1) = {"
Cm
Cm
Cm
Cm
Cm
Cm
Cm
Cm
UL
UL
Wj
OH
Os
Os
Os
Os
Os
rp
Wj
UL
UL
Cm
Cm
Cm
Cm
Cm
Cm
Cm
Cm
"}
(29,1,1) = {"
Cm
Cm
Cm
Cm
Cm
Cm
Cm
Cm
Cm
UL
UL
Wj
LP
Os
AV
LP
Os
Wj
UL
UL
Cm
Cm
Cm
Cm
Cm
Cm
Cm
Cm
Cm
"}
(30,1,1) = {"
Cm
Cm
Cm
Cm
Cm
Cm
Cm
Cm
Cm
uQ
UL
UL
fV
pJ
pV
pJ
fV
UL
UL
uQ
Cm
Cm
Cm
Cm
Cm
Cm
Cm
Cm
Cm
"}
(31,1,1) = {"
Cm
Cm
Cm
Cm
Cm
Cm
Cm
Cm
Cm
Cm
ye
UL
DX
DX
DX
DX
DX
UL
ye
Cm
Cm
Cm
Cm
Cm
Cm
Cm
Cm
Cm
Cm
"}
(32,1,1) = {"
Cm
Cm
Cm
Cm
Cm
Cm
Cm
Cm
Cm
Cm
Cm
Cm
Cm
Cm
Cm
Cm
Cm
Cm
Cm
Cm
Cm
Cm
Cm
Cm
Cm
Cm
Cm
Cm
Cm
"}
(33,1,1) = {"
Cm
Cm
Cm
Cm
Cm
Cm
Cm
Cm
Cm
Cm
Cm
Cm
Cm
Cm
Cm
Cm
Cm
Cm
Cm
Cm
Cm
Cm
Cm
Cm
Cm
Cm
Cm
Cm
Cm
"}
