//MAP CONVERTED BY dmm2tgm.py THIS HEADER COMMENT PREVENTS RECONVERSION, DO NOT REMOVE
"aa" = (
/turf/template_noop,
/area/submap/event)
"bm" = (
/obj/random/landmine,
/turf/template_noop,
/area/submap/event)
"bF" = (
/obj/machinery/atmospherics/pipe/tank/oxygen,
/turf/simulated/floor/tiled/yellow,
/area/submap/event)
"bU" = (
/mob/living/simple_mob/humanoid/merc/ranged/space/shotgun/auto,
/obj/structure/bed/chair/office/dark{
	dir = 1
	},
/turf/simulated/floor/tiled/red,
/area/submap/event)
"cH" = (
/obj/machinery/light{
	dir = 4;
	icon_state = "tube1";
	pixel_x = 0
	},
/obj/effect/floor_decal/borderfloor{
	dir = 6
	},
/turf/simulated/floor/tiled/steel,
/area/submap/event)
"dd" = (
/obj/structure/grille,
/obj/structure/window/reinforced,
/obj/structure/window/reinforced{
	dir = 8
	},
/obj/structure/window/reinforced{
	dir = 4
	},
/obj/machinery/door/blast/regular,
/turf/simulated/floor/plating,
/area/submap/event)
"dG" = (
/obj/structure/table/steel,
/obj/item/weapon/paper_bin,
/obj/effect/floor_decal/borderfloor,
/turf/simulated/floor/tiled/steel,
/area/submap/event)
"dL" = (
/obj/structure/bed,
/obj/item/weapon/bedsheet,
/obj/effect/floor_decal/borderfloor,
/turf/simulated/floor/tiled/steel,
/area/submap/event)
"et" = (
/obj/machinery/door/airlock/glass,
/obj/effect/floor_decal/borderfloor,
/turf/simulated/floor/tiled/steel,
/area/submap/event)
"eD" = (
/obj/structure/cliff/automatic,
/turf/template_noop,
/area/submap/event)
"fq" = (
/obj/effect/floor_decal/borderfloor/corner,
/obj/effect/floor_decal/borderfloor,
/turf/simulated/floor/tiled/steel,
/area/submap/event)
"fB" = (
/turf/simulated/floor/tiled/white,
/area/submap/event)
"fV" = (
/turf/simulated/floor/tiled/steel,
/turf/simulated/shuttle/wall/dark{
	icon_state = "dark10";
	name = "Unknown Shuttle"
	},
/area/submap/event)
"gv" = (
/obj/structure/cliff/automatic/corner,
/turf/template_noop,
/area/submap/event)
"hH" = (
/turf/simulated/floor/tiled/red,
/area/submap/event)
"hU" = (
/obj/structure/table/woodentable,
/obj/item/mecha_parts/part/phazon_head,
/turf/simulated/floor/tiled/steel,
/area/submap/event)
"io" = (
/obj/structure/dispenser/oxygen,
/obj/effect/floor_decal/borderfloor{
	dir = 6
	},
/turf/simulated/floor/tiled/steel,
/area/submap/event)
"iw" = (
/obj/structure/table/standard,
/obj/item/weapon/storage/box/masks,
/obj/effect/floor_decal/corner/green/border{
	dir = 6;
	icon_state = "bordercolor"
	},
/obj/random/maintenance/medical,
/turf/simulated/floor/tiled/white,
/area/submap/event)
"ix" = (
/obj/random/mob/merc/all,
/obj/effect/floor_decal/borderfloor/corner{
	dir = 1
	},
/turf/simulated/floor/tiled/steel,
/area/submap/event)
"iF" = (
/obj/effect/floor_decal/borderfloor{
	dir = 4
	},
/turf/simulated/floor/tiled/steel,
/area/submap/event)
"jh" = (
/obj/effect/floor_decal/corner/green/border{
	dir = 8;
	icon_state = "bordercolor"
	},
/turf/simulated/floor/tiled/white,
/area/submap/event)
"jq" = (
/obj/structure/cliff/automatic{
	dir = 5
	},
/turf/template_noop,
/area/submap/event)
"jM" = (
/obj/structure/grille,
/obj/structure/window/reinforced{
	dir = 4
	},
/obj/structure/window/reinforced{
	dir = 8
	},
/obj/machinery/door/blast/regular,
/turf/simulated/floor/plating,
/area/submap/event)
"kj" = (
/obj/structure/bed,
/obj/item/weapon/bedsheet,
/obj/structure/bed,
/obj/effect/floor_decal/borderfloor,
/turf/simulated/floor/tiled/steel,
/area/submap/event)
"km" = (
/obj/structure/cliff/automatic{
	dir = 6
	},
/turf/template_noop,
/area/submap/event)
"kx" = (
/obj/machinery/computer/communications,
/obj/effect/floor_decal/borderfloor{
	dir = 9
	},
/obj/machinery/light{
	dir = 8;
	icon_state = "tube1"
	},
/turf/simulated/floor/tiled/steel,
/area/submap/event)
"kz" = (
/obj/machinery/light,
/obj/structure/table/rack,
/obj/effect/floor_decal/borderfloor{
	dir = 10
	},
/obj/item/clothing/head/helmet/space/void/refurb/mercenary/talon,
/obj/item/clothing/suit/space/void/refurb/officer/talon,
/obj/item/clothing/suit/space/void/refurb/officer/talon,
/obj/item/clothing/suit/space/void/refurb/officer/talon,
/obj/item/clothing/head/helmet/space/void/refurb/mercenary/talon,
/obj/item/clothing/head/helmet/space/void/refurb/mercenary/talon,
/obj/item/clothing/suit/space/void/refurb/pilot/talon,
/obj/item/clothing/head/helmet/space/void/refurb/pilot/alt/talon,
/turf/simulated/floor/tiled/steel,
/area/submap/event)
"lC" = (
/obj/machinery/portable_atmospherics/canister/empty/oxygen,
/turf/simulated/floor/tiled/yellow,
/area/submap/event)
"lG" = (
/obj/effect/floor_decal/borderfloor/corner{
	dir = 1
	},
/turf/simulated/floor/tiled/steel,
/area/submap/event)
"lN" = (
/obj/machinery/light,
/obj/effect/floor_decal/borderfloor,
/turf/simulated/floor/tiled/steel,
/area/submap/event)
"lU" = (
/obj/effect/floor_decal/borderfloor{
	dir = 9
	},
/turf/simulated/floor/tiled/steel,
/area/submap/event)
"mf" = (
/obj/structure/table/steel,
/obj/item/stack/cable_coil/alien/blood,
/obj/random/tool/power,
/obj/random/maintenance/research,
/obj/random/maintenance/engineering,
/obj/random/material/precious,
/turf/simulated/floor/tiled/steel,
/area/submap/event)
"mj" = (
/obj/machinery/atmospherics/pipe/tank/oxygen,
/obj/machinery/light/small{
	dir = 4;
	pixel_y = 0
	},
/turf/simulated/floor/tiled/yellow,
/area/submap/event)
"mp" = (
/obj/structure/table/steel,
/obj/item/mecha_parts/part/phazon_left_arm,
/obj/item/weapon/circuitboard/mecha/phazon/targeting,
/obj/random/tool,
/obj/random/maintenance/research,
/obj/random/maintenance/engineering,
/obj/random/material,
/obj/item/mecha_parts/mecha_equipment/generator/nuclear,
/turf/simulated/floor/tiled/steel,
/area/submap/event)
"mR" = (
/obj/effect/floor_decal/borderfloor/corner{
	dir = 8
	},
/turf/simulated/floor/tiled/steel,
/area/submap/event)
"nk" = (
/obj/machinery/light{
	dir = 4;
	icon_state = "tube1";
	pixel_x = 0
	},
/obj/effect/floor_decal/borderfloor{
	dir = 4
	},
/turf/simulated/floor/tiled/steel,
/area/submap/event)
"nE" = (
/obj/effect/floor_decal/borderfloor{
	dir = 8
	},
/turf/simulated/floor/tiled/steel,
/area/submap/event)
"nF" = (
/obj/structure/table/steel,
/obj/item/mecha_parts/part/phazon_left_leg,
/obj/item/weapon/circuitboard/mecha/phazon/peripherals,
/obj/random/tool,
/obj/random/maintenance/research,
/obj/random/maintenance/engineering,
/obj/random/material,
/obj/item/mecha_parts/mecha_equipment/weapon/energy/flamer/rigged,
/turf/simulated/floor/tiled/steel,
/area/submap/event)
"nG" = (
/mob/living/simple_mob/humanoid/merc/ranged/space/suppressor,
/turf/simulated/floor/tiled/white,
/area/submap/event)
"nU" = (
/obj/structure/table/standard,
/obj/item/weapon/reagent_containers/spray/sterilizine,
/obj/item/weapon/reagent_containers/spray/sterilizine,
/obj/effect/floor_decal/corner/green/border,
/obj/random/firstaid,
/turf/simulated/floor/tiled/white,
/area/submap/event)
"oA" = (
/obj/structure/toilet{
	dir = 1
	},
/turf/simulated/floor/tiled/hydro,
/area/submap/event)
"oC" = (
/obj/structure/closet/secure_closet/freezer/fridge,
/obj/effect/floor_decal/borderfloor{
	dir = 6
	},
/turf/simulated/floor/tiled/steel,
/area/submap/event)
"oU" = (
/obj/machinery/light{
	dir = 1
	},
/obj/effect/floor_decal/borderfloor{
	dir = 1
	},
/turf/simulated/floor/tiled/steel,
/area/submap/event)
"pi" = (
/mob/living/simple_mob/mechanical/viscerator/mercenary,
/mob/living/simple_mob/mechanical/viscerator/mercenary,
/mob/living/simple_mob/mechanical/viscerator/mercenary,
/turf/simulated/floor/tiled/yellow,
/area/submap/event)
"qr" = (
/obj/structure/table/steel,
/obj/random/firstaid,
/turf/simulated/floor/tiled/steel,
/area/submap/event)
"qT" = (
/obj/structure/table/steel,
/obj/random/projectile/scrapped_gun,
/turf/simulated/floor/tiled/steel,
/area/submap/event)
"rl" = (
/obj/structure/cliff/automatic{
	dir = 2
	},
/turf/template_noop,
/area/submap/event)
"ss" = (
/turf/simulated/shuttle/wall/dark{
	icon_state = "dark0";
	name = "Unknown Shuttle"
	},
/area/submap/event)
"sS" = (
/obj/structure/closet/secure_closet/freezer/fridge,
/obj/item/mecha_parts/part/phazon_right_arm,
/obj/effect/floor_decal/borderfloor{
	dir = 5
	},
/turf/simulated/floor/tiled/steel,
/area/submap/event)
"tn" = (
/obj/machinery/light/small{
	dir = 4;
	pixel_y = 0
	},
/obj/structure/closet/crate,
/obj/random/rigsuit,
/obj/random/grenade/box,
/obj/random/grenade/box,
/obj/item/stolenpackage,
/obj/item/stolenpackage,
/turf/simulated/floor/tiled/yellow,
/area/submap/event)
"tv" = (
/obj/random/mob/merc/all,
/obj/effect/floor_decal/borderfloor/corner{
	dir = 8
	},
/turf/simulated/floor/tiled/steel,
/area/submap/event)
"tB" = (
/obj/item/weapon/stool,
/mob/living/simple_mob/humanoid/merc/ranged/sniper,
/turf/simulated/floor/tiled/steel,
/area/submap/event)
"tU" = (
/obj/structure/table/steel,
/obj/item/pizzabox,
/turf/simulated/floor/tiled/steel,
/area/submap/event)
"ui" = (
/obj/structure/cliff/automatic{
	dir = 4
	},
/turf/template_noop,
/area/submap/event)
"uT" = (
/obj/item/weapon/stool,
/obj/random/mob/merc/all,
/turf/simulated/floor/tiled/steel,
/area/submap/event)
"uY" = (
/obj/structure/cliff/automatic{
	dir = 10
	},
/turf/template_noop,
/area/submap/event)
"vX" = (
/mob/living/simple_mob/humanoid/merc/ranged/deagle,
/obj/structure/bed/chair/office/dark{
	dir = 1
	},
/turf/simulated/floor/tiled/red,
/area/submap/event)
"wl" = (
/obj/structure/table/steel,
/obj/effect/floor_decal/borderfloor/full,
/obj/item/clothing/suit/space/void/chrono,
/obj/item/clothing/head/helmet/space/void/chrono,
/obj/item/weapon/gun/projectile/revolver/cappeacekeeper,
/turf/simulated/floor/tiled/steel,
/area/submap/event)
"wo" = (
/obj/machinery/fusion_fuel_injector/mapped{
	dir = 4;
	icon_state = "injector0"
	},
/turf/simulated/floor/tiled/yellow,
/area/submap/event)
"wp" = (
/obj/structure/bed,
/obj/item/weapon/bedsheet,
/obj/effect/floor_decal/borderfloor{
	dir = 6
	},
/turf/simulated/floor/tiled/steel,
/area/submap/event)
"wz" = (
/obj/structure/table/rack,
/obj/effect/floor_decal/borderfloor{
	dir = 10
	},
/obj/item/clothing/head/helmet/space/void/refurb/mercenary/talon,
/obj/item/clothing/suit/space/void/refurb/officer/talon,
/obj/item/clothing/suit/space/void/refurb/officer/talon,
/obj/item/clothing/suit/space/void/refurb/officer/talon,
/obj/item/clothing/head/helmet/space/void/refurb/mercenary/talon,
/obj/item/clothing/head/helmet/space/void/refurb/mercenary/talon,
/obj/item/clothing/suit/space/void/refurb/pilot/talon,
/obj/item/clothing/head/helmet/space/void/refurb/pilot/alt/talon,
/obj/machinery/light{
	dir = 1
	},
/turf/simulated/floor/tiled/steel,
/area/submap/event)
"wN" = (
/obj/structure/table/steel,
/obj/item/weapon/paper{
	info = "We need to take a short stop. The engine's are in need of minor repairs due to turbulence, should be a week's time. We've got reserve food supplies but pleanty of locale fauna to subsist on too if need be. PCRC is keeping most of there assets near New Reykjavik and locale authorities are more mindful then most to travel in this kind of weather. Our outfit should be at the rendezvous point in less then ten days assuming the upper ecehelon hasn't dropped ties with us yet.";
	name = "Operation Progress/M-53"
	},
/obj/effect/floor_decal/borderfloor{
	dir = 10
	},
/turf/simulated/floor/tiled/steel,
/area/submap/event)
"wP" = (
/obj/machinery/light{
	dir = 4;
	icon_state = "tube1";
	pixel_x = 0
	},
/obj/effect/floor_decal/borderfloor{
	dir = 5
	},
/turf/simulated/floor/tiled/steel,
/area/submap/event)
"wV" = (
/obj/machinery/door/airlock/security{
	locked = 1
	},
/turf/simulated/floor/tiled/steel,
/area/submap/event)
"xl" = (
/obj/structure/table/steel,
/obj/item/mecha_parts/mecha_equipment/weapon/honker,
/turf/simulated/floor/tiled/red,
/area/submap/event)
"xZ" = (
/obj/random/mob/merc/all,
/obj/effect/floor_decal/borderfloor,
/turf/simulated/floor/tiled/steel,
/area/submap/event)
"yf" = (
/obj/item/weapon/stool,
/mob/living/simple_mob/humanoid/merc/ranged/deagle,
/turf/simulated/floor/tiled/steel,
/area/submap/event)
"yq" = (
/obj/structure/table/steel,
/obj/random/maintenance/foodstuff,
/obj/random/maintenance/foodstuff,
/obj/random/maintenance/foodstuff,
/obj/random/maintenance/foodstuff,
/obj/random/maintenance/foodstuff,
/obj/effect/floor_decal/borderfloor{
	dir = 9
	},
/turf/simulated/floor/tiled/steel,
/area/submap/event)
"yv" = (
/turf/template_noop,
/turf/simulated/shuttle/wall/dark{
	icon_state = "dark9";
	name = "Unknown Shuttle"
	},
/area/submap/event)
"za" = (
/turf/template_noop,
/turf/simulated/shuttle/wall/dark{
	icon_state = "dark6";
	name = "Unknown Shuttle"
	},
/area/submap/event)
"zc" = (
/obj/machinery/door/airlock/glass,
/turf/simulated/floor/tiled/steel,
/area/submap/event)
"zn" = (
/obj/machinery/light,
/obj/structure/table/steel,
/obj/random/tool,
/obj/random/maintenance/research,
/obj/random/maintenance/engineering,
/obj/random/material/refined,
/obj/item/weapon/cell/device/weapon/recharge/alien/omni,
/turf/simulated/floor/tiled/steel,
/area/submap/event)
"zv" = (
/obj/structure/cliff/automatic/corner{
	dir = 6
	},
/turf/template_noop,
/area/submap/event)
"zz" = (
/obj/effect/floor_decal/borderfloor{
	dir = 5
	},
/turf/simulated/floor/tiled/steel,
/area/submap/event)
"zL" = (
/obj/machinery/door/airlock/external{
	density = 1;
	frequency = 1331;
	id_tag = "merc_shuttle_outer";
	name = "Ship External Access";
	req_access = list(150)
	},
/turf/simulated/floor/tiled/steel,
/area/submap/event)
"zU" = (
/obj/machinery/light/small{
	dir = 4;
	pixel_y = 0
	},
/turf/simulated/floor/tiled/hydro,
/area/submap/event)
"AD" = (
/obj/machinery/computer/area_atmos,
/obj/effect/floor_decal/borderfloor{
	dir = 10
	},
/obj/machinery/light{
	dir = 8;
	icon_state = "tube1"
	},
/turf/simulated/floor/tiled/steel,
/area/submap/event)
"Bx" = (
/obj/structure/table/steel,
/obj/effect/floor_decal/borderfloor{
	dir = 8
	},
/obj/item/clothing/head/helmet/space/void/chrono,
/turf/simulated/floor/tiled/steel,
/area/submap/event)
"BA" = (
/obj/structure/table/steel,
/obj/effect/floor_decal/borderfloor{
	dir = 8
	},
/turf/simulated/floor/tiled/steel,
/area/submap/event)
"Ci" = (
/obj/structure/table/standard,
/obj/item/weapon/tank/anesthetic,
/obj/effect/floor_decal/corner/green/border,
/obj/random/maintenance/medical,
/turf/simulated/floor/tiled/white,
/area/submap/event)
"Cu" = (
/turf/simulated/floor/tiled/steel,
/turf/simulated/shuttle/wall/dark{
	icon_state = "dark9";
	name = "Unknown Shuttle"
	},
/area/submap/event)
"Cv" = (
/turf/template_noop,
/turf/simulated/shuttle/wall/dark{
	icon_state = "dark10";
	name = "Unknown Shuttle"
	},
/area/submap/event)
"Cz" = (
/obj/machinery/organ_printer/flesh,
/obj/effect/floor_decal/corner/green/border{
	dir = 5;
	icon_state = "bordercolor"
	},
/turf/simulated/floor/tiled/white,
/area/submap/event)
"CG" = (
/obj/machinery/shower,
/obj/structure/curtain/open/shower,
/turf/simulated/floor/tiled/hydro,
/area/submap/event)
"Do" = (
/obj/effect/floor_decal/borderfloor/corner{
	dir = 4
	},
/turf/simulated/floor/tiled/steel,
/area/submap/event)
"Eg" = (
/obj/item/weapon/stool,
/turf/simulated/floor/tiled/red,
/area/submap/event)
"EC" = (
/obj/effect/floor_decal/borderfloor{
	dir = 6
	},
/turf/simulated/floor/tiled/steel,
/area/submap/event)
"EM" = (
/obj/machinery/body_scanconsole,
/obj/effect/floor_decal/corner/green/border{
	dir = 1;
	icon_state = "bordercolor"
	},
/turf/simulated/floor/tiled/white,
/area/submap/event)
"Fb" = (
/mob/living/simple_mob/mechanical/viscerator/mercenary,
/mob/living/simple_mob/mechanical/viscerator/mercenary,
/mob/living/simple_mob/mechanical/viscerator/mercenary,
/mob/living/simple_mob/mechanical/viscerator/mercenary,
/turf/simulated/floor/tiled/steel,
/area/submap/event)
"Gd" = (
/obj/effect/floor_decal/corner/grey,
/obj/structure/table/woodentable,
/turf/simulated/floor/tiled/steel,
/area/submap/event)
"Gj" = (
/obj/machinery/door/airlock/glass,
/turf/simulated/floor/tiled/white,
/area/submap/event)
"GT" = (
/mob/living/simple_mob/mechanical/viscerator/mercenary,
/mob/living/simple_mob/mechanical/viscerator/mercenary,
/mob/living/simple_mob/mechanical/viscerator/mercenary,
/turf/simulated/floor/tiled/steel,
/area/submap/event)
"GZ" = (
/obj/structure/dispenser/oxygen,
/obj/effect/floor_decal/borderfloor{
	dir = 5
	},
/turf/simulated/floor/tiled/steel,
/area/submap/event)
"Hh" = (
/obj/item/mecha_parts/part/phazon_torso,
/obj/item/mecha_parts/chassis/phazon,
/turf/simulated/floor/tiled/steel,
/area/submap/event)
"Ii" = (
/obj/random/mob/merc/all,
/obj/effect/floor_decal/borderfloor{
	dir = 1
	},
/turf/simulated/floor/tiled/steel,
/area/submap/event)
"It" = (
/obj/machinery/door/airlock/external,
/turf/simulated/floor/tiled/steel,
/area/submap/event)
"IY" = (
/turf/simulated/floor/tiled/steel,
/area/submap/event)
"JH" = (
/obj/machinery/light{
	dir = 1
	},
/obj/effect/floor_decal/corner/green/border{
	dir = 1;
	icon_state = "bordercolor"
	},
/turf/simulated/floor/tiled/white,
/area/submap/event)
"JN" = (
/obj/machinery/optable,
/obj/effect/floor_decal/corner/green/border{
	dir = 9;
	icon_state = "bordercolor"
	},
/turf/simulated/floor/tiled/white,
/area/submap/event)
"KF" = (
/obj/structure/shuttle/engine/propulsion{
	dir = 4;
	icon_state = "propulsion_l"
	},
/turf/template_noop,
/area/submap/event)
"KT" = (
/obj/structure/shuttle/engine/heater{
	dir = 4;
	icon_state = "heater"
	},
/turf/simulated/shuttle/wall/dark{
	icon_state = "dark0";
	name = "Unknown Shuttle"
	},
/area/submap/event)
"KX" = (
/turf/template_noop,
/turf/simulated/shuttle/wall/dark{
	icon_state = "dark5";
	name = "Unknown Shuttle"
	},
/area/submap/event)
"LL" = (
/obj/structure/cliff/automatic/corner{
	dir = 9
	},
/turf/template_noop,
/area/submap/event)
"LP" = (
/obj/machinery/light{
	dir = 8;
	icon_state = "tube1"
	},
/obj/effect/floor_decal/borderfloor{
	dir = 8
	},
/turf/simulated/floor/tiled/steel,
/area/submap/event)
"Mn" = (
/mob/living/simple_mob/mechanical/mecha/combat/phazon,
/turf/simulated/floor/tiled/steel,
/area/submap/event)
"MX" = (
/obj/structure/bed,
/obj/item/weapon/bedsheet,
/obj/effect/floor_decal/borderfloor{
	dir = 1
	},
/turf/simulated/floor/tiled/steel,
/area/submap/event)
"Ni" = (
/turf/simulated/floor/tiled/steel,
/turf/simulated/shuttle/wall/dark{
	icon_state = "dark6";
	name = "Unknown Shuttle"
	},
/area/submap/event)
"Ok" = (
/obj/structure/table/steel,
/obj/item/stack/cable_coil/alien/blood,
/obj/item/weapon/circuitboard/mecha/phazon/main,
/obj/random/tool/power,
/obj/random/maintenance/research,
/obj/random/maintenance/engineering,
/obj/random/material/precious,
/obj/item/mecha_parts/mecha_equipment/weapon/energy/taser/rigged,
/turf/simulated/floor/tiled/steel,
/area/submap/event)
"Ow" = (
/obj/item/weapon/stool,
/mob/living/simple_mob/humanoid/merc/ranged/ionrifle,
/turf/simulated/floor/tiled/red,
/area/submap/event)
"Oz" = (
/obj/structure/cliff/automatic{
	dir = 9
	},
/turf/template_noop,
/area/submap/event)
"OO" = (
/obj/effect/floor_decal/borderfloor{
	dir = 1
	},
/turf/simulated/floor/tiled/steel,
/area/submap/event)
"Py" = (
/obj/random/mob/merc/armored,
/turf/simulated/floor/tiled/steel_grid,
/area/submap/event)
"PX" = (
/obj/effect/floor_decal/borderfloor/corner,
/turf/simulated/floor/tiled/steel,
/area/submap/event)
"Qu" = (
/obj/structure/table/steel,
/obj/effect/floor_decal/borderfloor/full,
/obj/item/clothing/head/helmet/space/void/refurb/marine/talon,
/obj/item/clothing/suit/space/void/refurb/marine/talon,
/obj/item/weapon/gun/energy/x01,
/turf/simulated/floor/tiled/steel,
/area/submap/event)
"Qw" = (
/obj/structure/table/steel,
/turf/simulated/floor/tiled/red,
/area/submap/event)
"QV" = (
/obj/machinery/bodyscanner{
	dir = 8
	},
/obj/effect/floor_decal/corner/green/border{
	dir = 1;
	icon_state = "bordercolor"
	},
/turf/simulated/floor/tiled/white,
/area/submap/event)
"Ru" = (
/turf/simulated/floor/tiled/steel_grid,
/area/submap/event)
"RH" = (
/obj/structure/grille,
/obj/structure/window/reinforced{
	dir = 1
	},
/obj/structure/window/reinforced{
	dir = 8
	},
/obj/structure/window/reinforced{
	dir = 4
	},
/obj/machinery/door/blast/regular,
/turf/simulated/floor/plating,
/area/submap/event)
"RM" = (
/obj/structure/table/standard,
/obj/item/clothing/gloves/sterile,
/obj/item/clothing/gloves/sterile,
/obj/effect/floor_decal/corner/green/border,
/obj/random/maintenance/medical,
/turf/simulated/floor/tiled/white,
/area/submap/event)
"SD" = (
/obj/structure/closet/toolcloset,
/turf/simulated/floor/tiled/steel,
/area/submap/event)
"SF" = (
/obj/machinery/power/apc{
	dir = 8;
	name = "BSD APC";
	pixel_x = -24
	},
/mob/living/simple_mob/mechanical/viscerator/mercenary,
/mob/living/simple_mob/mechanical/viscerator/mercenary,
/mob/living/simple_mob/mechanical/viscerator/mercenary,
/turf/simulated/floor/tiled/yellow,
/area/submap/event)
"SH" = (
/turf/simulated/floor/tiled/steel,
/turf/simulated/shuttle/wall/dark{
	icon_state = "dark5";
	name = "Unknown Shuttle"
	},
/area/submap/event)
"To" = (
/obj/effect/floor_decal/borderfloor{
	dir = 10
	},
/turf/simulated/floor/tiled/steel,
/area/submap/event)
"Uh" = (
/obj/effect/floor_decal/borderfloor{
	dir = 6
	},
/obj/machinery/door/airlock/security{
	locked = 1
	},
/turf/simulated/floor/tiled/steel,
/area/submap/event)
"Uy" = (
/obj/structure/cliff/automatic/corner{
	dir = 10
	},
/turf/template_noop,
/area/submap/event)
"Vk" = (
/obj/structure/bed,
/obj/item/weapon/bedsheet,
/obj/structure/bed,
/obj/effect/floor_decal/borderfloor{
	dir = 1
	},
/turf/simulated/floor/tiled/steel,
/area/submap/event)
"VA" = (
/obj/machinery/door/airlock/glass,
/obj/effect/floor_decal/borderfloor{
	dir = 1
	},
/turf/simulated/floor/tiled/steel,
/area/submap/event)
"VF" = (
/obj/effect/floor_decal/borderfloor,
/turf/simulated/floor/tiled/steel,
/area/submap/event)
"WT" = (
/obj/machinery/fusion_fuel_compressor,
/turf/simulated/floor/tiled/yellow,
/area/submap/event)
"WZ" = (
/obj/machinery/door/airlock,
/turf/simulated/floor/tiled/hydro,
/area/submap/event)
"Xb" = (
/obj/structure/toilet{
	dir = 1
	},
/obj/item/mecha_parts/part/phazon_right_leg,
/turf/simulated/floor/tiled/hydro,
/area/submap/event)
"XF" = (
/obj/random/mob/merc/all,
/turf/simulated/floor/tiled/steel,
/area/submap/event)
"Ye" = (
/obj/effect/floor_decal/borderfloor{
	dir = 5
	},
/obj/machinery/door/airlock/security{
	locked = 1
	},
/turf/simulated/floor/tiled/steel,
/area/submap/event)
"Yo" = (
/obj/structure/closet/secure_closet/guncabinet,
/obj/random/projectile,
/obj/random/projectile,
/obj/random/gun/random,
/obj/random/energy/highend,
/obj/random/energy/highend,
/turf/simulated/floor/tiled/yellow,
/area/submap/event)
"Yv" = (
/obj/effect/landmark/loot_spawn,
/turf/simulated/floor/tiled/yellow,
/area/submap/event)
"YR" = (
/obj/structure/table/steel,
/obj/effect/floor_decal/borderfloor{
	dir = 8
	},
/obj/item/device/perfect_tele,
/turf/simulated/floor/tiled/steel,
/area/submap/event)
"YZ" = (
/obj/structure/table/steel,
/obj/item/weapon/material/knife,
/obj/effect/floor_decal/borderfloor{
	dir = 1
	},
/turf/simulated/floor/tiled/steel,
/area/submap/event)
"ZC" = (
/obj/structure/table/standard,
/obj/item/weapon/storage/firstaid/surgery,
/obj/effect/floor_decal/corner/green/border{
	dir = 10;
	icon_state = "bordercolor"
	},
/obj/random/maintenance/medical,
/turf/simulated/floor/tiled/white,
/area/submap/event)
"ZN" = (
/obj/structure/bed,
/obj/item/weapon/bedsheet,
/obj/effect/floor_decal/borderfloor{
	dir = 5
	},
/turf/simulated/floor/tiled/steel,
/area/submap/event)

(1,1,1) = {"
aa
aa
aa
aa
aa
aa
aa
aa
aa
aa
aa
aa
aa
aa
aa
aa
aa
aa
aa
aa
aa
aa
aa
aa
aa
aa
aa
aa
aa
aa
aa
aa
aa
aa
aa
"}
(2,1,1) = {"
aa
aa
aa
aa
aa
aa
aa
aa
zv
ui
ui
ui
ui
gv
aa
aa
aa
aa
aa
zv
ui
ui
ui
ui
ui
gv
aa
aa
aa
aa
aa
aa
aa
aa
aa
"}
(3,1,1) = {"
aa
aa
aa
zv
ui
ui
ui
ui
km
aa
aa
aa
aa
eD
zv
ui
ui
ui
ui
km
aa
aa
aa
aa
aa
jq
ui
ui
ui
ui
gv
aa
aa
aa
aa
"}
(4,1,1) = {"
aa
aa
aa
rl
aa
aa
aa
aa
aa
aa
aa
aa
aa
jq
km
aa
aa
aa
aa
aa
aa
aa
aa
bm
aa
aa
aa
aa
aa
aa
eD
aa
aa
aa
aa
"}
(5,1,1) = {"
aa
aa
aa
rl
aa
aa
aa
aa
bm
aa
aa
aa
aa
aa
aa
aa
bm
aa
aa
aa
aa
aa
aa
aa
aa
aa
aa
aa
aa
aa
eD
aa
aa
aa
aa
"}
(6,1,1) = {"
aa
aa
aa
rl
aa
aa
aa
aa
aa
aa
aa
bm
aa
aa
aa
aa
aa
aa
aa
aa
bm
aa
aa
aa
aa
aa
aa
aa
aa
aa
eD
aa
aa
aa
aa
"}
(7,1,1) = {"
aa
aa
aa
rl
aa
aa
aa
aa
aa
aa
aa
aa
aa
Ni
ss
RH
jM
jM
dd
ss
SH
aa
aa
aa
aa
bm
aa
aa
bm
aa
eD
aa
aa
aa
aa
"}
(8,1,1) = {"
aa
aa
zv
km
aa
aa
bm
aa
aa
aa
aa
aa
Ni
ss
kx
BA
YR
BA
Bx
AD
ss
SH
aa
aa
aa
aa
aa
aa
aa
aa
eD
aa
aa
aa
aa
"}
(9,1,1) = {"
aa
aa
rl
aa
aa
aa
aa
za
ss
ss
SH
Ni
ss
ss
lG
vX
hH
hH
bU
mR
ss
ss
SH
Ni
ss
ss
KX
aa
aa
aa
jq
gv
aa
aa
aa
"}
(10,1,1) = {"
aa
aa
rl
aa
aa
aa
aa
ss
ss
ss
ss
ss
wl
Ye
iF
iF
Do
PX
iF
iF
Uh
Qu
ss
ss
ss
ss
ss
aa
aa
aa
aa
eD
aa
aa
aa
"}
(11,1,1) = {"
aa
aa
rl
aa
aa
aa
aa
ss
ss
ss
ss
ss
ss
ss
ss
ss
VA
et
ss
ss
ss
ss
ss
ss
ss
ss
ss
aa
aa
aa
aa
eD
aa
aa
aa
"}
(12,1,1) = {"
aa
aa
rl
aa
bm
aa
aa
ss
ss
ss
lU
nE
To
wV
lU
LP
lG
mR
LP
To
wV
lU
nE
To
ss
ss
ss
aa
bm
aa
aa
eD
aa
aa
aa
"}
(13,1,1) = {"
aa
aa
rl
aa
aa
aa
aa
Cv
ss
ss
OO
Py
VF
ss
MX
hH
Ow
Eg
hH
dL
ss
OO
Py
VF
ss
ss
yv
aa
aa
aa
aa
jq
ui
gv
aa
"}
(14,1,1) = {"
aa
zv
km
aa
aa
aa
aa
aa
ss
ss
OO
Ru
VF
ss
MX
IY
Gd
hU
IY
dL
ss
OO
Ru
VF
ss
ss
aa
aa
aa
aa
aa
aa
aa
eD
aa
"}
(15,1,1) = {"
aa
rl
aa
aa
aa
aa
bm
aa
ss
wz
ix
Ru
xZ
ss
Vk
hH
Eg
Ow
hH
kj
ss
Ii
Ru
tv
kz
ss
aa
bm
aa
aa
aa
bm
aa
eD
aa
"}
(16,1,1) = {"
aa
rl
bm
aa
aa
aa
aa
aa
ss
GZ
iF
Do
fq
ss
ZN
nk
Do
PX
nk
wp
ss
OO
PX
iF
io
ss
aa
aa
aa
aa
aa
aa
aa
eD
aa
"}
(17,1,1) = {"
aa
rl
aa
aa
aa
aa
aa
aa
ss
ss
ss
OO
VF
ss
ss
ss
wV
wV
ss
ss
ss
OO
VF
ss
ss
ss
aa
aa
aa
aa
aa
aa
aa
eD
aa
"}
(18,1,1) = {"
aa
rl
aa
aa
aa
bm
aa
aa
aa
zL
It
OO
VF
ss
yq
nE
lG
mR
nE
wN
ss
OO
VF
It
zL
aa
aa
aa
aa
aa
aa
aa
aa
eD
aa
"}
(19,1,1) = {"
aa
rl
aa
aa
aa
aa
aa
aa
aa
zL
It
zz
cH
ss
YZ
hH
hH
hH
hH
dG
ss
wP
EC
It
zL
aa
aa
aa
aa
bm
aa
aa
aa
eD
aa
"}
(20,1,1) = {"
aa
rl
aa
aa
aa
aa
aa
bm
ss
ss
ss
ss
ss
ss
OO
uT
tU
qr
yf
VF
ss
ss
ss
ss
ss
ss
aa
aa
aa
aa
aa
aa
aa
eD
aa
"}
(21,1,1) = {"
aa
rl
aa
bm
aa
aa
aa
aa
ss
JN
jh
jh
ZC
ss
oU
Eg
xl
Qw
Eg
lN
ss
SD
IY
IY
nF
ss
aa
aa
aa
aa
aa
aa
Oz
LL
aa
"}
(22,1,1) = {"
aa
Uy
uY
aa
aa
aa
aa
aa
ss
QV
fB
fB
Ci
ss
OO
tB
qT
tU
uT
VF
ss
XF
Hh
IY
mf
ss
aa
bm
aa
aa
aa
aa
eD
aa
aa
"}
(23,1,1) = {"
aa
aa
rl
aa
aa
aa
bm
aa
ss
EM
nG
fB
fB
Gj
OO
hH
hH
hH
hH
VF
zc
IY
IY
IY
zn
ss
aa
aa
aa
aa
aa
aa
eD
aa
aa
"}
(24,1,1) = {"
aa
aa
rl
aa
aa
aa
aa
aa
ss
JH
fB
fB
RM
ss
sS
iF
Do
PX
iF
oC
ss
IY
Mn
IY
Ok
ss
aa
aa
aa
aa
bm
aa
eD
aa
aa
"}
(25,1,1) = {"
aa
aa
rl
aa
aa
aa
aa
aa
ss
Cz
fB
nU
iw
ss
ss
ss
wV
wV
ss
ss
ss
SD
IY
IY
mp
ss
KX
aa
aa
aa
aa
aa
eD
aa
aa
"}
(26,1,1) = {"
aa
aa
rl
aa
aa
aa
bm
za
ss
ss
WZ
ss
ss
ss
Yv
pi
Fb
GT
SF
bF
ss
ss
WZ
ss
ss
ss
ss
aa
bm
aa
aa
Oz
LL
aa
aa
"}
(27,1,1) = {"
aa
aa
rl
aa
aa
aa
aa
ss
ss
CG
zU
Xb
ss
ss
Yo
GT
GT
GT
GT
lC
ss
CG
zU
oA
ss
ss
ss
aa
aa
aa
aa
eD
aa
aa
aa
"}
(28,1,1) = {"
aa
aa
Uy
uY
aa
aa
aa
ss
ss
ss
ss
ss
ss
ss
tn
GT
Fb
GT
GT
mj
ss
ss
ss
ss
ss
ss
ss
aa
aa
aa
aa
eD
aa
aa
aa
"}
(29,1,1) = {"
aa
aa
aa
Uy
uY
aa
aa
ss
ss
ss
ss
Cu
aa
fV
ss
WT
wo
wo
WT
ss
Cu
aa
fV
ss
ss
ss
ss
aa
aa
aa
aa
eD
aa
aa
aa
"}
(30,1,1) = {"
aa
aa
aa
aa
Uy
uY
aa
ss
ss
ss
Cu
aa
aa
aa
fV
KT
KT
KT
KT
Cu
aa
aa
aa
fV
KT
KT
yv
aa
aa
aa
aa
eD
aa
aa
aa
"}
(31,1,1) = {"
aa
aa
aa
aa
aa
rl
aa
Cv
KT
KT
aa
aa
aa
aa
aa
KF
KF
KF
KF
aa
aa
aa
aa
aa
KF
KF
aa
aa
aa
aa
aa
eD
aa
aa
aa
"}
(32,1,1) = {"
aa
aa
aa
aa
aa
rl
aa
aa
KF
KF
aa
aa
aa
aa
aa
aa
aa
aa
aa
aa
aa
aa
aa
aa
aa
aa
aa
aa
aa
aa
aa
eD
aa
aa
aa
"}
(33,1,1) = {"
aa
aa
aa
aa
aa
rl
aa
aa
aa
aa
aa
aa
aa
aa
aa
aa
aa
aa
aa
aa
aa
aa
aa
aa
aa
aa
aa
aa
aa
aa
aa
aa
aa
aa
aa
"}
(34,1,1) = {"
aa
aa
aa
aa
aa
rl
aa
aa
aa
aa
aa
aa
aa
aa
aa
aa
aa
aa
aa
aa
aa
aa
aa
aa
aa
aa
aa
aa
aa
aa
aa
aa
aa
aa
aa
"}
(35,1,1) = {"
aa
aa
aa
aa
aa
aa
aa
aa
aa
aa
aa
aa
aa
aa
aa
aa
aa
aa
aa
aa
aa
aa
aa
aa
aa
aa
aa
aa
aa
aa
aa
aa
aa
aa
aa
"}
