//MAP CONVERTED BY dmm2tgm.py THIS HEADER COMMENT PREVENTS RECONVERSION, DO NOT REMOVE
"a" = (
/obj/structure/railing,
/turf/simulated/floor/outdoors/grass,
/area/space)
"b" = (
/obj/structure/railing{
	dir = 4
	},
/turf/simulated/floor/outdoors/grass,
/area/space)
"c" = (
/obj/structure/railing,
/obj/structure/railing{
	dir = 8;
	icon_state = "railing0"
	},
/turf/simulated/floor/outdoors/grass,
/area/space)
"d" = (
/obj/structure/simple_door/sifwood,
/turf/simulated/floor/wood/sif,
/area/space)
"g" = (
/obj/effect/decal/cleanable/dirt,
/turf/simulated/floor/outdoors/dirt,
/area/space)
"h" = (
/obj/random/energy/highend,
/obj/item/weapon/material/knife/machete/hatchet/unathiknife,
/obj/structure/closet/crate,
/turf/simulated/floor/wood/sif,
/area/space)
"i" = (
/obj/effect/decal/cleanable/blood/oil/streak,
/obj/effect/decal/cleanable/dirt,
/turf/simulated/floor/wood/sif,
/area/space)
"j" = (
/obj/effect/decal/cleanable/dirt,
/obj/effect/decal/cleanable/dirt,
/turf/simulated/floor/outdoors/grass,
/area/space)
"k" = (
/turf/simulated/wall/log_sif,
/area/space)
"l" = (
/turf/simulated/floor/outdoors/dirt,
/area/space)
"m" = (
/obj/structure/table/standard,
/obj/item/weapon/material/minihoe,
/obj/item/weapon/reagent_containers/glass/beaker/large,
/turf/simulated/floor/wood/sif,
/area/space)
"p" = (
/obj/structure/table/standard,
/obj/item/weapon/material/knife/machete/hatchet,
/obj/item/weapon/reagent_containers/glass/bucket,
/turf/simulated/floor/wood/sif,
/area/space)
"q" = (
/obj/machinery/portable_atmospherics/hydroponics,
/turf/simulated/floor/wood/sif,
/area/space)
"r" = (
/obj/structure/table/sifwoodentable,
/obj/random/firstaid,
/turf/simulated/floor/wood/sif,
/area/space)
"s" = (
/obj/structure/table/sifwoodentable,
/obj/item/weapon/flame/candle/candelabra,
/turf/simulated/floor/wood/sif,
/area/space)
"t" = (
/obj/effect/decal/cleanable/dirt,
/obj/effect/decal/cleanable/dirt,
/turf/simulated/floor/outdoors/dirt,
/area/space)
"u" = (
/turf/simulated/floor/outdoors/grass,
/area/space)
"x" = (
/obj/structure/window/basic,
/obj/structure/curtain/black,
/obj/structure/table/standard,
/turf/simulated/floor/wood/sif,
/area/space)
"y" = (
/obj/effect/decal/cleanable/blood/oil/streak,
/obj/effect/decal/cleanable/dirt,
/obj/effect/decal/cleanable/dirt,
/turf/simulated/floor/wood/sif,
/area/space)
"z" = (
/obj/structure/window/basic,
/obj/effect/landmark/loot_spawn,
/obj/structure/curtain/black,
/turf/simulated/floor/wood/sif,
/area/space)
"A" = (
/obj/structure/table/rack,
/obj/item/weapon/melee/umbrella/random,
/obj/item/weapon/gun/energy/taser/xeno,
/turf/simulated/floor/wood/sif,
/area/space)
"C" = (
/obj/structure/railing{
	dir = 8;
	icon_state = "railing0"
	},
/turf/simulated/floor/outdoors/grass,
/area/space)
"D" = (
/turf/simulated/floor/water,
/area/space)
"E" = (
/obj/effect/decal/cleanable/dirt,
/obj/effect/landmark/loot_spawn,
/turf/simulated/floor/wood/sif,
/area/space)
"G" = (
/obj/structure/simple_door/sifwood,
/obj/effect/decal/cleanable/dirt,
/obj/effect/decal/cleanable/dirt,
/turf/simulated/floor/wood/sif,
/area/space)
"H" = (
/obj/effect/decal/cleanable/dirt,
/obj/structure/loot_pile/surface/bones,
/turf/simulated/floor/wood/sif,
/area/space)
"I" = (
/obj/effect/decal/cleanable/dirt,
/obj/structure/closet/crate/hydroponics/exotic,
/turf/simulated/floor/wood/sif,
/area/space)
"L" = (
/obj/effect/decal/cleanable/dirt,
/obj/effect/decal/cleanable/dirt,
/obj/effect/decal/cleanable/dirt,
/turf/simulated/floor/outdoors/dirt,
/area/space)
"M" = (
/obj/structure/simple_door/sifwood,
/obj/effect/decal/cleanable/dirt,
/turf/simulated/floor/wood/sif,
/area/space)
"O" = (
/obj/effect/decal/cleanable/dirt,
/turf/simulated/floor/wood/sif,
/area/space)
"P" = (
/obj/item/weapon/material/shard,
/obj/effect/decal/cleanable/dirt,
/obj/effect/decal/cleanable/dirt,
/turf/simulated/floor/wood/sif,
/area/space)
"Q" = (
/obj/effect/decal/cleanable/dirt,
/obj/effect/decal/cleanable/dirt,
/turf/simulated/floor/wood/sif,
/area/space)
"S" = (
/turf/simulated/floor/wood/sif,
/area/space)
"U" = (
/mob/living/simple_mob/vore/alienanimals/teppi,
/turf/simulated/floor/outdoors/grass,
/area/space)
"V" = (
/obj/effect/decal/cleanable/blood/oil/streak,
/obj/structure/table/rack,
/obj/item/weapon/melee/umbrella/random,
/obj/item/weapon/gun/energy/taser/xeno,
/turf/simulated/floor/wood/sif,
/area/space)
"W" = (
/obj/structure/railing{
	dir = 4
	},
/obj/structure/railing,
/turf/simulated/floor/outdoors/grass,
/area/space)
"X" = (
/obj/effect/decal/cleanable/dirt,
/obj/effect/decal/cleanable/dirt,
/obj/effect/decal/cleanable/dirt,
/turf/simulated/floor/wood/sif,
/area/space)
"Y" = (
/obj/structure/bed/padded,
/obj/item/weapon/bedsheet/blue,
/turf/simulated/floor/wood/sif,
/area/space)
"Z" = (
/turf/template_noop,
/area/space)

(1,1,1) = {"
Z
Z
Z
Z
Z
Z
Z
Z
Z
Z
Z
Z
Z
Z
Z
"}
(2,1,1) = {"
Z
k
k
k
k
k
k
k
k
C
C
C
C
c
Z
"}
(3,1,1) = {"
Z
k
Y
O
k
s
E
V
k
u
u
U
u
a
Z
"}
(4,1,1) = {"
Z
k
r
Q
k
Q
H
Q
P
j
u
u
u
a
Z
"}
(5,1,1) = {"
Z
k
s
O
k
i
Q
Q
O
u
u
u
u
a
Z
"}
(6,1,1) = {"
Z
k
h
O
k
s
Q
A
k
u
u
u
D
a
Z
"}
(7,1,1) = {"
Z
k
k
G
k
k
d
k
k
b
b
b
b
W
Z
"}
(8,1,1) = {"
Z
k
s
O
O
X
O
d
L
t
g
g
l
l
Z
"}
(9,1,1) = {"
Z
k
s
O
X
y
O
M
L
L
g
g
l
Z
Z
"}
(10,1,1) = {"
Z
k
k
M
k
k
k
k
g
g
t
l
l
Z
Z
"}
(11,1,1) = {"
Z
k
I
O
Q
X
O
z
t
l
l
Z
Z
Z
Z
"}
(12,1,1) = {"
Z
k
S
O
O
O
Q
z
g
l
Z
Z
Z
Z
Z
"}
(13,1,1) = {"
Z
k
q
q
q
p
m
x
l
Z
Z
Z
Z
Z
Z
"}
(14,1,1) = {"
Z
k
k
k
k
k
k
k
l
Z
Z
Z
Z
Z
Z
"}
(15,1,1) = {"
Z
Z
Z
Z
Z
Z
Z
Z
Z
Z
Z
Z
Z
Z
Z
"}
