//MAP CONVERTED BY dmm2tgm.py THIS HEADER COMMENT PREVENTS RECONVERSION, DO NOT REMOVE
"a" = (
/turf/simulated/shuttle/floor/alienplating/blue,
/area/submap/vault)
"b" = (
/mob/living/simple_mob/mechanical/hivebot/ranged_damage/ion,
/turf/simulated/shuttle/floor/alien,
/area/submap/vault)
"c" = (
/turf/simulated/shuttle/wall/alien,
/area/submap/vault)
"d" = (
/turf/template_noop,
/area/template_noop)
"e" = (
/obj/structure/table/alien/blue,
/obj/item/prop/alien/junk,
/obj/item/prop/alien/junk,
/obj/item/weapon/implantcase/chem,
/turf/simulated/shuttle/floor/alienplating/blue,
/area/submap/vault)
"i" = (
/obj/structure/loot_pile/surface/alien/security,
/turf/simulated/shuttle/floor/alienplating/blue,
/area/submap/vault)
"n" = (
/obj/structure/loot_pile/surface/alien/end,
/turf/simulated/shuttle/floor/alienplating/blue,
/area/submap/vault)
"o" = (
/mob/living/simple_mob/mechanical/hivebot/ranged_damage/siege/fragmentation,
/turf/simulated/shuttle/floor/alien,
/area/submap/vault)
"p" = (
/turf/space,
/area/submap/vault)
"r" = (
/obj/machinery/porta_turret/alien{
	faction = "hivebot"
	},
/turf/simulated/shuttle/floor/alienplating/blue,
/area/submap/vault)
"v" = (
/obj/structure/table/alien/blue,
/obj/random/janusmodule,
/turf/simulated/shuttle/floor/alienplating/blue,
/area/submap/vault)
"x" = (
/turf/simulated/shuttle/floor/alienplating/external,
/area/submap/vault)
"y" = (
/obj/item/clothing/suit/armor/shield,
/obj/item/weapon/implantcase/handblade,
/obj/item/weapon/implantcase/dart,
/turf/simulated/floor/airless,
/area/submap/vault)
"z" = (
/turf/simulated/shuttle/floor/alien,
/area/submap/vault)
"B" = (
/mob/living/simple_mob/mechanical/hivebot/ranged_damage/siege/radiation,
/turf/simulated/shuttle/floor/alienplating/blue,
/area/submap/vault)
"C" = (
/mob/living/simple_mob/mechanical/hivebot/ranged_damage/siege/emp,
/turf/simulated/shuttle/floor/alienplating/blue,
/area/submap/vault)
"D" = (
/obj/structure/window/titanium/full,
/obj/structure/grille/cult{
	name = "Alien grille"
	},
/obj/structure/window/phoronreinforced,
/obj/structure/window/phoronreinforced{
	dir = 4
	},
/obj/structure/window/phoronreinforced{
	dir = 8
	},
/obj/structure/window/phoronreinforced{
	dir = 1
	},
/obj/machinery/door/blast/regular,
/turf/simulated/shuttle/floor/alienplating/external,
/area/submap/vault)
"G" = (
/mob/living/simple_mob/mechanical/hivebot/ranged_damage/dot,
/turf/simulated/shuttle/floor/alienplating/blue,
/area/submap/vault)
"H" = (
/obj/structure/table/alien/blue,
/obj/item/prop/alien/junk,
/obj/item/prop/alien/junk,
/obj/item/weapon/cell/device/weapon/recharge/alien/omni/empty,
/turf/simulated/shuttle/floor/alienplating/blue,
/area/submap/vault)
"I" = (
/mob/living/simple_mob/mechanical/hivebot/ranged_damage/siege/fragmentation,
/turf/simulated/shuttle/floor/alienplating/blue,
/area/submap/vault)
"J" = (
/mob/living/simple_mob/mechanical/hivebot/ranged_damage/siege/radiation,
/turf/simulated/shuttle/floor/alien,
/area/submap/vault)
"L" = (
/mob/living/simple_mob/mechanical/hivebot/support/logistics,
/turf/simulated/shuttle/floor/alienplating/blue,
/area/submap/vault)
"M" = (
/obj/structure/table/alien/blue,
/obj/item/prop/alien/junk,
/obj/item/prop/alien/junk,
/obj/item/weapon/implantcase/medkit,
/turf/simulated/shuttle/floor/alienplating/blue,
/area/submap/vault)
"P" = (
/obj/machinery/porta_turret/alien{
	faction = "hivebot"
	},
/turf/simulated/shuttle/floor/alien,
/area/submap/vault)
"R" = (
/obj/structure/table/alien/blue,
/obj/item/weapon/gun/energy/alien,
/obj/item/prop/alien/junk,
/obj/item/prop/alien/junk,
/turf/simulated/shuttle/floor/alienplating/blue,
/area/submap/vault)
"V" = (
/obj/machinery/porta_turret/alien{
	faction = "hivebot"
	},
/turf/simulated/floor/airless,
/area/submap/vault)
"X" = (
/mob/living/simple_mob/mechanical/mecha/combat/gygax/dark/advanced{
	faction = "hivebot"
	},
/turf/simulated/shuttle/floor/alienplating/blue,
/area/submap/vault)
"Z" = (
/obj/machinery/door/airlock/alien/blue/locked,
/turf/simulated/shuttle/floor/alienplating/blue,
/area/submap/vault)

(1,1,1) = {"
d
d
d
d
d
d
d
d
d
d
d
d
d
d
d
d
d
d
d
d
d
d
d
d
d
d
d
d
d
d
d
d
d
d
d
d
d
d
d
"}
(2,1,1) = {"
d
d
d
d
d
d
d
d
c
c
c
c
c
a
a
a
a
a
a
a
a
a
a
a
a
a
c
c
c
c
c
d
d
d
d
d
d
d
d
"}
(3,1,1) = {"
d
d
d
d
d
d
d
c
c
a
a
r
c
a
a
z
z
a
a
a
a
a
z
z
a
a
c
r
a
a
c
c
d
d
d
d
d
d
d
"}
(4,1,1) = {"
d
d
d
d
d
d
c
c
a
a
a
a
c
c
r
a
a
r
c
c
c
r
a
a
r
c
c
a
a
a
a
c
c
d
d
d
d
d
d
"}
(5,1,1) = {"
d
d
d
d
d
c
c
r
a
z
z
a
c
c
c
Z
Z
c
c
c
c
c
Z
Z
c
c
c
a
z
z
a
r
c
c
d
d
d
d
d
"}
(6,1,1) = {"
d
d
d
d
c
c
a
a
a
z
z
a
Z
a
z
a
a
c
c
c
c
c
a
a
z
a
Z
a
z
z
a
a
a
c
c
d
d
d
d
"}
(7,1,1) = {"
d
d
d
c
c
a
z
a
a
a
a
a
Z
a
z
a
a
c
c
c
c
c
a
a
z
a
Z
a
a
a
a
a
z
a
c
c
d
d
d
"}
(8,1,1) = {"
d
d
c
c
r
a
a
P
c
Z
c
c
c
c
c
Z
Z
c
c
c
c
c
Z
Z
c
c
c
c
c
Z
c
P
a
a
r
c
c
d
d
"}
(9,1,1) = {"
d
c
c
a
a
a
a
c
c
a
a
i
c
c
a
a
a
a
c
c
c
a
a
a
a
c
c
H
a
a
c
c
a
a
a
a
c
c
d
"}
(10,1,1) = {"
d
c
a
a
z
z
a
Z
a
z
a
n
c
a
a
a
a
a
a
a
a
a
a
a
a
a
c
R
a
z
a
Z
a
z
z
a
a
c
d
"}
(11,1,1) = {"
d
c
a
a
z
z
a
c
a
a
P
c
c
a
a
z
z
z
z
z
z
z
z
z
a
a
c
c
P
a
a
c
a
z
z
a
a
c
d
"}
(12,1,1) = {"
d
c
r
a
a
a
a
c
i
n
c
c
c
a
a
a
a
a
a
X
a
a
a
a
a
a
c
c
c
M
H
c
a
a
a
a
r
c
d
"}
(13,1,1) = {"
d
c
c
c
c
Z
Z
c
c
c
c
c
c
c
a
a
a
z
z
z
z
z
a
a
a
c
c
c
c
c
c
c
Z
Z
c
c
c
c
d
"}
(14,1,1) = {"
d
a
a
c
c
a
a
c
c
a
a
a
c
c
c
a
a
a
a
v
a
a
a
x
c
c
c
a
a
a
c
c
a
a
c
c
a
a
d
"}
(15,1,1) = {"
d
a
a
r
c
z
z
c
a
a
a
a
a
c
c
c
c
D
D
D
D
D
c
c
c
c
a
a
a
a
a
c
z
z
c
r
a
a
d
"}
(16,1,1) = {"
d
a
z
a
Z
a
a
Z
a
a
z
a
I
a
c
c
c
D
D
D
D
D
c
c
c
a
a
a
z
a
a
Z
a
a
Z
a
z
a
d
"}
(17,1,1) = {"
d
a
z
a
Z
a
a
Z
a
a
z
a
I
a
c
c
V
p
p
p
p
p
V
c
c
a
B
a
z
a
a
Z
a
a
Z
a
z
a
d
"}
(18,1,1) = {"
d
a
a
r
c
c
c
c
a
a
o
I
z
a
D
D
p
p
p
p
p
p
p
D
D
C
z
a
J
a
a
c
c
c
c
r
a
a
d
"}
(19,1,1) = {"
d
a
a
c
c
c
c
c
c
a
z
a
z
a
D
D
p
p
p
p
p
p
p
D
D
a
z
a
z
a
c
c
c
c
c
c
a
a
d
"}
(20,1,1) = {"
d
a
a
c
c
c
c
c
c
a
z
a
z
v
D
D
p
p
p
y
p
p
p
D
D
v
z
L
z
a
c
c
c
c
c
c
a
a
d
"}
(21,1,1) = {"
d
a
a
c
c
c
c
c
c
a
z
a
z
a
D
D
p
p
p
p
p
p
p
D
D
a
z
a
z
a
c
c
c
c
c
c
a
a
d
"}
(22,1,1) = {"
d
a
a
r
c
c
c
c
a
a
o
I
z
a
D
D
p
p
p
p
p
p
p
D
D
C
z
a
J
a
a
c
c
c
c
r
a
a
d
"}
(23,1,1) = {"
d
a
z
a
Z
a
a
Z
a
a
z
a
I
a
c
c
V
p
p
p
p
p
V
c
c
a
B
a
z
a
a
Z
a
a
Z
a
z
a
d
"}
(24,1,1) = {"
d
a
z
a
Z
a
a
Z
a
a
z
a
I
a
c
c
c
D
D
D
D
D
c
c
c
a
a
a
z
a
a
Z
a
a
Z
a
z
a
d
"}
(25,1,1) = {"
d
a
a
r
c
z
z
c
a
a
a
a
a
c
c
c
c
D
D
D
D
D
c
c
c
c
a
a
a
a
a
c
z
z
c
r
a
a
d
"}
(26,1,1) = {"
d
a
a
c
c
a
a
c
c
a
a
a
c
c
c
G
G
a
a
v
a
a
G
G
c
c
c
a
a
a
c
c
a
a
c
c
a
a
d
"}
(27,1,1) = {"
d
c
c
c
c
Z
Z
c
c
c
c
c
c
c
a
a
a
b
b
z
b
b
a
a
a
c
c
c
c
c
c
c
Z
Z
c
c
c
c
d
"}
(28,1,1) = {"
d
c
r
a
a
a
a
c
H
e
c
c
c
a
a
a
a
G
G
G
G
G
a
a
a
a
c
c
c
n
i
c
a
a
a
a
r
c
d
"}
(29,1,1) = {"
d
c
a
a
z
z
a
c
a
a
P
c
c
a
a
z
z
z
z
z
z
z
z
z
a
a
c
c
P
a
a
c
a
z
z
a
a
c
d
"}
(30,1,1) = {"
d
c
a
a
z
z
a
Z
a
z
a
R
c
a
a
a
a
a
a
a
a
a
a
a
a
a
c
n
a
z
a
Z
a
z
z
a
a
c
d
"}
(31,1,1) = {"
d
c
c
a
a
a
a
c
c
a
a
H
c
c
a
a
a
a
c
c
c
a
a
a
a
c
c
i
a
a
c
c
a
a
a
a
c
c
d
"}
(32,1,1) = {"
d
d
c
c
r
a
a
P
c
Z
c
c
c
c
c
Z
Z
c
c
c
c
c
Z
Z
c
c
c
c
c
Z
c
P
a
a
r
c
c
d
d
"}
(33,1,1) = {"
d
d
d
c
c
a
z
a
a
a
a
a
Z
a
z
a
a
c
c
c
c
c
a
a
z
a
Z
a
a
a
a
a
z
a
c
c
d
d
d
"}
(34,1,1) = {"
d
d
d
d
c
c
a
a
a
z
z
a
Z
a
z
a
a
c
c
c
c
c
a
a
z
a
Z
a
z
z
a
a
a
c
c
d
d
d
d
"}
(35,1,1) = {"
d
d
d
d
d
c
c
r
a
z
z
a
c
c
c
Z
Z
c
c
c
c
c
Z
Z
c
c
c
a
z
z
a
r
c
c
d
d
d
d
d
"}
(36,1,1) = {"
d
d
d
d
d
d
c
c
a
a
a
a
c
c
r
a
a
r
c
c
c
r
a
a
r
c
c
a
a
a
a
c
c
d
d
d
d
d
d
"}
(37,1,1) = {"
d
d
d
d
d
d
d
c
c
a
a
r
c
a
a
z
z
a
a
a
a
a
z
z
a
a
c
r
a
a
c
c
d
d
d
d
d
d
d
"}
(38,1,1) = {"
d
d
d
d
d
d
d
d
c
c
c
c
c
a
a
a
a
a
a
a
a
a
a
a
a
a
c
c
c
c
c
d
d
d
d
d
d
d
d
"}
(39,1,1) = {"
d
d
d
d
d
d
d
d
d
d
d
d
d
d
d
d
d
d
d
d
d
d
d
d
d
d
d
d
d
d
d
d
d
d
d
d
d
d
d
"}
