//MAP CONVERTED BY dmm2tgm.py THIS HEADER COMMENT PREVENTS RECONVERSION, DO NOT REMOVE
"a" = (
/obj/effect/decal/remains/xeno,
/obj/item/clothing/mask/gas,
/obj/item/clothing/suit/fire/firefighter,
/turf/simulated/mineral/floor/ignore_mapgen,
/area/submap/cave/deadspy)
"b" = (
/turf/simulated/mineral/floor/ignore_mapgen,
/area/submap/cave/deadspy)
"c" = (
/obj/effect/decal/cleanable/molten_item,
/turf/simulated/mineral/floor/ignore_mapgen,
/area/submap/cave/deadspy)
"d" = (
/obj/item/flamethrower,
/turf/simulated/mineral/floor/ignore_mapgen,
/area/submap/cave/deadspy)
"e" = (
/obj/effect/decal/cleanable/liquid_fuel,
/turf/simulated/mineral/floor/ignore_mapgen,
/area/submap/cave/deadspy)
"f" = (
/obj/effect/decal/cleanable/ash,
/obj/random/landmine,
/turf/simulated/mineral/floor/ignore_mapgen,
/area/submap/cave/deadspy)
"g" = (
/obj/random/landmine,
/turf/simulated/mineral/floor/ignore_mapgen,
/area/submap/cave/deadspy)
"h" = (
/obj/effect/decal/cleanable/liquid_fuel,
/obj/random/landmine,
/turf/simulated/mineral/floor/ignore_mapgen,
/area/submap/cave/deadspy)
"i" = (
/obj/effect/decal/cleanable/liquid_fuel,
/obj/effect/decal/cleanable/molten_item,
/turf/simulated/mineral/floor/ignore_mapgen,
/area/submap/cave/deadspy)
"j" = (
/obj/item/material/butterfly,
/obj/effect/decal/cleanable/liquid_fuel,
/turf/simulated/mineral/floor/ignore_mapgen,
/area/submap/cave/deadspy)
"k" = (
/obj/effect/decal/remains/human,
/obj/item/tool/wrench,
/obj/item/clothing/head/hardhat,
/turf/simulated/mineral/floor/ignore_mapgen,
/area/submap/cave/deadspy)
"l" = (
/obj/item/flame/lighter/zippo,
/obj/effect/decal/cleanable/liquid_fuel,
/turf/simulated/mineral/floor/ignore_mapgen,
/area/submap/cave/deadspy)
"m" = (
/obj/effect/decal/remains/human,
/obj/item/clothing/mask/balaclava,
/obj/item/clothing/under/suit_jacket/really_black,
/obj/effect/decal/cleanable/ash,
/obj/effect/decal/cleanable/liquid_fuel,
/obj/effect/decal/cleanable/ash,
/turf/simulated/mineral/floor/ignore_mapgen,
/area/submap/cave/deadspy)
"n" = (
/obj/effect/decal/cleanable/liquid_fuel,
/obj/effect/decal/cleanable/liquid_fuel,
/obj/effect/decal/cleanable/ash,
/turf/simulated/mineral/floor/ignore_mapgen,
/area/submap/cave/deadspy)
"o" = (
/obj/machinery/porta_turret/poi{
	desc = "Looking at this heavy caliber, tripod-mounted, little ol' number makes you want to square-dance.";
	lethal = 0;
	name = "sentry turret"
	},
/turf/simulated/mineral/floor/ignore_mapgen,
/area/submap/cave/deadspy)
"p" = (
/obj/item/deadringer,
/obj/effect/decal/cleanable/liquid_fuel,
/turf/simulated/mineral/floor/ignore_mapgen,
/area/submap/cave/deadspy)
"q" = (
/obj/effect/decal/cleanable/liquid_fuel,
/obj/effect/decal/cleanable/liquid_fuel,
/obj/random/landmine,
/turf/simulated/mineral/floor/ignore_mapgen,
/area/submap/cave/deadspy)
"r" = (
/obj/effect/decal/cleanable/liquid_fuel,
/obj/item/storage/fancy/cigarettes/professionals,
/turf/simulated/mineral/floor/ignore_mapgen,
/area/submap/cave/deadspy)
"s" = (
/obj/item/card/emag_broken,
/turf/simulated/mineral/floor/ignore_mapgen,
/area/submap/cave/deadspy)
"t" = (
/obj/effect/decal/cleanable/ash,
/turf/simulated/mineral/floor/ignore_mapgen,
/area/submap/cave/deadspy)
"v" = (
/turf/simulated/mineral,
/area/submap/cave/deadspy)

(1,1,1) = {"
a
b
b
b
v
v
v
"}
(2,1,1) = {"
b
c
b
b
b
g
v
"}
(3,1,1) = {"
b
d
h
l
p
b
b
"}
(4,1,1) = {"
b
e
i
m
q
t
b
"}
(5,1,1) = {"
b
b
j
n
r
b
b
"}
(6,1,1) = {"
v
f
b
b
b
b
v
"}
(7,1,1) = {"
v
b
k
o
s
b
b
"}
