//MAP CONVERTED BY dmm2tgm.py THIS HEADER COMMENT PREVENTS RECONVERSION, DO NOT REMOVE
"a" = (
/turf/template_noop,
/area/template_noop)
"c" = (
/obj/machinery/crystal/lava,
/turf/simulated/mineral/floor/ignore_mapgen,
/area/template_noop)
"m" = (
/obj/item/weapon/pickaxe/silver,
/turf/simulated/mineral/floor/ignore_mapgen,
/area/template_noop)
"o" = (
/turf/simulated/mineral/floor/ignore_mapgen,
/area/template_noop)
"P" = (
/mob/living/simple_mob/vore/oregrub/lava,
/turf/simulated/mineral/floor/ignore_mapgen,
/area/template_noop)
"Z" = (
/mob/living/simple_mob/vore/oregrub,
/turf/simulated/mineral/floor/ignore_mapgen,
/area/template_noop)

(1,1,1) = {"
a
a
a
o
o
a
a
a
"}
(2,1,1) = {"
a
a
a
o
o
a
a
a
"}
(3,1,1) = {"
a
a
c
o
o
P
a
a
"}
(4,1,1) = {"
o
o
o
Z
o
o
o
o
"}
(5,1,1) = {"
c
o
o
o
m
o
P
o
"}
(6,1,1) = {"
a
a
P
o
o
c
a
a
"}
(7,1,1) = {"
a
a
a
o
o
a
a
a
"}
(8,1,1) = {"
a
a
a
o
o
a
a
a
"}
