//MAP CONVERTED BY dmm2tgm.py THIS HEADER COMMENT PREVENTS RECONVERSION, DO NOT REMOVE
"a" = (
/turf/simulated/mineral/ignore_mapgen,
/area/template_noop)
"b" = (
/turf/template_noop,
/area/template_noop)
"c" = (
/obj/effect/decal/cleanable/blood/tracks/paw,
/obj/effect/decal/cleanable/blood/drip,
/turf/simulated/mineral/floor/ignore_mapgen,
/area/template_noop)
"g" = (
/mob/living/simple_mob/vore/aggressive/rat,
/turf/simulated/mineral/floor/ignore_mapgen,
/area/template_noop)
"k" = (
/obj/effect/decal/cleanable/blood/drip,
/turf/simulated/mineral/floor/ignore_mapgen,
/area/template_noop)
"n" = (
/obj/effect/decal/cleanable/blood/tracks/paw,
/obj/effect/decal/cleanable/blood/tracks/paw,
/obj/effect/decal/cleanable/blood/drip,
/turf/simulated/mineral/floor/ignore_mapgen,
/area/template_noop)
"o" = (
/obj/effect/decal/cleanable/blood,
/mob/living/simple_mob/vore/aggressive/rat,
/turf/simulated/mineral/floor/ignore_mapgen,
/area/template_noop)
"p" = (
/obj/structure/barricade,
/obj/effect/decal/cleanable/blood/drip,
/turf/simulated/mineral/floor/ignore_mapgen,
/area/template_noop)
"u" = (
/obj/structure/barricade,
/turf/simulated/mineral/floor/ignore_mapgen,
/area/template_noop)
"A" = (
/obj/effect/decal/cleanable/blood,
/turf/simulated/mineral/floor/ignore_mapgen,
/area/template_noop)
"B" = (
/obj/structure/outcrop/diamond,
/turf/simulated/mineral/floor/ignore_mapgen,
/area/template_noop)
"C" = (
/obj/structure/frame,
/turf/simulated/mineral/floor/ignore_mapgen,
/area/template_noop)
"F" = (
/obj/structure/girder,
/turf/simulated/mineral/floor/ignore_mapgen,
/area/template_noop)
"J" = (
/obj/effect/decal/cleanable/blood/tracks/paw,
/obj/effect/decal/cleanable/blood/drip,
/obj/effect/decal/cleanable/blood/drip,
/turf/simulated/mineral/floor/ignore_mapgen,
/area/template_noop)
"M" = (
/obj/effect/decal/cleanable/blood,
/obj/effect/decal/cleanable/blood/drip,
/turf/simulated/mineral/floor/ignore_mapgen,
/area/template_noop)
"N" = (
/turf/simulated/mineral/floor/ignore_mapgen,
/area/template_noop)
"Q" = (
/obj/structure/bonfire/permanent,
/turf/simulated/mineral/floor/ignore_mapgen,
/area/template_noop)
"T" = (
/obj/effect/decal/cleanable/cobweb,
/turf/simulated/mineral/floor/ignore_mapgen,
/area/template_noop)
"W" = (
/obj/structure/barricade,
/obj/effect/decal/cleanable/blood/tracks/paw,
/obj/effect/decal/cleanable/blood/drip,
/turf/simulated/mineral/floor/ignore_mapgen,
/area/template_noop)
"Z" = (
/obj/item/weapon/pickaxe/diamond,
/turf/simulated/mineral/floor/ignore_mapgen,
/area/template_noop)

(1,1,1) = {"
b
b
b
a
a
a
a
a
a
a
a
a
"}
(2,1,1) = {"
b
b
b
a
T
N
N
N
N
A
A
a
"}
(3,1,1) = {"
b
b
b
a
N
N
N
g
N
N
A
a
"}
(4,1,1) = {"
a
a
a
a
N
N
N
N
N
N
A
a
"}
(5,1,1) = {"
T
u
N
N
N
N
N
N
N
N
N
a
"}
(6,1,1) = {"
c
c
c
J
N
N
N
C
N
N
N
a
"}
(7,1,1) = {"
u
N
N
c
N
N
N
N
N
N
N
a
"}
(8,1,1) = {"
a
a
N
c
c
M
M
Q
N
N
A
a
"}
(9,1,1) = {"
a
a
a
N
c
N
k
k
N
N
N
a
"}
(10,1,1) = {"
a
a
g
B
c
A
N
k
N
N
A
a
"}
(11,1,1) = {"
W
c
c
c
n
N
Z
k
N
N
N
a
"}
(12,1,1) = {"
u
N
N
N
N
N
N
k
N
N
N
a
"}
(13,1,1) = {"
a
a
a
a
N
N
N
k
N
N
N
a
"}
(14,1,1) = {"
b
b
b
a
g
N
N
k
N
N
A
a
"}
(15,1,1) = {"
b
b
b
a
F
N
N
k
N
A
o
a
"}
(16,1,1) = {"
b
b
b
a
a
a
a
p
a
a
a
a
"}
